Année,Libellé du département,Libellé du canton,Inscrits,Abstentions,Votants,Blancs et nuls,Exprimés,Tour,Parti Politique,nb_votants,Chômage Isere,Estimations de population - Part des 0-24 ans - Isère
2022,ISERE,Monestier-d'Ambel,22,5,17,2,15,2,FN,5,5.925,31.1
2022,ISERE,Monestier-d'Ambel,22,5,17,2,15,2,LREM,10,5.925,31.1
2022,ISERE,Ambel,33,6,27,1,26,2,FN,10,5.925,31.1
2022,ISERE,Ambel,33,6,27,1,26,2,LREM,16,5.925,31.1
2022,ISERE,Beaufin,34,1,33,7,26,2,FN,12,5.925,31.1
2022,ISERE,Beaufin,34,1,33,7,26,2,LREM,14,5.925,31.1
2022,ISERE,Villard-Reymond,34,4,30,7,23,2,FN,6,5.925,31.1
2022,ISERE,Villard-Reymond,34,4,30,7,23,2,LREM,17,5.925,31.1
2022,ISERE,Villard-Notre-Dame,38,5,33,3,30,2,FN,6,5.925,31.1
2022,ISERE,Villard-Notre-Dame,38,5,33,3,30,2,LREM,24,5.925,31.1
2022,ISERE,Oulles,39,9,30,4,26,2,FN,18,5.925,31.1
2022,ISERE,Oulles,39,9,30,4,26,2,LREM,8,5.925,31.1
2022,ISERE,Cognet,41,8,33,7,26,2,FN,15,5.925,31.1
2022,ISERE,Cognet,41,8,33,7,26,2,LREM,11,5.925,31.1
2022,ISERE,Sainte-Luce,55,16,39,4,35,2,FN,13,5.925,31.1
2022,ISERE,Sainte-Luce,55,16,39,4,35,2,LREM,22,5.925,31.1
2022,ISERE,La Valette,62,12,50,7,43,2,FN,18,5.925,31.1
2022,ISERE,La Valette,62,12,50,7,43,2,LREM,25,5.925,31.1
2022,ISERE,Malleval-en-Vercors,63,10,53,4,49,2,FN,15,5.925,31.1
2022,ISERE,Malleval-en-Vercors,63,10,53,4,49,2,LREM,34,5.925,31.1
2022,ISERE,Saint-Michel-en-Beaumont,65,14,51,1,50,2,FN,20,5.925,31.1
2022,ISERE,Saint-Michel-en-Beaumont,65,14,51,1,50,2,LREM,30,5.925,31.1
2022,ISERE,Marcieu,68,6,62,7,55,2,FN,31,5.925,31.1
2022,ISERE,Marcieu,68,6,62,7,55,2,LREM,24,5.925,31.1
2022,ISERE,Saint-Arey,75,8,67,13,54,2,FN,21,5.925,31.1
2022,ISERE,Saint-Arey,75,8,67,13,54,2,LREM,33,5.925,31.1
2022,ISERE,Quincieu,76,15,61,11,50,2,FN,37,5.925,31.1
2022,ISERE,Quincieu,76,15,61,11,50,2,LREM,13,5.925,31.1
2022,ISERE,Bressieux,81,12,69,13,56,2,FN,15,5.925,31.1
2022,ISERE,Bressieux,81,12,69,13,56,2,LREM,41,5.925,31.1
2022,ISERE,Quet-en-Beaumont,83,22,61,8,53,2,FN,22,5.925,31.1
2022,ISERE,Quet-en-Beaumont,83,22,61,8,53,2,LREM,31,5.925,31.1
2022,ISERE,Beauvoir-en-Royans,85,13,72,14,58,2,FN,26,5.925,31.1
2022,ISERE,Beauvoir-en-Royans,85,13,72,14,58,2,LREM,32,5.925,31.1
2022,ISERE,Mont-Saint-Martin,90,14,76,17,59,2,FN,19,5.925,31.1
2022,ISERE,Mont-Saint-Martin,90,14,76,17,59,2,LREM,40,5.925,31.1
2022,ISERE,Mayres-Savel,91,27,64,10,54,2,FN,22,5.925,31.1
2022,ISERE,Mayres-Savel,91,27,64,10,54,2,LREM,32,5.925,31.1
2022,ISERE,Montfalcon,94,8,86,9,77,2,FN,39,5.925,31.1
2022,ISERE,Montfalcon,94,8,86,9,77,2,LREM,38,5.925,31.1
2022,ISERE,Bessins,95,16,79,6,73,2,FN,28,5.925,31.1
2022,ISERE,Bessins,95,16,79,6,73,2,LREM,45,5.925,31.1
2022,ISERE,Villard-Reculas,95,18,77,9,68,2,FN,9,5.925,31.1
2022,ISERE,Villard-Reculas,95,18,77,9,68,2,LREM,59,5.925,31.1
2022,ISERE,Châtelus,96,16,80,10,70,2,FN,52,5.925,31.1
2022,ISERE,Châtelus,96,16,80,10,70,2,LREM,18,5.925,31.1
2022,ISERE,Les Côtes-de-Corps,98,19,79,15,64,2,FN,19,5.925,31.1
2022,ISERE,Les Côtes-de-Corps,98,19,79,15,64,2,LREM,45,5.925,31.1
2022,ISERE,Oris-en-Rattier,102,31,71,13,58,2,FN,15,5.925,31.1
2022,ISERE,Oris-en-Rattier,102,31,71,13,58,2,LREM,43,5.925,31.1
2022,ISERE,Presles,106,28,78,19,59,2,FN,27,5.925,31.1
2022,ISERE,Presles,106,28,78,19,59,2,LREM,32,5.925,31.1
2022,ISERE,La Garde,108,25,83,14,69,2,FN,29,5.925,31.1
2022,ISERE,La Garde,108,25,83,14,69,2,LREM,40,5.925,31.1
2022,ISERE,Siévoz,110,15,95,18,77,2,FN,32,5.925,31.1
2022,ISERE,Siévoz,110,15,95,18,77,2,LREM,45,5.925,31.1
2022,ISERE,Clavans-en-Haut-Oisans,114,24,90,12,78,2,FN,31,5.925,31.1
2022,ISERE,Clavans-en-Haut-Oisans,114,24,90,12,78,2,LREM,47,5.925,31.1
2022,ISERE,Saint-Andéol,115,19,96,13,83,2,FN,20,5.925,31.1
2022,ISERE,Saint-Andéol,115,19,96,13,83,2,LREM,63,5.925,31.1
2022,ISERE,Blandin,118,25,93,6,87,2,FN,48,5.925,31.1
2022,ISERE,Blandin,118,25,93,6,87,2,LREM,39,5.925,31.1
2022,ISERE,Saint-Julien-de-l'Herms,121,29,92,7,85,2,FN,53,5.925,31.1
2022,ISERE,Saint-Julien-de-l'Herms,121,29,92,7,85,2,LREM,32,5.925,31.1
2022,ISERE,Brion,121,30,91,13,78,2,FN,44,5.925,31.1
2022,ISERE,Brion,121,30,91,13,78,2,LREM,34,5.925,31.1
2022,ISERE,Marnans,121,31,90,12,78,2,FN,45,5.925,31.1
2022,ISERE,Marnans,121,31,90,12,78,2,LREM,33,5.925,31.1
2022,ISERE,Saint-Christophe-en-Oisans,123,32,91,18,73,2,FN,15,5.925,31.1
2022,ISERE,Saint-Christophe-en-Oisans,123,32,91,18,73,2,LREM,58,5.925,31.1
2022,ISERE,Choranche,128,25,103,12,91,2,FN,49,5.925,31.1
2022,ISERE,Choranche,128,25,103,12,91,2,LREM,42,5.925,31.1
2022,ISERE,Percy,131,26,105,21,84,2,FN,25,5.925,31.1
2022,ISERE,Percy,131,26,105,21,84,2,LREM,59,5.925,31.1
2022,ISERE,Saint-Pierre-de-Méaroz,131,40,91,7,84,2,FN,53,5.925,31.1
2022,ISERE,Saint-Pierre-de-Méaroz,131,40,91,7,84,2,LREM,31,5.925,31.1
2022,ISERE,Chalon,135,16,119,6,113,2,FN,70,5.925,31.1
2022,ISERE,Chalon,135,16,119,6,113,2,LREM,43,5.925,31.1
2022,ISERE,La Salette-Fallavaux,137,41,96,9,87,2,FN,41,5.925,31.1
2022,ISERE,La Salette-Fallavaux,137,41,96,9,87,2,LREM,46,5.925,31.1
2022,ISERE,Saint-Maurice-en-Trièves,143,30,113,14,99,2,FN,55,5.925,31.1
2022,ISERE,Saint-Maurice-en-Trièves,143,30,113,14,99,2,LREM,44,5.925,31.1
2022,ISERE,Sousville,144,27,117,18,99,2,FN,52,5.925,31.1
2022,ISERE,Sousville,144,27,117,18,99,2,LREM,47,5.925,31.1
2022,ISERE,Besse,149,37,112,8,104,2,FN,37,5.925,31.1
2022,ISERE,Besse,149,37,112,8,104,2,LREM,67,5.925,31.1
2022,ISERE,Lavars,149,39,110,20,90,2,FN,40,5.925,31.1
2022,ISERE,Lavars,149,39,110,20,90,2,LREM,50,5.925,31.1
2022,ISERE,Saint-Martin-de-Clelles,153,24,129,16,113,2,FN,34,5.925,31.1
2022,ISERE,Saint-Martin-de-Clelles,153,24,129,16,113,2,LREM,79,5.925,31.1
2022,ISERE,Lavaldens,157,30,127,14,113,2,FN,49,5.925,31.1
2022,ISERE,Lavaldens,157,30,127,14,113,2,LREM,64,5.925,31.1
2022,ISERE,Cornillon-en-Trièves,161,24,137,16,121,2,FN,38,5.925,31.1
2022,ISERE,Cornillon-en-Trièves,161,24,137,16,121,2,LREM,83,5.925,31.1
2022,ISERE,Hurtières,163,33,130,14,116,2,FN,48,5.925,31.1
2022,ISERE,Hurtières,163,33,130,14,116,2,LREM,68,5.925,31.1
2022,ISERE,Prébois,163,51,112,13,99,2,FN,31,5.925,31.1
2022,ISERE,Prébois,163,51,112,13,99,2,LREM,68,5.925,31.1
2022,ISERE,Ornon,170,36,134,18,116,2,FN,26,5.925,31.1
2022,ISERE,Ornon,170,36,134,18,116,2,LREM,90,5.925,31.1
2022,ISERE,Mizoën,177,41,136,23,113,2,FN,50,5.925,31.1
2022,ISERE,Mizoën,177,41,136,23,113,2,LREM,63,5.925,31.1
2022,ISERE,Sainte-Marie-du-Mont,184,32,152,22,130,2,FN,39,5.925,31.1
2022,ISERE,Sainte-Marie-du-Mont,184,32,152,22,130,2,LREM,91,5.925,31.1
2022,ISERE,Pellafol,184,65,119,16,103,2,FN,42,5.925,31.1
2022,ISERE,Pellafol,184,65,119,16,103,2,LREM,61,5.925,31.1
2022,ISERE,Saint-Guillaume,189,22,167,20,147,2,FN,66,5.925,31.1
2022,ISERE,Saint-Guillaume,189,22,167,20,147,2,LREM,81,5.925,31.1
2022,ISERE,Voissant,189,41,148,14,134,2,FN,63,5.925,31.1
2022,ISERE,Voissant,189,41,148,14,134,2,LREM,71,5.925,31.1
2022,ISERE,Sarcenas,190,30,160,18,142,2,FN,33,5.925,31.1
2022,ISERE,Sarcenas,190,30,160,18,142,2,LREM,109,5.925,31.1
2022,ISERE,Lalley,192,55,137,22,115,2,FN,25,5.925,31.1
2022,ISERE,Lalley,192,55,137,22,115,2,LREM,90,5.925,31.1
2022,ISERE,Avignonet,195,42,153,21,132,2,FN,35,5.925,31.1
2022,ISERE,Avignonet,195,42,153,21,132,2,LREM,97,5.925,31.1
2022,ISERE,Entraigues,195,51,144,14,130,2,FN,64,5.925,31.1
2022,ISERE,Entraigues,195,51,144,14,130,2,LREM,66,5.925,31.1
2022,ISERE,La Morte,200,59,141,16,125,2,FN,45,5.925,31.1
2022,ISERE,La Morte,200,59,141,16,125,2,LREM,80,5.925,31.1
2022,ISERE,Tréminis,204,41,163,36,127,2,FN,54,5.925,31.1
2022,ISERE,Tréminis,204,41,163,36,127,2,LREM,73,5.925,31.1
2022,ISERE,Chassignieu,206,39,167,19,148,2,FN,87,5.925,31.1
2022,ISERE,Chassignieu,206,39,167,19,148,2,LREM,61,5.925,31.1
2022,ISERE,Valjouffrey,210,52,158,20,138,2,FN,41,5.925,31.1
2022,ISERE,Valjouffrey,210,52,158,20,138,2,LREM,97,5.925,31.1
2022,ISERE,Saint-Clair-sur-Galaure,212,46,166,13,153,2,FN,62,5.925,31.1
2022,ISERE,Saint-Clair-sur-Galaure,212,46,166,13,153,2,LREM,91,5.925,31.1
2022,ISERE,Le Moutaret,212,53,159,18,141,2,FN,60,5.925,31.1
2022,ISERE,Le Moutaret,212,53,159,18,141,2,LREM,81,5.925,31.1
2022,ISERE,Plan,213,39,174,19,155,2,FN,83,5.925,31.1
2022,ISERE,Plan,213,39,174,19,155,2,LREM,72,5.925,31.1
2022,ISERE,Vernas,213,50,163,13,150,2,FN,84,5.925,31.1
2022,ISERE,Vernas,213,50,163,13,150,2,LREM,66,5.925,31.1
2022,ISERE,Le Freney-d'Oisans,215,66,149,4,145,2,FN,66,5.925,31.1
2022,ISERE,Le Freney-d'Oisans,215,66,149,4,145,2,LREM,79,5.925,31.1
2022,ISERE,Lentiol,216,38,178,18,160,2,FN,77,5.925,31.1
2022,ISERE,Lentiol,216,38,178,18,160,2,LREM,83,5.925,31.1
2022,ISERE,Treffort,218,44,174,21,153,2,FN,55,5.925,31.1
2022,ISERE,Treffort,218,44,174,21,153,2,LREM,98,5.925,31.1
2022,ISERE,Chantepérier,218,47,171,26,145,2,FN,62,5.925,31.1
2022,ISERE,Chantepérier,218,47,171,26,145,2,LREM,83,5.925,31.1
2022,ISERE,Saint-Paul-lès-Monestier,222,37,185,20,165,2,FN,63,5.925,31.1
2022,ISERE,Saint-Paul-lès-Monestier,222,37,185,20,165,2,LREM,102,5.925,31.1
2022,ISERE,Ponsonnas,234,40,194,23,171,2,FN,61,5.925,31.1
2022,ISERE,Ponsonnas,234,40,194,23,171,2,LREM,110,5.925,31.1
2022,ISERE,Le Monestier-du-Percy,237,48,189,32,157,2,FN,45,5.925,31.1
2022,ISERE,Le Monestier-du-Percy,237,48,189,32,157,2,LREM,112,5.925,31.1
2022,ISERE,Auris,237,69,168,14,154,2,FN,59,5.925,31.1
2022,ISERE,Auris,237,69,168,14,154,2,LREM,95,5.925,31.1
2022,ISERE,Saint-Jean-le-Vieux,238,41,197,14,183,2,FN,54,5.925,31.1
2022,ISERE,Saint-Jean-le-Vieux,238,41,197,14,183,2,LREM,129,5.925,31.1
2022,ISERE,Saint-Didier-de-Bizonnes,238,42,196,27,169,2,FN,98,5.925,31.1
2022,ISERE,Saint-Didier-de-Bizonnes,238,42,196,27,169,2,LREM,71,5.925,31.1
2022,ISERE,Saint-Michel-de-Saint-Geoirs,240,40,200,28,172,2,FN,81,5.925,31.1
2022,ISERE,Saint-Michel-de-Saint-Geoirs,240,40,200,28,172,2,LREM,91,5.925,31.1
2022,ISERE,Montagne,240,62,178,21,157,2,FN,88,5.925,31.1
2022,ISERE,Montagne,240,62,178,21,157,2,LREM,69,5.925,31.1
2022,ISERE,Oz,246,67,179,26,153,2,FN,47,5.925,31.1
2022,ISERE,Oz,246,67,179,26,153,2,LREM,106,5.925,31.1
2022,ISERE,Saint-Martin-de-Vaulserre,247,50,197,25,172,2,FN,77,5.925,31.1
2022,ISERE,Saint-Martin-de-Vaulserre,247,50,197,25,172,2,LREM,95,5.925,31.1
2022,ISERE,Serre-Nerpol,247,74,173,21,152,2,FN,80,5.925,31.1
2022,ISERE,Serre-Nerpol,247,74,173,21,152,2,LREM,72,5.925,31.1
2022,ISERE,Saint-Michel-les-Portes,250,53,197,25,172,2,FN,50,5.925,31.1
2022,ISERE,Saint-Michel-les-Portes,250,53,197,25,172,2,LREM,122,5.925,31.1
2022,ISERE,La Forteresse,253,64,189,20,169,2,FN,92,5.925,31.1
2022,ISERE,La Forteresse,253,64,189,20,169,2,LREM,77,5.925,31.1
2022,ISERE,Saint-Paul-d'Izeaux,256,59,197,25,172,2,FN,103,5.925,31.1
2022,ISERE,Saint-Paul-d'Izeaux,256,59,197,25,172,2,LREM,69,5.925,31.1
2022,ISERE,Saint-Mury-Monteymond,258,48,210,28,182,2,FN,72,5.925,31.1
2022,ISERE,Saint-Mury-Monteymond,258,48,210,28,182,2,LREM,110,5.925,31.1
2022,ISERE,Lieudieu,259,68,191,21,170,2,FN,116,5.925,31.1
2022,ISERE,Lieudieu,259,68,191,21,170,2,LREM,54,5.925,31.1
2022,ISERE,Château-Bernard,262,72,190,16,174,2,FN,67,5.925,31.1
2022,ISERE,Château-Bernard,262,72,190,16,174,2,LREM,107,5.925,31.1
2022,ISERE,Roissard,263,47,216,14,202,2,FN,85,5.925,31.1
2022,ISERE,Roissard,263,47,216,14,202,2,LREM,117,5.925,31.1
2022,ISERE,Saint-Baudille-et-Pipet,266,54,212,25,187,2,FN,63,5.925,31.1
2022,ISERE,Saint-Baudille-et-Pipet,266,54,212,25,187,2,LREM,124,5.925,31.1
2022,ISERE,Bossieu,278,60,218,25,193,2,FN,123,5.925,31.1
2022,ISERE,Bossieu,278,60,218,25,193,2,LREM,70,5.925,31.1
2022,ISERE,Cholonge,280,50,230,30,200,2,FN,112,5.925,31.1
2022,ISERE,Cholonge,280,50,230,30,200,2,LREM,88,5.925,31.1
2022,ISERE,Rencurel,281,53,228,35,193,2,FN,72,5.925,31.1
2022,ISERE,Rencurel,281,53,228,35,193,2,LREM,121,5.925,31.1
2022,ISERE,Montchaboud,286,47,239,31,208,2,FN,67,5.925,31.1
2022,ISERE,Montchaboud,286,47,239,31,208,2,LREM,141,5.925,31.1
2022,ISERE,Morette,287,34,253,18,235,2,FN,113,5.925,31.1
2022,ISERE,Morette,287,34,253,18,235,2,LREM,122,5.925,31.1
2022,ISERE,Murinais,293,58,235,19,216,2,FN,114,5.925,31.1
2022,ISERE,Murinais,293,58,235,19,216,2,LREM,102,5.925,31.1
2022,ISERE,Saint-André-en-Royans,294,51,243,33,210,2,FN,92,5.925,31.1
2022,ISERE,Saint-André-en-Royans,294,51,243,33,210,2,LREM,118,5.925,31.1
2022,ISERE,Penol,295,50,245,17,228,2,FN,116,5.925,31.1
2022,ISERE,Penol,295,50,245,17,228,2,LREM,112,5.925,31.1
2022,ISERE,Chichilianne,297,45,252,31,221,2,FN,88,5.925,31.1
2022,ISERE,Chichilianne,297,45,252,31,221,2,LREM,133,5.925,31.1
2022,ISERE,Prunières,299,78,221,40,181,2,FN,102,5.925,31.1
2022,ISERE,Prunières,299,78,221,40,181,2,LREM,79,5.925,31.1
2022,ISERE,Auberives-en-Royans,300,67,233,23,210,2,FN,112,5.925,31.1
2022,ISERE,Auberives-en-Royans,300,67,233,23,210,2,LREM,98,5.925,31.1
2022,ISERE,Saint-Jean-d'Hérans,304,62,242,40,202,2,FN,95,5.925,31.1
2022,ISERE,Saint-Jean-d'Hérans,304,62,242,40,202,2,LREM,107,5.925,31.1
2022,ISERE,Veyssilieu,309,53,256,18,238,2,FN,99,5.925,31.1
2022,ISERE,Veyssilieu,309,53,256,18,238,2,LREM,139,5.925,31.1
2022,ISERE,Royas,311,50,261,25,236,2,FN,131,5.925,31.1
2022,ISERE,Royas,311,50,261,25,236,2,LREM,105,5.925,31.1
2022,ISERE,La Salle-en-Beaumont,312,69,243,28,215,2,FN,116,5.925,31.1
2022,ISERE,La Salle-en-Beaumont,312,69,243,28,215,2,LREM,99,5.925,31.1
2022,ISERE,Miribel-Lanchâtre,317,55,262,38,224,2,FN,102,5.925,31.1
2022,ISERE,Miribel-Lanchâtre,317,55,262,38,224,2,LREM,122,5.925,31.1
2022,ISERE,Chantesse,321,62,259,12,247,2,FN,122,5.925,31.1
2022,ISERE,Chantesse,321,62,259,12,247,2,LREM,125,5.925,31.1
2022,ISERE,Saint-Romain-de-Surieu,327,51,276,21,255,2,FN,133,5.925,31.1
2022,ISERE,Saint-Romain-de-Surieu,327,51,276,21,255,2,LREM,122,5.925,31.1
2022,ISERE,Saint-Barthélemy-de-Séchilienne,331,70,261,25,236,2,FN,107,5.925,31.1
2022,ISERE,Saint-Barthélemy-de-Séchilienne,331,70,261,25,236,2,LREM,129,5.925,31.1
2022,ISERE,Vatilieu,335,62,273,37,236,2,FN,89,5.925,31.1
2022,ISERE,Vatilieu,335,62,273,37,236,2,LREM,147,5.925,31.1
2022,ISERE,Burcin,336,45,291,23,268,2,FN,128,5.925,31.1
2022,ISERE,Burcin,336,45,291,23,268,2,LREM,140,5.925,31.1
2022,ISERE,Cras,337,53,284,39,245,2,FN,115,5.925,31.1
2022,ISERE,Cras,337,53,284,39,245,2,LREM,130,5.925,31.1
2022,ISERE,Saint-Albin-de-Vaulserre,338,64,274,31,243,2,FN,123,5.925,31.1
2022,ISERE,Saint-Albin-de-Vaulserre,338,64,274,31,243,2,LREM,120,5.925,31.1
2022,ISERE,Vasselin,341,63,278,25,253,2,FN,146,5.925,31.1
2022,ISERE,Vasselin,341,63,278,25,253,2,LREM,107,5.925,31.1
2022,ISERE,Saint-Appolinard,342,64,278,24,254,2,FN,128,5.925,31.1
2022,ISERE,Saint-Appolinard,342,64,278,24,254,2,LREM,126,5.925,31.1
2022,ISERE,Montrevel,346,70,276,276,0,2,FN,0,5.925,31.1
2022,ISERE,Montrevel,346,70,276,276,0,2,LREM,0,5.925,31.1
2022,ISERE,Laffrey,347,77,270,37,233,2,FN,127,5.925,31.1
2022,ISERE,Laffrey,347,77,270,37,233,2,LREM,106,5.925,31.1
2022,ISERE,Charette,350,63,287,23,264,2,FN,165,5.925,31.1
2022,ISERE,Charette,350,63,287,23,264,2,LREM,99,5.925,31.1
2022,ISERE,La Flachère,350,78,272,20,252,2,FN,114,5.925,31.1
2022,ISERE,La Flachère,350,78,272,20,252,2,LREM,138,5.925,31.1
2022,ISERE,Chasselay,353,88,265,32,233,2,FN,123,5.925,31.1
2022,ISERE,Chasselay,353,88,265,32,233,2,LREM,110,5.925,31.1
2022,ISERE,Villard-Saint-Christophe,354,100,254,32,222,2,FN,102,5.925,31.1
2022,ISERE,Villard-Saint-Christophe,354,100,254,32,222,2,LREM,120,5.925,31.1
2022,ISERE,La Motte-Saint-Martin,355,74,281,34,247,2,FN,113,5.925,31.1
2022,ISERE,La Motte-Saint-Martin,355,74,281,34,247,2,LREM,134,5.925,31.1
2022,ISERE,Châtenay,356,92,264,31,233,2,FN,112,5.925,31.1
2022,ISERE,Châtenay,356,92,264,31,233,2,LREM,121,5.925,31.1
2022,ISERE,Saint-Sulpice-des-Rivoires,358,67,291,21,270,2,FN,127,5.925,31.1
2022,ISERE,Saint-Sulpice-des-Rivoires,358,67,291,21,270,2,LREM,143,5.925,31.1
2022,ISERE,Granieu,361,58,303,16,287,2,FN,140,5.925,31.1
2022,ISERE,Granieu,361,58,303,16,287,2,LREM,147,5.925,31.1
2022,ISERE,Eydoche,366,55,311,22,289,2,FN,164,5.925,31.1
2022,ISERE,Eydoche,366,55,311,22,289,2,LREM,125,5.925,31.1
2022,ISERE,Notre-Dame-de-l'Osier,370,68,302,30,272,2,FN,137,5.925,31.1
2022,ISERE,Notre-Dame-de-l'Osier,370,68,302,30,272,2,LREM,135,5.925,31.1
2022,ISERE,Engins,371,73,298,26,272,2,FN,97,5.925,31.1
2022,ISERE,Engins,371,73,298,26,272,2,LREM,175,5.925,31.1
2022,ISERE,Saint-Laurent-en-Beaumont,376,74,302,23,279,2,FN,153,5.925,31.1
2022,ISERE,Saint-Laurent-en-Beaumont,376,74,302,23,279,2,LREM,126,5.925,31.1
2022,ISERE,Sainte-Marie-d'Alloix,382,66,316,29,287,2,FN,120,5.925,31.1
2022,ISERE,Sainte-Marie-d'Alloix,382,66,316,29,287,2,LREM,167,5.925,31.1
2022,ISERE,Corrençon-en-Vercors,382,72,310,20,290,2,FN,85,5.925,31.1
2022,ISERE,Corrençon-en-Vercors,382,72,310,20,290,2,LREM,205,5.925,31.1
2022,ISERE,Saint-Geoirs,386,84,302,31,271,2,FN,130,5.925,31.1
2022,ISERE,Saint-Geoirs,386,84,302,31,271,2,LREM,141,5.925,31.1
2022,ISERE,Gresse-en-Vercors,388,78,310,36,274,2,FN,75,5.925,31.1
2022,ISERE,Gresse-en-Vercors,388,78,310,36,274,2,LREM,199,5.925,31.1
2022,ISERE,Saint-Gervais,390,108,282,21,261,2,FN,143,5.925,31.1
2022,ISERE,Saint-Gervais,390,108,282,21,261,2,LREM,118,5.925,31.1
2022,ISERE,Monteynard,392,61,331,27,304,2,FN,167,5.925,31.1
2022,ISERE,Monteynard,392,61,331,27,304,2,LREM,137,5.925,31.1
2022,ISERE,Corps,401,75,326,25,301,2,FN,135,5.925,31.1
2022,ISERE,Corps,401,75,326,25,301,2,LREM,166,5.925,31.1
2022,ISERE,Notre-Dame-de-Commiers,403,73,330,30,300,2,FN,153,5.925,31.1
2022,ISERE,Notre-Dame-de-Commiers,403,73,330,30,300,2,LREM,147,5.925,31.1
2022,ISERE,Vaujany,405,100,305,16,289,2,FN,119,5.925,31.1
2022,ISERE,Vaujany,405,100,305,16,289,2,LREM,170,5.925,31.1
2022,ISERE,Proveysieux,406,75,331,33,298,2,FN,76,5.925,31.1
2022,ISERE,Proveysieux,406,75,331,33,298,2,LREM,222,5.925,31.1
2022,ISERE,Belmont,406,92,314,20,294,2,FN,176,5.925,31.1
2022,ISERE,Belmont,406,92,314,20,294,2,LREM,118,5.925,31.1
2022,ISERE,La Chapelle-du-Bard,408,104,304,37,267,2,FN,106,5.925,31.1
2022,ISERE,La Chapelle-du-Bard,408,104,304,37,267,2,LREM,161,5.925,31.1
2022,ISERE,Merlas,409,97,312,37,275,2,FN,147,5.925,31.1
2022,ISERE,Merlas,409,97,312,37,275,2,LREM,128,5.925,31.1
2022,ISERE,Nantes-en-Ratier,415,66,349,55,294,2,FN,110,5.925,31.1
2022,ISERE,Nantes-en-Ratier,415,66,349,55,294,2,LREM,184,5.925,31.1
2022,ISERE,Beaufort,422,70,352,30,322,2,FN,182,5.925,31.1
2022,ISERE,Beaufort,422,70,352,30,322,2,LREM,140,5.925,31.1
2022,ISERE,Velanne,429,106,323,34,289,2,FN,149,5.925,31.1
2022,ISERE,Velanne,429,106,323,34,289,2,LREM,140,5.925,31.1
2022,ISERE,Montcarra,435,72,363,39,324,2,FN,161,5.925,31.1
2022,ISERE,Montcarra,435,72,363,39,324,2,LREM,163,5.925,31.1
2022,ISERE,La Sône,435,98,337,41,296,2,FN,144,5.925,31.1
2022,ISERE,La Sône,435,98,337,41,296,2,LREM,152,5.925,31.1
2022,ISERE,Saint-Pierre-de-Chérennes,438,88,350,45,305,2,FN,133,5.925,31.1
2022,ISERE,Saint-Pierre-de-Chérennes,438,88,350,45,305,2,LREM,172,5.925,31.1
2022,ISERE,Longechenal,438,92,346,40,306,2,FN,152,5.925,31.1
2022,ISERE,Longechenal,438,92,346,40,306,2,LREM,154,5.925,31.1
2022,ISERE,Crachier,439,71,368,33,335,2,FN,174,5.925,31.1
2022,ISERE,Crachier,439,71,368,33,335,2,LREM,161,5.925,31.1
2022,ISERE,Châtel en Trièves,440,85,355,44,311,2,FN,116,5.925,31.1
2022,ISERE,Châtel en Trièves,440,85,355,44,311,2,LREM,195,5.925,31.1
2022,ISERE,Flachères,440,97,343,36,307,2,FN,169,5.925,31.1
2022,ISERE,Flachères,440,97,343,36,307,2,LREM,138,5.925,31.1
2022,ISERE,Saint-Théoffrey,443,101,342,50,292,2,FN,117,5.925,31.1
2022,ISERE,Saint-Théoffrey,443,101,342,50,292,2,LREM,175,5.925,31.1
2022,ISERE,Montaud,444,95,349,54,295,2,FN,63,5.925,31.1
2022,ISERE,Montaud,444,95,349,54,295,2,LREM,232,5.925,31.1
2022,ISERE,Pisieu,452,102,350,42,308,2,FN,161,5.925,31.1
2022,ISERE,Pisieu,452,102,350,42,308,2,LREM,147,5.925,31.1
2022,ISERE,Chèzeneuve,455,60,395,30,365,2,FN,186,5.925,31.1
2022,ISERE,Chèzeneuve,455,60,395,30,365,2,LREM,179,5.925,31.1
2022,ISERE,Le Haut-Bréda,455,97,358,44,314,2,FN,131,5.925,31.1
2022,ISERE,Le Haut-Bréda,455,97,358,44,314,2,LREM,183,5.925,31.1
2022,ISERE,Siccieu-Saint-Julien-et-Carisieu,456,95,361,33,328,2,FN,153,5.925,31.1
2022,ISERE,Siccieu-Saint-Julien-et-Carisieu,456,95,361,33,328,2,LREM,175,5.925,31.1
2022,ISERE,Saint-Ondras,460,90,370,41,329,2,FN,169,5.925,31.1
2022,ISERE,Saint-Ondras,460,90,370,41,329,2,LREM,160,5.925,31.1
2022,ISERE,Têche,460,117,343,32,311,2,FN,165,5.925,31.1
2022,ISERE,Têche,460,117,343,32,311,2,LREM,146,5.925,31.1
2022,ISERE,Le Bouchage,461,89,372,22,350,2,FN,222,5.925,31.1
2022,ISERE,Le Bouchage,461,89,372,22,350,2,LREM,128,5.925,31.1
2022,ISERE,Brangues,461,99,362,25,337,2,FN,183,5.925,31.1
2022,ISERE,Brangues,461,99,362,25,337,2,LREM,154,5.925,31.1
2022,ISERE,Saint-Sorlin-de-Morestel,461,105,356,19,337,2,FN,188,5.925,31.1
2022,ISERE,Saint-Sorlin-de-Morestel,461,105,356,19,337,2,LREM,149,5.925,31.1
2022,ISERE,Clelles,467,90,377,66,311,2,FN,134,5.925,31.1
2022,ISERE,Clelles,467,90,377,66,311,2,LREM,177,5.925,31.1
2022,ISERE,Moras,469,92,377,27,350,2,FN,172,5.925,31.1
2022,ISERE,Moras,469,92,377,27,350,2,LREM,178,5.925,31.1
2022,ISERE,La Pierre,469,96,373,45,328,2,FN,135,5.925,31.1
2022,ISERE,La Pierre,469,96,373,45,328,2,LREM,193,5.925,31.1
2022,ISERE,Saint-Jean-de-Vaulx,471,99,372,58,314,2,FN,138,5.925,31.1
2022,ISERE,Saint-Jean-de-Vaulx,471,99,372,58,314,2,LREM,176,5.925,31.1
2022,ISERE,Sainte-Agnès,473,78,395,47,348,2,FN,100,5.925,31.1
2022,ISERE,Sainte-Agnès,473,78,395,47,348,2,LREM,248,5.925,31.1
2022,ISERE,Chamrousse,474,121,353,23,330,2,FN,101,5.925,31.1
2022,ISERE,Chamrousse,474,121,353,23,330,2,LREM,229,5.925,31.1
2022,ISERE,Valbonnais,479,129,350,56,294,2,FN,109,5.925,31.1
2022,ISERE,Valbonnais,479,129,350,56,294,2,LREM,185,5.925,31.1
2022,ISERE,Vertrieu,481,92,389,31,358,2,FN,209,5.925,31.1
2022,ISERE,Vertrieu,481,92,389,31,358,2,LREM,149,5.925,31.1
2022,ISERE,Saint-Bueil,483,112,371,39,332,2,FN,179,5.925,31.1
2022,ISERE,Saint-Bueil,483,112,371,39,332,2,LREM,153,5.925,31.1
2022,ISERE,Notre-Dame-de-Vaulx,485,101,384,41,343,2,FN,137,5.925,31.1
2022,ISERE,Notre-Dame-de-Vaulx,485,101,384,41,343,2,LREM,206,5.925,31.1
2022,ISERE,Cognin-les-Gorges,486,117,369,45,324,2,FN,133,5.925,31.1
2022,ISERE,Cognin-les-Gorges,486,117,369,45,324,2,LREM,191,5.925,31.1
2022,ISERE,Saint-Hilaire-de-Brens,494,97,397,44,353,2,FN,162,5.925,31.1
2022,ISERE,Saint-Hilaire-de-Brens,494,97,397,44,353,2,LREM,191,5.925,31.1
2022,ISERE,Rovon,507,121,386,35,351,2,FN,205,5.925,31.1
2022,ISERE,Rovon,507,121,386,35,351,2,LREM,146,5.925,31.1
2022,ISERE,Saint-Pierre-d'Entremont,511,135,376,30,346,2,FN,125,5.925,31.1
2022,ISERE,Saint-Pierre-d'Entremont,511,135,376,30,346,2,LREM,221,5.925,31.1
2022,ISERE,Marcollin,515,143,372,27,345,2,FN,187,5.925,31.1
2022,ISERE,Marcollin,515,143,372,27,345,2,LREM,158,5.925,31.1
2022,ISERE,La Chapelle-de-Surieu,519,102,417,35,382,2,FN,226,5.925,31.1
2022,ISERE,La Chapelle-de-Surieu,519,102,417,35,382,2,LREM,156,5.925,31.1
2022,ISERE,Beaulieu,522,97,425,44,381,2,FN,174,5.925,31.1
2022,ISERE,Beaulieu,522,97,425,44,381,2,LREM,207,5.925,31.1
2022,ISERE,Annoisin-Chatelans,525,81,444,30,414,2,FN,205,5.925,31.1
2022,ISERE,Annoisin-Chatelans,525,81,444,30,414,2,LREM,209,5.925,31.1
2022,ISERE,La Buissière,526,93,433,41,392,2,FN,149,5.925,31.1
2022,ISERE,La Buissière,526,93,433,41,392,2,LREM,243,5.925,31.1
2022,ISERE,Sinard,533,115,418,53,365,2,FN,119,5.925,31.1
2022,ISERE,Sinard,533,115,418,53,365,2,LREM,246,5.925,31.1
2022,ISERE,Valencogne,535,124,411,36,375,2,FN,177,5.925,31.1
2022,ISERE,Valencogne,535,124,411,36,375,2,LREM,198,5.925,31.1
2022,ISERE,Panossas,536,86,450,34,416,2,FN,180,5.925,31.1
2022,ISERE,Panossas,536,86,450,34,416,2,LREM,236,5.925,31.1
2022,ISERE,Parmilieu,537,102,435,40,395,2,FN,221,5.925,31.1
2022,ISERE,Parmilieu,537,102,435,40,395,2,LREM,174,5.925,31.1
2022,ISERE,Meyssiez,538,106,432,37,395,2,FN,243,5.925,31.1
2022,ISERE,Meyssiez,538,106,432,37,395,2,LREM,152,5.925,31.1
2022,ISERE,Saint-Martin-de-la-Cluze,546,106,440,41,399,2,FN,182,5.925,31.1
2022,ISERE,Saint-Martin-de-la-Cluze,546,106,440,41,399,2,LREM,217,5.925,31.1
2022,ISERE,Saint-Maximin,553,114,439,51,388,2,FN,171,5.925,31.1
2022,ISERE,Saint-Maximin,553,114,439,51,388,2,LREM,217,5.925,31.1
2022,ISERE,Chevrières,556,130,426,43,383,2,FN,150,5.925,31.1
2022,ISERE,Chevrières,556,130,426,43,383,2,LREM,233,5.925,31.1
2022,ISERE,La Rivière,556,130,426,26,400,2,FN,218,5.925,31.1
2022,ISERE,La Rivière,556,130,426,26,400,2,LREM,182,5.925,31.1
2022,ISERE,Sainte-Anne-sur-Gervonde,557,114,443,36,407,2,FN,222,5.925,31.1
2022,ISERE,Sainte-Anne-sur-Gervonde,557,114,443,36,407,2,LREM,185,5.925,31.1
2022,ISERE,Tramolé,558,110,448,29,419,2,FN,162,5.925,31.1
2022,ISERE,Tramolé,558,110,448,29,419,2,LREM,257,5.925,31.1
2022,ISERE,Saint-Bonnet-de-Chavagne,572,126,446,41,405,2,FN,184,5.925,31.1
2022,ISERE,Saint-Bonnet-de-Chavagne,572,126,446,41,405,2,LREM,221,5.925,31.1
2022,ISERE,Torchefelon,573,104,469,53,416,2,FN,187,5.925,31.1
2022,ISERE,Torchefelon,573,104,469,53,416,2,LREM,229,5.925,31.1
2022,ISERE,Moissieu-sur-Dolon,575,127,448,31,417,2,FN,223,5.925,31.1
2022,ISERE,Moissieu-sur-Dolon,575,127,448,31,417,2,LREM,194,5.925,31.1
2022,ISERE,La Combe-de-Lancey,577,105,472,45,427,2,FN,138,5.925,31.1
2022,ISERE,La Combe-de-Lancey,577,105,472,45,427,2,LREM,289,5.925,31.1
2022,ISERE,Succieu,577,107,470,33,437,2,FN,245,5.925,31.1
2022,ISERE,Succieu,577,107,470,33,437,2,LREM,192,5.925,31.1
2022,ISERE,Thodure,581,101,480,51,429,2,FN,216,5.925,31.1
2022,ISERE,Thodure,581,101,480,51,429,2,LREM,213,5.925,31.1
2022,ISERE,Monsteroux-Milieu,593,107,486,45,441,2,FN,263,5.925,31.1
2022,ISERE,Monsteroux-Milieu,593,107,486,45,441,2,LREM,178,5.925,31.1
2022,ISERE,Primarette,593,121,472,48,424,2,FN,233,5.925,31.1
2022,ISERE,Primarette,593,121,472,48,424,2,LREM,191,5.925,31.1
2022,ISERE,Saint-Pierre-de-Mésage,598,120,478,51,427,2,FN,200,5.925,31.1
2022,ISERE,Saint-Pierre-de-Mésage,598,120,478,51,427,2,LREM,227,5.925,31.1
2022,ISERE,Saint-Pierre-de-Bressieux,599,121,478,42,436,2,FN,163,5.925,31.1
2022,ISERE,Saint-Pierre-de-Bressieux,599,121,478,42,436,2,LREM,273,5.925,31.1
2022,ISERE,Culin,601,120,481,38,443,2,FN,226,5.925,31.1
2022,ISERE,Culin,601,120,481,38,443,2,LREM,217,5.925,31.1
2022,ISERE,Izeron,603,126,477,45,432,2,FN,249,5.925,31.1
2022,ISERE,Izeron,603,126,477,45,432,2,LREM,183,5.925,31.1
2022,ISERE,Massieu,603,153,450,47,403,2,FN,168,5.925,31.1
2022,ISERE,Massieu,603,153,450,47,403,2,LREM,235,5.925,31.1
2022,ISERE,Mottier,604,137,467,37,430,2,FN,236,5.925,31.1
2022,ISERE,Mottier,604,137,467,37,430,2,LREM,194,5.925,31.1
2022,ISERE,Bresson,607,90,517,40,477,2,FN,134,5.925,31.1
2022,ISERE,Bresson,607,90,517,40,477,2,LREM,343,5.925,31.1
2022,ISERE,Chélieu,611,122,489,46,443,2,FN,250,5.925,31.1
2022,ISERE,Chélieu,611,122,489,46,443,2,LREM,193,5.925,31.1
2022,ISERE,Venon,612,89,523,70,453,2,FN,109,5.925,31.1
2022,ISERE,Venon,612,89,523,70,453,2,LREM,344,5.925,31.1
2022,ISERE,Pommier-de-Beaurepaire,612,157,455,35,420,2,FN,224,5.925,31.1
2022,ISERE,Pommier-de-Beaurepaire,612,157,455,35,420,2,LREM,196,5.925,31.1
2022,ISERE,Châteauvilain,615,107,508,38,470,2,FN,243,5.925,31.1
2022,ISERE,Châteauvilain,615,107,508,38,470,2,LREM,227,5.925,31.1
2022,ISERE,Dizimieu,620,138,482,28,454,2,FN,218,5.925,31.1
2022,ISERE,Dizimieu,620,138,482,28,454,2,LREM,236,5.925,31.1
2022,ISERE,Pont-en-Royans,620,212,408,51,357,2,FN,144,5.925,31.1
2022,ISERE,Pont-en-Royans,620,212,408,51,357,2,LREM,213,5.925,31.1
2022,ISERE,Vénérieu,625,124,501,32,469,2,FN,236,5.925,31.1
2022,ISERE,Vénérieu,625,124,501,32,469,2,LREM,233,5.925,31.1
2022,ISERE,Leyrieu,642,148,494,37,457,2,FN,242,5.925,31.1
2022,ISERE,Leyrieu,642,148,494,37,457,2,LREM,215,5.925,31.1
2022,ISERE,Pact,643,120,523,44,479,2,FN,297,5.925,31.1
2022,ISERE,Pact,643,120,523,44,479,2,LREM,182,5.925,31.1
2022,ISERE,Soleymieu,651,154,497,47,450,2,FN,251,5.925,31.1
2022,ISERE,Soleymieu,651,154,497,47,450,2,LREM,199,5.925,31.1
2022,ISERE,Charancieu,651,162,489,53,436,2,FN,237,5.925,31.1
2022,ISERE,Charancieu,651,162,489,53,436,2,LREM,199,5.925,31.1
2022,ISERE,Saint-Baudille-de-la-Tour,655,157,498,46,452,2,FN,255,5.925,31.1
2022,ISERE,Saint-Baudille-de-la-Tour,655,157,498,46,452,2,LREM,197,5.925,31.1
2022,ISERE,Saint-Honoré,658,130,528,87,441,2,FN,221,5.925,31.1
2022,ISERE,Saint-Honoré,658,130,528,87,441,2,LREM,220,5.925,31.1
2022,ISERE,Saint-Christophe-sur-Guiers,661,141,520,51,469,2,FN,225,5.925,31.1
2022,ISERE,Saint-Christophe-sur-Guiers,661,141,520,51,469,2,LREM,244,5.925,31.1
2022,ISERE,Doissin,664,106,558,50,508,2,FN,257,5.925,31.1
2022,ISERE,Doissin,664,106,558,50,508,2,LREM,251,5.925,31.1
2022,ISERE,Murianette,664,112,552,40,512,2,FN,210,5.925,31.1
2022,ISERE,Murianette,664,112,552,40,512,2,LREM,302,5.925,31.1
2022,ISERE,Optevoz,664,138,526,35,491,2,FN,284,5.925,31.1
2022,ISERE,Optevoz,664,138,526,35,491,2,LREM,207,5.925,31.1
2022,ISERE,Saint-Barthélemy,676,176,500,42,458,2,FN,247,5.925,31.1
2022,ISERE,Saint-Barthélemy,676,176,500,42,458,2,LREM,211,5.925,31.1
2022,ISERE,Cour-et-Buis,677,169,508,36,472,2,FN,254,5.925,31.1
2022,ISERE,Cour-et-Buis,677,169,508,36,472,2,LREM,218,5.925,31.1
2022,ISERE,Montseveroux,692,136,556,52,504,2,FN,279,5.925,31.1
2022,ISERE,Montseveroux,692,136,556,52,504,2,LREM,225,5.925,31.1
2022,ISERE,Le Passage,702,106,596,49,547,2,FN,245,5.925,31.1
2022,ISERE,Le Passage,702,106,596,49,547,2,LREM,302,5.925,31.1
2022,ISERE,Savas-Mépin,704,136,568,40,528,2,FN,328,5.925,31.1
2022,ISERE,Savas-Mépin,704,136,568,40,528,2,LREM,200,5.925,31.1
2022,ISERE,Saint-Jean-d'Avelanne,704,156,548,58,490,2,FN,249,5.925,31.1
2022,ISERE,Saint-Jean-d'Avelanne,704,156,548,58,490,2,LREM,241,5.925,31.1
2022,ISERE,Meyrieu-les-Etangs,718,130,588,54,534,2,FN,265,5.925,31.1
2022,ISERE,Meyrieu-les-Etangs,718,130,588,54,534,2,LREM,269,5.925,31.1
2022,ISERE,Saint-Alban-du-Rhône,718,195,523,45,478,2,FN,277,5.925,31.1
2022,ISERE,Saint-Alban-du-Rhône,718,195,523,45,478,2,LREM,201,5.925,31.1
2022,ISERE,Varacieux,719,142,577,51,526,2,FN,294,5.925,31.1
2022,ISERE,Varacieux,719,142,577,51,526,2,LREM,232,5.925,31.1
2022,ISERE,Ornacieux-Balbins,723,110,613,58,555,2,FN,244,5.925,31.1
2022,ISERE,Ornacieux-Balbins,723,110,613,58,555,2,LREM,311,5.925,31.1
2022,ISERE,La Balme-les-Grottes,728,162,566,41,525,2,FN,321,5.925,31.1
2022,ISERE,La Balme-les-Grottes,728,162,566,41,525,2,LREM,204,5.925,31.1
2022,ISERE,Saint-Sorlin-de-Vienne,729,105,624,56,568,2,FN,308,5.925,31.1
2022,ISERE,Saint-Sorlin-de-Vienne,729,105,624,56,568,2,LREM,260,5.925,31.1
2022,ISERE,Bizonnes,744,143,601,36,565,2,FN,346,5.925,31.1
2022,ISERE,Bizonnes,744,143,601,36,565,2,LREM,219,5.925,31.1
2022,ISERE,Pajay,749,160,589,61,528,2,FN,288,5.925,31.1
2022,ISERE,Pajay,749,160,589,61,528,2,LREM,240,5.925,31.1
2022,ISERE,Les Eparres,751,180,571,41,530,2,FN,271,5.925,31.1
2022,ISERE,Les Eparres,751,180,571,41,530,2,LREM,259,5.925,31.1
2022,ISERE,Marcilloles,751,188,563,35,528,2,FN,286,5.925,31.1
2022,ISERE,Marcilloles,751,188,563,35,528,2,LREM,242,5.925,31.1
2022,ISERE,Anjou,752,186,566,53,513,2,FN,259,5.925,31.1
2022,ISERE,Anjou,752,186,566,53,513,2,LREM,254,5.925,31.1
2022,ISERE,Oyeu,762,146,616,54,562,2,FN,243,5.925,31.1
2022,ISERE,Oyeu,762,146,616,54,562,2,LREM,319,5.925,31.1
2022,ISERE,Vignieu,773,178,595,46,549,2,FN,310,5.925,31.1
2022,ISERE,Vignieu,773,178,595,46,549,2,LREM,239,5.925,31.1
2022,ISERE,Saint-Agnin-sur-Bion,780,133,647,59,588,2,FN,332,5.925,31.1
2022,ISERE,Saint-Agnin-sur-Bion,780,133,647,59,588,2,LREM,256,5.925,31.1
2022,ISERE,Faramans,784,145,639,43,596,2,FN,333,5.925,31.1
2022,ISERE,Faramans,784,145,639,43,596,2,LREM,263,5.925,31.1
2022,ISERE,Sardieu,789,153,636,40,596,2,FN,349,5.925,31.1
2022,ISERE,Sardieu,789,153,636,40,596,2,LREM,247,5.925,31.1
2022,ISERE,Réaumont,790,147,643,50,593,2,FN,217,5.925,31.1
2022,ISERE,Réaumont,790,147,643,50,593,2,LREM,376,5.925,31.1
2022,ISERE,Saint-Blaise-du-Buis,802,154,648,67,581,2,FN,230,5.925,31.1
2022,ISERE,Saint-Blaise-du-Buis,802,154,648,67,581,2,LREM,351,5.925,31.1
2022,ISERE,Saint-Nicolas-de-Macherin,806,138,668,68,600,2,FN,220,5.925,31.1
2022,ISERE,Saint-Nicolas-de-Macherin,806,138,668,68,600,2,LREM,380,5.925,31.1
2022,ISERE,Séchilienne,810,220,590,50,540,2,FN,267,5.925,31.1
2022,ISERE,Séchilienne,810,220,590,50,540,2,LREM,273,5.925,31.1
2022,ISERE,Chozeau,816,140,676,53,623,2,FN,265,5.925,31.1
2022,ISERE,Chozeau,816,140,676,53,623,2,LREM,358,5.925,31.1
2022,ISERE,Villeneuve-de-Marc,817,164,653,71,582,2,FN,313,5.925,31.1
2022,ISERE,Villeneuve-de-Marc,817,164,653,71,582,2,LREM,269,5.925,31.1
2022,ISERE,Bévenais,822,174,648,67,581,2,FN,303,5.925,31.1
2022,ISERE,Bévenais,822,174,648,67,581,2,LREM,278,5.925,31.1
2022,ISERE,Bellegarde-Poussieu,823,165,658,48,610,2,FN,317,5.925,31.1
2022,ISERE,Bellegarde-Poussieu,823,165,658,48,610,2,LREM,293,5.925,31.1
2022,ISERE,Quaix-en-Chartreuse,825,163,662,49,613,2,FN,165,5.925,31.1
2022,ISERE,Quaix-en-Chartreuse,825,163,662,49,613,2,LREM,448,5.925,31.1
2022,ISERE,Hières-sur-Amby,825,236,589,26,563,2,FN,340,5.925,31.1
2022,ISERE,Hières-sur-Amby,825,236,589,26,563,2,LREM,223,5.925,31.1
2022,ISERE,Beauvoir-de-Marc,831,195,636,44,592,2,FN,312,5.925,31.1
2022,ISERE,Beauvoir-de-Marc,831,195,636,44,592,2,LREM,280,5.925,31.1
2022,ISERE,Sainte-Blandine,833,160,673,63,610,2,FN,345,5.925,31.1
2022,ISERE,Sainte-Blandine,833,160,673,63,610,2,LREM,265,5.925,31.1
2022,ISERE,Livet-et-Gavet,835,257,578,60,518,2,FN,315,5.925,31.1
2022,ISERE,Livet-et-Gavet,835,257,578,60,518,2,LREM,203,5.925,31.1
2022,ISERE,Sérézin-de-la-Tour,838,168,670,38,632,2,FN,320,5.925,31.1
2022,ISERE,Sérézin-de-la-Tour,838,168,670,38,632,2,LREM,312,5.925,31.1
2022,ISERE,Roybon,838,218,620,59,561,2,FN,230,5.925,31.1
2022,ISERE,Roybon,838,218,620,59,561,2,LREM,331,5.925,31.1
2022,ISERE,La Frette,842,194,648,42,606,2,FN,315,5.925,31.1
2022,ISERE,La Frette,842,194,648,42,606,2,LREM,291,5.925,31.1
2022,ISERE,Poliénas,847,170,677,78,599,2,FN,312,5.925,31.1
2022,ISERE,Poliénas,847,170,677,78,599,2,LREM,287,5.925,31.1
2022,ISERE,Les Adrets,855,187,668,62,606,2,FN,156,5.925,31.1
2022,ISERE,Les Adrets,855,187,668,62,606,2,LREM,450,5.925,31.1
2022,ISERE,Gillonnay,859,143,716,68,648,2,FN,332,5.925,31.1
2022,ISERE,Gillonnay,859,143,716,68,648,2,LREM,316,5.925,31.1
2022,ISERE,Jarcieu,866,196,670,69,601,2,FN,302,5.925,31.1
2022,ISERE,Jarcieu,866,196,670,69,601,2,LREM,299,5.925,31.1
2022,ISERE,Cheyssieu,867,224,643,46,597,2,FN,300,5.925,31.1
2022,ISERE,Cheyssieu,867,224,643,46,597,2,LREM,297,5.925,31.1
2022,ISERE,Susville,871,231,640,60,580,2,FN,376,5.925,31.1
2022,ISERE,Susville,871,231,640,60,580,2,LREM,204,5.925,31.1
2022,ISERE,Revel-Tourdan,873,174,699,58,641,2,FN,339,5.925,31.1
2022,ISERE,Revel-Tourdan,873,174,699,58,641,2,LREM,302,5.925,31.1
2022,ISERE,Laval-en-Belledonne,878,170,708,74,634,2,FN,195,5.925,31.1
2022,ISERE,Laval-en-Belledonne,878,170,708,74,634,2,LREM,439,5.925,31.1
2022,ISERE,Allemond,879,261,618,66,552,2,FN,208,5.925,31.1
2022,ISERE,Allemond,879,261,618,66,552,2,LREM,344,5.925,31.1
2022,ISERE,Agnin,881,187,694,52,642,2,FN,350,5.925,31.1
2022,ISERE,Agnin,881,187,694,52,642,2,LREM,292,5.925,31.1
2022,ISERE,La Sure en Chartreuse,884,178,706,62,644,2,FN,189,5.925,31.1
2022,ISERE,La Sure en Chartreuse,884,178,706,62,644,2,LREM,455,5.925,31.1
2022,ISERE,Anthon,894,201,693,40,653,2,FN,334,5.925,31.1
2022,ISERE,Anthon,894,201,693,40,653,2,LREM,319,5.925,31.1
2022,ISERE,Bonnefamille,898,199,699,45,654,2,FN,316,5.925,31.1
2022,ISERE,Bonnefamille,898,199,699,45,654,2,LREM,338,5.925,31.1
2022,ISERE,Montagnieu,904,157,747,68,679,2,FN,402,5.925,31.1
2022,ISERE,Montagnieu,904,157,747,68,679,2,LREM,277,5.925,31.1
2022,ISERE,Saint-Aupre,908,139,769,67,702,2,FN,247,5.925,31.1
2022,ISERE,Saint-Aupre,908,139,769,67,702,2,LREM,455,5.925,31.1
2022,ISERE,Ville-sous-Anjou,924,190,734,64,670,2,FN,349,5.925,31.1
2022,ISERE,Ville-sous-Anjou,924,190,734,64,670,2,LREM,321,5.925,31.1
2022,ISERE,Pressins,925,194,731,56,675,2,FN,371,5.925,31.1
2022,ISERE,Pressins,925,194,731,56,675,2,LREM,304,5.925,31.1
2022,ISERE,Courtenay,926,205,721,58,663,2,FN,384,5.925,31.1
2022,ISERE,Courtenay,926,205,721,58,663,2,LREM,279,5.925,31.1
2022,ISERE,Saint-Nizier-du-Moucherotte,927,240,687,81,606,2,FN,136,5.925,31.1
2022,ISERE,Saint-Nizier-du-Moucherotte,927,240,687,81,606,2,LREM,470,5.925,31.1
2022,ISERE,Rochetoirin,942,213,729,65,664,2,FN,360,5.925,31.1
2022,ISERE,Rochetoirin,942,213,729,65,664,2,LREM,304,5.925,31.1
2022,ISERE,Saint-Cassien,950,203,747,70,677,2,FN,256,5.925,31.1
2022,ISERE,Saint-Cassien,950,203,747,70,677,2,LREM,421,5.925,31.1
2022,ISERE,Notre-Dame-de-Mésage,950,221,729,71,658,2,FN,295,5.925,31.1
2022,ISERE,Notre-Dame-de-Mésage,950,221,729,71,658,2,LREM,363,5.925,31.1
2022,ISERE,Meyrié,953,164,789,77,712,2,FN,255,5.925,31.1
2022,ISERE,Meyrié,953,164,789,77,712,2,LREM,457,5.925,31.1
2022,ISERE,Saint-Victor-de-Morestel,954,243,711,65,646,2,FN,370,5.925,31.1
2022,ISERE,Saint-Victor-de-Morestel,954,243,711,65,646,2,LREM,276,5.925,31.1
2022,ISERE,L'Albenc,954,255,699,70,629,2,FN,308,5.925,31.1
2022,ISERE,L'Albenc,954,255,699,70,629,2,LREM,321,5.925,31.1
2022,ISERE,Saint-Pierre-de-Chartreuse,956,187,769,101,668,2,FN,169,5.925,31.1
2022,ISERE,Saint-Pierre-de-Chartreuse,956,187,769,101,668,2,LREM,499,5.925,31.1
2022,ISERE,Le Sappey-en-Chartreuse,965,154,811,57,754,2,FN,120,5.925,31.1
2022,ISERE,Le Sappey-en-Chartreuse,965,154,811,57,754,2,LREM,634,5.925,31.1
2022,ISERE,Saint-Just-de-Claix,977,255,722,53,669,2,FN,370,5.925,31.1
2022,ISERE,Saint-Just-de-Claix,977,255,722,53,669,2,LREM,299,5.925,31.1
2022,ISERE,Champier,982,213,769,63,706,2,FN,426,5.925,31.1
2022,ISERE,Champier,982,213,769,63,706,2,LREM,280,5.925,31.1
2022,ISERE,Monestier-de-Clermont,983,235,748,72,676,2,FN,312,5.925,31.1
2022,ISERE,Monestier-de-Clermont,983,235,748,72,676,2,LREM,364,5.925,31.1
2022,ISERE,Saint-Antoine-l'Abbaye,987,220,767,95,672,2,FN,299,5.925,31.1
2022,ISERE,Saint-Antoine-l'Abbaye,987,220,767,95,672,2,LREM,373,5.925,31.1
2022,ISERE,Saint-Joseph-de-Rivière,995,247,748,79,669,2,FN,287,5.925,31.1
2022,ISERE,Saint-Joseph-de-Rivière,995,247,748,79,669,2,LREM,382,5.925,31.1
2022,ISERE,Champagnier,1001,145,856,70,786,2,FN,241,5.925,31.1
2022,ISERE,Champagnier,1001,145,856,70,786,2,LREM,545,5.925,31.1
2022,ISERE,Vaulnaveys-le-Bas,1021,200,821,68,753,2,FN,306,5.925,31.1
2022,ISERE,Vaulnaveys-le-Bas,1021,200,821,68,753,2,LREM,447,5.925,31.1
2022,ISERE,Sonnay,1030,228,802,53,749,2,FN,423,5.925,31.1
2022,ISERE,Sonnay,1030,228,802,53,749,2,LREM,326,5.925,31.1
2022,ISERE,Bougé-Chambalud,1047,181,866,64,802,2,FN,420,5.925,31.1
2022,ISERE,Bougé-Chambalud,1047,181,866,64,802,2,LREM,382,5.925,31.1
2022,ISERE,Grenay,1054,218,836,58,778,2,FN,404,5.925,31.1
2022,ISERE,Grenay,1054,218,836,58,778,2,LREM,374,5.925,31.1
2022,ISERE,Le Champ-près-Froges,1054,265,789,71,718,2,FN,293,5.925,31.1
2022,ISERE,Le Champ-près-Froges,1054,265,789,71,718,2,LREM,425,5.925,31.1
2022,ISERE,Vernioz,1062,202,860,81,779,2,FN,418,5.925,31.1
2022,ISERE,Vernioz,1062,202,860,81,779,2,LREM,361,5.925,31.1
2022,ISERE,Eclose-Badinières,1079,216,863,65,798,2,FN,446,5.925,31.1
2022,ISERE,Eclose-Badinières,1079,216,863,65,798,2,LREM,352,5.925,31.1
2022,ISERE,Val-de-Virieu,1092,293,799,52,747,2,FN,366,5.925,31.1
2022,ISERE,Val-de-Virieu,1092,293,799,52,747,2,LREM,381,5.925,31.1
2022,ISERE,Saint-Quentin-sur-Isère,1096,241,855,84,771,2,FN,347,5.925,31.1
2022,ISERE,Saint-Quentin-sur-Isère,1096,241,855,84,771,2,LREM,424,5.925,31.1
2022,ISERE,Four,1097,182,915,97,818,2,FN,397,5.925,31.1
2022,ISERE,Four,1097,182,915,97,818,2,LREM,421,5.925,31.1
2022,ISERE,Chimilin,1097,253,844,67,777,2,FN,428,5.925,31.1
2022,ISERE,Chimilin,1097,253,844,67,777,2,LREM,349,5.925,31.1
2022,ISERE,Bouvesse-Quirieu,1105,272,833,89,744,2,FN,471,5.925,31.1
2022,ISERE,Bouvesse-Quirieu,1105,272,833,89,744,2,LREM,273,5.925,31.1
2022,ISERE,Veurey-Voroize,1108,253,855,58,797,2,FN,309,5.925,31.1
2022,ISERE,Veurey-Voroize,1108,253,855,58,797,2,LREM,488,5.925,31.1
2022,ISERE,Saint-Lattier,1110,256,854,83,771,2,FN,393,5.925,31.1
2022,ISERE,Saint-Lattier,1110,256,854,83,771,2,LREM,378,5.925,31.1
2022,ISERE,Pierre-Châtel,1113,256,857,101,756,2,FN,406,5.925,31.1
2022,ISERE,Pierre-Châtel,1113,256,857,101,756,2,LREM,350,5.925,31.1
2022,ISERE,Salagnon,1129,254,875,47,828,2,FN,462,5.925,31.1
2022,ISERE,Salagnon,1129,254,875,47,828,2,LREM,366,5.925,31.1
2022,ISERE,Faverges-de-la-Tour,1133,256,877,93,784,2,FN,407,5.925,31.1
2022,ISERE,Faverges-de-la-Tour,1133,256,877,93,784,2,LREM,377,5.925,31.1
2022,ISERE,Viriville,1135,263,872,74,798,2,FN,408,5.925,31.1
2022,ISERE,Viriville,1135,263,872,74,798,2,LREM,390,5.925,31.1
2022,ISERE,Saint-Hilaire-de-la-Côte,1144,235,909,84,825,2,FN,399,5.925,31.1
2022,ISERE,Saint-Hilaire-de-la-Côte,1144,235,909,84,825,2,LREM,426,5.925,31.1
2022,ISERE,Huez,1144,245,899,74,825,2,FN,301,5.925,31.1
2022,ISERE,Huez,1144,245,899,74,825,2,LREM,524,5.925,31.1
2022,ISERE,Auberives-sur-Varèze,1144,317,827,85,742,2,FN,421,5.925,31.1
2022,ISERE,Auberives-sur-Varèze,1144,317,827,85,742,2,LREM,321,5.925,31.1
2022,ISERE,Biol,1145,206,939,81,858,2,FN,468,5.925,31.1
2022,ISERE,Biol,1145,206,939,81,858,2,LREM,390,5.925,31.1
2022,ISERE,Saint-Prim,1146,268,878,58,820,2,FN,400,5.925,31.1
2022,ISERE,Saint-Prim,1146,268,878,58,820,2,LREM,420,5.925,31.1
2022,ISERE,Saint-Jean-de-Soudain,1148,286,862,83,779,2,FN,385,5.925,31.1
2022,ISERE,Saint-Jean-de-Soudain,1148,286,862,83,779,2,LREM,394,5.925,31.1
2022,ISERE,Herbeys,1165,204,961,84,877,2,FN,195,5.925,31.1
2022,ISERE,Herbeys,1165,204,961,84,877,2,LREM,682,5.925,31.1
2022,ISERE,Saint-Marcel-Bel-Accueil,1197,239,958,77,881,2,FN,340,5.925,31.1
2022,ISERE,Saint-Marcel-Bel-Accueil,1197,239,958,77,881,2,LREM,541,5.925,31.1
2022,ISERE,Assieu,1200,248,952,75,877,2,FN,455,5.925,31.1
2022,ISERE,Assieu,1200,248,952,75,877,2,LREM,422,5.925,31.1
2022,ISERE,Creys-Mépieu,1206,266,940,86,854,2,FN,523,5.925,31.1
2022,ISERE,Creys-Mépieu,1206,266,940,86,854,2,LREM,331,5.925,31.1
2022,ISERE,Revel,1213,257,956,85,871,2,FN,207,5.925,31.1
2022,ISERE,Revel,1213,257,956,85,871,2,LREM,664,5.925,31.1
2022,ISERE,Mens,1225,306,919,111,808,2,FN,299,5.925,31.1
2022,ISERE,Mens,1225,306,919,111,808,2,LREM,509,5.925,31.1
2022,ISERE,Beaucroissant,1231,230,1001,104,897,2,FN,433,5.925,31.1
2022,ISERE,Beaucroissant,1231,230,1001,104,897,2,LREM,464,5.925,31.1
2022,ISERE,Domarin,1232,301,931,77,854,2,FN,332,5.925,31.1
2022,ISERE,Domarin,1232,301,931,77,854,2,LREM,522,5.925,31.1
2022,ISERE,Clonas-sur-Varèze,1247,270,977,87,890,2,FN,432,5.925,31.1
2022,ISERE,Clonas-sur-Varèze,1247,270,977,87,890,2,LREM,458,5.925,31.1
2022,ISERE,Janneyrias,1265,245,1020,79,941,2,FN,524,5.925,31.1
2022,ISERE,Janneyrias,1265,245,1020,79,941,2,LREM,417,5.925,31.1
2022,ISERE,Chamagnieu,1271,250,1021,83,938,2,FN,435,5.925,31.1
2022,ISERE,Chamagnieu,1271,250,1021,83,938,2,LREM,503,5.925,31.1
2022,ISERE,Saint-Vincent-de-Mercuze,1273,252,1021,77,944,2,FN,304,5.925,31.1
2022,ISERE,Saint-Vincent-de-Mercuze,1273,252,1021,77,944,2,LREM,640,5.925,31.1
2022,ISERE,Charnècles,1282,269,1013,84,929,2,FN,359,5.925,31.1
2022,ISERE,Charnècles,1282,269,1013,84,929,2,LREM,570,5.925,31.1
2022,ISERE,Bilieu,1293,324,969,98,871,2,FN,371,5.925,31.1
2022,ISERE,Bilieu,1293,324,969,98,871,2,LREM,500,5.925,31.1
2022,ISERE,Chonas-l'Amballan,1316,248,1068,85,983,2,FN,398,5.925,31.1
2022,ISERE,Chonas-l'Amballan,1316,248,1068,85,983,2,LREM,585,5.925,31.1
2022,ISERE,Colombe,1323,254,1069,84,985,2,FN,441,5.925,31.1
2022,ISERE,Colombe,1323,254,1069,84,985,2,LREM,544,5.925,31.1
2022,ISERE,Montferrat,1327,279,1048,97,951,2,FN,428,5.925,31.1
2022,ISERE,Montferrat,1327,279,1048,97,951,2,LREM,523,5.925,31.1
2022,ISERE,Artas,1332,302,1030,98,932,2,FN,499,5.925,31.1
2022,ISERE,Artas,1332,302,1030,98,932,2,LREM,433,5.925,31.1
2022,ISERE,Sermérieu,1333,257,1076,79,997,2,FN,555,5.925,31.1
2022,ISERE,Sermérieu,1333,257,1076,79,997,2,LREM,442,5.925,31.1
2022,ISERE,La Motte-d'Aveillans,1333,347,986,83,903,2,FN,500,5.925,31.1
2022,ISERE,La Motte-d'Aveillans,1333,347,986,83,903,2,LREM,403,5.925,31.1
2022,ISERE,Entre-deux-Guiers,1334,345,989,85,904,2,FN,487,5.925,31.1
2022,ISERE,Entre-deux-Guiers,1334,345,989,85,904,2,LREM,417,5.925,31.1
2022,ISERE,Les Roches-de-Condrieu,1335,291,1044,87,957,2,FN,439,5.925,31.1
2022,ISERE,Les Roches-de-Condrieu,1335,291,1044,87,957,2,LREM,518,5.925,31.1
2022,ISERE,Romagnieu,1337,275,1062,70,992,2,FN,524,5.925,31.1
2022,ISERE,Romagnieu,1337,275,1062,70,992,2,LREM,468,5.925,31.1
2022,ISERE,Porcieu-Amblagnieu,1337,373,964,71,893,2,FN,507,5.925,31.1
2022,ISERE,Porcieu-Amblagnieu,1337,373,964,71,893,2,LREM,386,5.925,31.1
2022,ISERE,Saint-Vérand,1339,273,1066,96,970,2,FN,391,5.925,31.1
2022,ISERE,Saint-Vérand,1339,273,1066,96,970,2,LREM,579,5.925,31.1
2022,ISERE,Tencin,1339,320,1019,81,938,2,FN,449,5.925,31.1
2022,ISERE,Tencin,1339,320,1019,81,938,2,LREM,489,5.925,31.1
2022,ISERE,Oytier-Saint-Oblas,1341,309,1032,68,964,2,FN,506,5.925,31.1
2022,ISERE,Oytier-Saint-Oblas,1341,309,1032,68,964,2,LREM,458,5.925,31.1
2022,ISERE,Saint-Sauveur,1349,273,1076,83,993,2,FN,457,5.925,31.1
2022,ISERE,Saint-Sauveur,1349,273,1076,83,993,2,LREM,536,5.925,31.1
2022,ISERE,Arandon-Passins,1360,324,1036,71,965,2,FN,612,5.925,31.1
2022,ISERE,Arandon-Passins,1360,324,1036,71,965,2,LREM,353,5.925,31.1
2022,ISERE,La Bâtie-Montgascon,1361,299,1062,106,956,2,FN,528,5.925,31.1
2022,ISERE,La Bâtie-Montgascon,1361,299,1062,106,956,2,LREM,428,5.925,31.1
2022,ISERE,Vourey,1362,301,1061,73,988,2,FN,352,5.925,31.1
2022,ISERE,Vourey,1362,301,1061,73,988,2,LREM,636,5.925,31.1
2022,ISERE,Saint-Romans,1380,277,1103,108,995,2,FN,456,5.925,31.1
2022,ISERE,Saint-Romans,1380,277,1103,108,995,2,LREM,539,5.925,31.1
2022,ISERE,Sillans,1450,331,1119,97,1022,2,FN,548,5.925,31.1
2022,ISERE,Sillans,1450,331,1119,97,1022,2,LREM,474,5.925,31.1
2022,ISERE,Miribel-les-Echelles,1457,382,1075,107,968,2,FN,422,5.925,31.1
2022,ISERE,Miribel-les-Echelles,1457,382,1075,107,968,2,LREM,546,5.925,31.1
2022,ISERE,Serpaize,1459,267,1192,87,1105,2,FN,533,5.925,31.1
2022,ISERE,Serpaize,1459,267,1192,87,1105,2,LREM,572,5.925,31.1
2022,ISERE,Châtonnay,1459,327,1132,64,1068,2,FN,589,5.925,31.1
2022,ISERE,Châtonnay,1459,327,1132,64,1068,2,LREM,479,5.925,31.1
2022,ISERE,Villemoirieu,1465,310,1155,100,1055,2,FN,450,5.925,31.1
2022,ISERE,Villemoirieu,1465,310,1155,100,1055,2,LREM,605,5.925,31.1
2022,ISERE,Charantonnay,1467,301,1166,96,1070,2,FN,604,5.925,31.1
2022,ISERE,Charantonnay,1467,301,1166,96,1070,2,LREM,466,5.925,31.1
2022,ISERE,Villette-de-Vienne,1468,274,1194,78,1116,2,FN,525,5.925,31.1
2022,ISERE,Villette-de-Vienne,1468,274,1194,78,1116,2,LREM,591,5.925,31.1
2022,ISERE,Reventin-Vaugris,1484,298,1186,111,1075,2,FN,521,5.925,31.1
2022,ISERE,Reventin-Vaugris,1484,298,1186,111,1075,2,LREM,554,5.925,31.1
2022,ISERE,Maubec,1499,310,1189,97,1092,2,FN,413,5.925,31.1
2022,ISERE,Maubec,1499,310,1189,97,1092,2,LREM,679,5.925,31.1
2022,ISERE,La Chapelle-de-la-Tour,1506,273,1233,104,1129,2,FN,582,5.925,31.1
2022,ISERE,La Chapelle-de-la-Tour,1506,273,1233,104,1129,2,LREM,547,5.925,31.1
2022,ISERE,La Murette,1510,319,1191,85,1106,2,FN,345,5.925,31.1
2022,ISERE,La Murette,1510,319,1191,85,1106,2,LREM,761,5.925,31.1
2022,ISERE,Sablons,1516,372,1144,94,1050,2,FN,591,5.925,31.1
2022,ISERE,Sablons,1516,372,1144,94,1050,2,LREM,459,5.925,31.1
2022,ISERE,Le Gua,1523,352,1171,129,1042,2,FN,432,5.925,31.1
2022,ISERE,Le Gua,1523,352,1171,129,1042,2,LREM,610,5.925,31.1
2022,ISERE,Charavines,1542,401,1141,85,1056,2,FN,454,5.925,31.1
2022,ISERE,Charavines,1542,401,1141,85,1056,2,LREM,602,5.925,31.1
2022,ISERE,Moidieu-Détourbe,1553,339,1214,97,1117,2,FN,592,5.925,31.1
2022,ISERE,Moidieu-Détourbe,1553,339,1214,97,1117,2,LREM,525,5.925,31.1
2022,ISERE,Barraux,1555,303,1252,95,1157,2,FN,445,5.925,31.1
2022,ISERE,Barraux,1555,303,1252,95,1157,2,LREM,712,5.925,31.1
2022,ISERE,Izeaux,1555,406,1149,106,1043,2,FN,529,5.925,31.1
2022,ISERE,Izeaux,1555,406,1149,106,1043,2,LREM,514,5.925,31.1
2022,ISERE,Trept,1556,350,1206,89,1117,2,FN,614,5.925,31.1
2022,ISERE,Trept,1556,350,1206,89,1117,2,LREM,503,5.925,31.1
2022,ISERE,Châbons,1564,352,1212,105,1107,2,FN,582,5.925,31.1
2022,ISERE,Châbons,1564,352,1212,105,1107,2,LREM,525,5.925,31.1
2022,ISERE,Porte-des-Bonnevaux,1579,331,1248,104,1144,2,FN,621,5.925,31.1
2022,ISERE,Porte-des-Bonnevaux,1579,331,1248,104,1144,2,LREM,523,5.925,31.1
2022,ISERE,Saint-Victor-de-Cessieu,1589,373,1216,109,1107,2,FN,630,5.925,31.1
2022,ISERE,Saint-Victor-de-Cessieu,1589,373,1216,109,1107,2,LREM,477,5.925,31.1
2022,ISERE,Poisat,1592,304,1288,126,1162,2,FN,332,5.925,31.1
2022,ISERE,Poisat,1592,304,1288,126,1162,2,LREM,830,5.925,31.1
2022,ISERE,Brézins,1624,440,1184,99,1085,2,FN,564,5.925,31.1
2022,ISERE,Brézins,1624,440,1184,99,1085,2,LREM,521,5.925,31.1
2022,ISERE,Saint-Alban-de-Roche,1635,364,1271,93,1178,2,FN,444,5.925,31.1
2022,ISERE,Saint-Alban-de-Roche,1635,364,1271,93,1178,2,LREM,734,5.925,31.1
2022,ISERE,Saint-Hilaire-du-Rosier,1635,417,1218,111,1107,2,FN,600,5.925,31.1
2022,ISERE,Saint-Hilaire-du-Rosier,1635,417,1218,111,1107,2,LREM,507,5.925,31.1
2022,ISERE,Saint-Didier-de-la-Tour,1643,357,1286,93,1193,2,FN,686,5.925,31.1
2022,ISERE,Saint-Didier-de-la-Tour,1643,357,1286,93,1193,2,LREM,507,5.925,31.1
2022,ISERE,Septème,1647,357,1290,71,1219,2,FN,710,5.925,31.1
2022,ISERE,Septème,1647,357,1290,71,1219,2,LREM,509,5.925,31.1
2022,ISERE,Saint-Geoire-en-Valdaine,1662,426,1236,104,1132,2,FN,547,5.925,31.1
2022,ISERE,Saint-Geoire-en-Valdaine,1662,426,1236,104,1132,2,LREM,585,5.925,31.1
2022,ISERE,Les Côtes-d'Arey,1675,310,1365,107,1258,2,FN,534,5.925,31.1
2022,ISERE,Les Côtes-d'Arey,1675,310,1365,107,1258,2,LREM,724,5.925,31.1
2022,ISERE,Seyssuel,1678,326,1352,107,1245,2,FN,484,5.925,31.1
2022,ISERE,Seyssuel,1678,326,1352,107,1245,2,LREM,761,5.925,31.1
2022,ISERE,Noyarey,1704,366,1338,98,1240,2,FN,491,5.925,31.1
2022,ISERE,Noyarey,1704,366,1338,98,1240,2,LREM,749,5.925,31.1
2022,ISERE,Vézeronce-Curtin,1710,450,1260,100,1160,2,FN,685,5.925,31.1
2022,ISERE,Vézeronce-Curtin,1710,450,1260,100,1160,2,LREM,475,5.925,31.1
2022,ISERE,Frontonas,1711,305,1406,105,1301,2,FN,562,5.925,31.1
2022,ISERE,Frontonas,1711,305,1406,105,1301,2,LREM,739,5.925,31.1
2022,ISERE,Lumbin,1729,385,1344,88,1256,2,FN,397,5.925,31.1
2022,ISERE,Lumbin,1729,385,1344,88,1256,2,LREM,859,5.925,31.1
2022,ISERE,Chanas,1736,428,1308,109,1199,2,FN,685,5.925,31.1
2022,ISERE,Chanas,1736,428,1308,109,1199,2,LREM,514,5.925,31.1
2022,ISERE,Jardin,1751,347,1404,114,1290,2,FN,469,5.925,31.1
2022,ISERE,Jardin,1751,347,1404,114,1290,2,LREM,821,5.925,31.1
2022,ISERE,Roche,1766,325,1441,121,1320,2,FN,654,5.925,31.1
2022,ISERE,Roche,1766,325,1441,121,1320,2,LREM,666,5.925,31.1
2022,ISERE,Theys,1773,344,1429,133,1296,2,FN,462,5.925,31.1
2022,ISERE,Theys,1773,344,1429,133,1296,2,LREM,834,5.925,31.1
2022,ISERE,Les Deux-Alpes,1779,549,1230,91,1139,2,FN,430,5.925,31.1
2022,ISERE,Les Deux-Alpes,1779,549,1230,91,1139,2,LREM,709,5.925,31.1
2022,ISERE,Vaulx-Milieu,1783,354,1429,112,1317,2,FN,591,5.925,31.1
2022,ISERE,Vaulx-Milieu,1783,354,1429,112,1317,2,LREM,726,5.925,31.1
2022,ISERE,Chuzelles,1795,337,1458,116,1342,2,FN,602,5.925,31.1
2022,ISERE,Chuzelles,1795,337,1458,116,1342,2,LREM,740,5.925,31.1
2022,ISERE,Eyzin-Pinet,1800,403,1397,124,1273,2,FN,593,5.925,31.1
2022,ISERE,Eyzin-Pinet,1800,403,1397,124,1273,2,LREM,680,5.925,31.1
2022,ISERE,Plateau des Petites Roches,1828,510,1318,168,1150,2,FN,274,5.925,31.1
2022,ISERE,Plateau des Petites Roches,1828,510,1318,168,1150,2,LREM,876,5.925,31.1
2022,ISERE,Corbelin,1843,428,1415,106,1309,2,FN,690,5.925,31.1
2022,ISERE,Corbelin,1843,428,1415,106,1309,2,LREM,619,5.925,31.1
2022,ISERE,Aoste,1856,472,1384,97,1287,2,FN,730,5.925,31.1
2022,ISERE,Aoste,1856,472,1384,97,1287,2,LREM,557,5.925,31.1
2022,ISERE,Nivolas-Vermelle,1860,411,1449,114,1335,2,FN,607,5.925,31.1
2022,ISERE,Nivolas-Vermelle,1860,411,1449,114,1335,2,LREM,728,5.925,31.1
2022,ISERE,Saint-Georges-de-Commiers,1867,414,1453,125,1328,2,FN,646,5.925,31.1
2022,ISERE,Saint-Georges-de-Commiers,1867,414,1453,125,1328,2,LREM,682,5.925,31.1
2022,ISERE,Chirens,1873,469,1404,134,1270,2,FN,552,5.925,31.1
2022,ISERE,Chirens,1873,469,1404,134,1270,2,LREM,718,5.925,31.1
2022,ISERE,Goncelin,1914,483,1431,145,1286,2,FN,513,5.925,31.1
2022,ISERE,Goncelin,1914,483,1431,145,1286,2,LREM,773,5.925,31.1
2022,ISERE,Satolas-et-Bonce,1917,424,1493,88,1405,2,FN,763,5.925,31.1
2022,ISERE,Satolas-et-Bonce,1917,424,1493,88,1405,2,LREM,642,5.925,31.1
2022,ISERE,Saint-Paul-de-Varces,1945,350,1595,89,1506,2,FN,546,5.925,31.1
2022,ISERE,Saint-Paul-de-Varces,1945,350,1595,89,1506,2,LREM,960,5.925,31.1
2022,ISERE,Luzinay,1947,407,1540,118,1422,2,FN,651,5.925,31.1
2022,ISERE,Luzinay,1947,407,1540,118,1422,2,LREM,771,5.925,31.1
2022,ISERE,La Terrasse,1964,374,1590,130,1460,2,FN,517,5.925,31.1
2022,ISERE,La Terrasse,1964,374,1590,130,1460,2,LREM,943,5.925,31.1
2022,ISERE,Le Cheylas,1971,545,1426,154,1272,2,FN,538,5.925,31.1
2022,ISERE,Le Cheylas,1971,545,1426,154,1272,2,LREM,734,5.925,31.1
2022,ISERE,Biviers,2008,317,1691,120,1571,2,FN,344,5.925,31.1
2022,ISERE,Biviers,2008,317,1691,120,1571,2,LREM,1227,5.925,31.1
2022,ISERE,Le Grand-Lemps,2024,433,1591,142,1449,2,FN,652,5.925,31.1
2022,ISERE,Le Grand-Lemps,2024,433,1591,142,1449,2,LREM,797,5.925,31.1
2022,ISERE,Villages du lac de Paladru,2044,482,1562,132,1430,2,FN,667,5.925,31.1
2022,ISERE,Villages du lac de Paladru,2044,482,1562,132,1430,2,LREM,763,5.925,31.1
2022,ISERE,Valencin,2084,422,1662,126,1536,2,FN,751,5.925,31.1
2022,ISERE,Valencin,2084,422,1662,126,1536,2,LREM,785,5.925,31.1
2022,ISERE,Chatte,2092,505,1587,120,1467,2,FN,659,5.925,31.1
2022,ISERE,Chatte,2092,505,1587,120,1467,2,LREM,808,5.925,31.1
2022,ISERE,Saint-André-le-Gaz,2098,508,1590,133,1457,2,FN,822,5.925,31.1
2022,ISERE,Saint-André-le-Gaz,2098,508,1590,133,1457,2,LREM,635,5.925,31.1
2022,ISERE,Brié-et-Angonnes,2112,376,1736,113,1623,2,FN,581,5.925,31.1
2022,ISERE,Brié-et-Angonnes,2112,376,1736,113,1623,2,LREM,1042,5.925,31.1
2022,ISERE,Montalieu-Vercieu,2134,655,1479,110,1369,2,FN,831,5.925,31.1
2022,ISERE,Montalieu-Vercieu,2134,655,1479,110,1369,2,LREM,538,5.925,31.1
2022,ISERE,Saint-Siméon-de-Bressieux,2151,588,1563,150,1413,2,FN,714,5.925,31.1
2022,ISERE,Saint-Siméon-de-Bressieux,2151,588,1563,150,1413,2,LREM,699,5.925,31.1
2022,ISERE,Saint-Just-Chaleyssin,2155,464,1691,129,1562,2,FN,706,5.925,31.1
2022,ISERE,Saint-Just-Chaleyssin,2155,464,1691,129,1562,2,LREM,856,5.925,31.1
2022,ISERE,Diémoz,2213,486,1727,137,1590,2,FN,932,5.925,31.1
2022,ISERE,Diémoz,2213,486,1727,137,1590,2,LREM,658,5.925,31.1
2022,ISERE,Cessieu,2223,554,1669,121,1548,2,FN,865,5.925,31.1
2022,ISERE,Cessieu,2223,554,1669,121,1548,2,LREM,683,5.925,31.1
2022,ISERE,Le Pont-de-Beauvoisin,2250,578,1672,122,1550,2,FN,745,5.925,31.1
2022,ISERE,Le Pont-de-Beauvoisin,2250,578,1672,122,1550,2,LREM,805,5.925,31.1
2022,ISERE,Crémieu,2262,577,1685,125,1560,2,FN,652,5.925,31.1
2022,ISERE,Crémieu,2262,577,1685,125,1560,2,LREM,908,5.925,31.1
2022,ISERE,Lans-en-Vercors,2285,460,1825,175,1650,2,FN,419,5.925,31.1
2022,ISERE,Lans-en-Vercors,2285,460,1825,175,1650,2,LREM,1231,5.925,31.1
2022,ISERE,Renage,2294,614,1680,169,1511,2,FN,680,5.925,31.1
2022,ISERE,Renage,2294,614,1680,169,1511,2,LREM,831,5.925,31.1
2022,ISERE,Saint-Etienne-de-Crossey,2295,484,1811,140,1671,2,FN,450,5.925,31.1
2022,ISERE,Saint-Etienne-de-Crossey,2295,484,1811,140,1671,2,LREM,1221,5.925,31.1
2022,ISERE,Chapareillan,2307,498,1809,167,1642,2,FN,669,5.925,31.1
2022,ISERE,Chapareillan,2307,498,1809,167,1642,2,LREM,973,5.925,31.1
2022,ISERE,Saint-Etienne-de-Saint-Geoirs,2345,593,1752,131,1621,2,FN,807,5.925,31.1
2022,ISERE,Saint-Etienne-de-Saint-Geoirs,2345,593,1752,131,1621,2,LREM,814,5.925,31.1
2022,ISERE,Fontanil-Cornillon,2416,538,1878,160,1718,2,FN,587,5.925,31.1
2022,ISERE,Fontanil-Cornillon,2416,538,1878,160,1718,2,LREM,1131,5.925,31.1
2022,ISERE,Saint-Nazaire-les-Eymes,2421,427,1994,128,1866,2,FN,453,5.925,31.1
2022,ISERE,Saint-Nazaire-les-Eymes,2421,427,1994,128,1866,2,LREM,1413,5.925,31.1
2022,ISERE,Apprieu,2449,515,1934,197,1737,2,FN,754,5.925,31.1
2022,ISERE,Apprieu,2449,515,1934,197,1737,2,LREM,983,5.925,31.1
2022,ISERE,Saint-Romain-de-Jalionas,2469,491,1978,116,1862,2,FN,1056,5.925,31.1
2022,ISERE,Saint-Romain-de-Jalionas,2469,491,1978,116,1862,2,LREM,806,5.925,31.1
2022,ISERE,Dolomieu,2474,568,1906,139,1767,2,FN,937,5.925,31.1
2022,ISERE,Dolomieu,2474,568,1906,139,1767,2,LREM,830,5.925,31.1
2022,ISERE,Saint-Clair-de-la-Tour,2487,697,1790,132,1658,2,FN,852,5.925,31.1
2022,ISERE,Saint-Clair-de-la-Tour,2487,697,1790,132,1658,2,LREM,806,5.925,31.1
2022,ISERE,Champ-sur-Drac,2515,581,1934,182,1752,2,FN,909,5.925,31.1
2022,ISERE,Champ-sur-Drac,2515,581,1934,182,1752,2,LREM,843,5.925,31.1
2022,ISERE,Le Bourg-d'Oisans,2540,687,1853,149,1704,2,FN,739,5.925,31.1
2022,ISERE,Le Bourg-d'Oisans,2540,687,1853,149,1704,2,LREM,965,5.925,31.1
2022,ISERE,Le Touvet,2544,570,1974,171,1803,2,FN,629,5.925,31.1
2022,ISERE,Le Touvet,2544,570,1974,171,1803,2,LREM,1174,5.925,31.1
2022,ISERE,La Buisse,2578,580,1998,179,1819,2,FN,581,5.925,31.1
2022,ISERE,La Buisse,2578,580,1998,179,1819,2,LREM,1238,5.925,31.1
2022,ISERE,Crêts en Belledonne,2631,654,1977,165,1812,2,FN,810,5.925,31.1
2022,ISERE,Crêts en Belledonne,2631,654,1977,165,1812,2,LREM,1002,5.925,31.1
2022,ISERE,Froges,2655,736,1919,176,1743,2,FN,761,5.925,31.1
2022,ISERE,Froges,2655,736,1919,176,1743,2,LREM,982,5.925,31.1
2022,ISERE,Autrans-Méaudre en Vercors,2665,646,2019,210,1809,2,FN,487,5.925,31.1
2022,ISERE,Autrans-Méaudre en Vercors,2665,646,2019,210,1809,2,LREM,1322,5.925,31.1
2022,ISERE,Saint-Jean-de-Moirans,2668,659,2009,167,1842,2,FN,666,5.925,31.1
2022,ISERE,Saint-Jean-de-Moirans,2668,659,2009,167,1842,2,LREM,1176,5.925,31.1
2022,ISERE,Estrablin,2682,498,2184,190,1994,2,FN,928,5.925,31.1
2022,ISERE,Estrablin,2682,498,2184,190,1994,2,LREM,1066,5.925,31.1
2022,ISERE,Saint-Georges-d'Espéranche,2690,626,2064,171,1893,2,FN,967,5.925,31.1
2022,ISERE,Saint-Georges-d'Espéranche,2690,626,2064,171,1893,2,LREM,926,5.925,31.1
2022,ISERE,Saint-Chef,2698,600,2098,156,1942,2,FN,1009,5.925,31.1
2022,ISERE,Saint-Chef,2698,600,2098,156,1942,2,LREM,933,5.925,31.1
2022,ISERE,Bernin,2853,591,2262,146,2116,2,FN,504,5.925,31.1
2022,ISERE,Bernin,2853,591,2262,146,2116,2,LREM,1612,5.925,31.1
2022,ISERE,Morestel,2982,781,2201,141,2060,2,FN,1015,5.925,31.1
2022,ISERE,Morestel,2982,781,2201,141,2060,2,LREM,1045,5.925,31.1
2022,ISERE,Jarrie,3033,618,2415,202,2213,2,FN,811,5.925,31.1
2022,ISERE,Jarrie,3033,618,2415,202,2213,2,LREM,1402,5.925,31.1
2022,ISERE,Chavanoz,3037,834,2203,137,2066,2,FN,1042,5.925,31.1
2022,ISERE,Chavanoz,3037,834,2203,137,2066,2,LREM,1024,5.925,31.1
2022,ISERE,Saint-Clair-du-Rhône,3064,817,2247,205,2042,2,FN,1052,5.925,31.1
2022,ISERE,Saint-Clair-du-Rhône,3064,817,2247,205,2042,2,LREM,990,5.925,31.1
2022,ISERE,Vinay,3132,810,2322,199,2123,2,FN,1048,5.925,31.1
2022,ISERE,Vinay,3132,810,2322,199,2123,2,LREM,1075,5.925,31.1
2022,ISERE,Allevard,3135,945,2190,239,1951,2,FN,801,5.925,31.1
2022,ISERE,Allevard,3135,945,2190,239,1951,2,LREM,1150,5.925,31.1
2022,ISERE,Vaulnaveys-le-Haut,3225,754,2471,193,2278,2,FN,747,5.925,31.1
2022,ISERE,Vaulnaveys-le-Haut,3225,754,2471,193,2278,2,LREM,1531,5.925,31.1
2022,ISERE,Beaurepaire,3231,1011,2220,165,2055,2,FN,1088,5.925,31.1
2022,ISERE,Beaurepaire,3231,1011,2220,165,2055,2,LREM,967,5.925,31.1
2022,ISERE,Saint-Laurent-du-Pont,3260,755,2505,247,2258,2,FN,1091,5.925,31.1
2022,ISERE,Saint-Laurent-du-Pont,3260,755,2505,247,2258,2,LREM,1167,5.925,31.1
2022,ISERE,La Côte-Saint-André,3283,1041,2242,187,2055,2,FN,936,5.925,31.1
2022,ISERE,La Côte-Saint-André,3283,1041,2242,187,2055,2,LREM,1119,5.925,31.1
2022,ISERE,Pont-de-Chéruy,3305,1271,2034,128,1906,2,FN,965,5.925,31.1
2022,ISERE,Pont-de-Chéruy,3305,1271,2034,128,1906,2,LREM,941,5.925,31.1
2022,ISERE,Saint-Savin,3309,781,2528,182,2346,2,FN,1136,5.925,31.1
2022,ISERE,Saint-Savin,3309,781,2528,182,2346,2,LREM,1210,5.925,31.1
2022,ISERE,La Mure,3327,999,2328,236,2092,2,FN,1097,5.925,31.1
2022,ISERE,La Mure,3327,999,2328,236,2092,2,LREM,995,5.925,31.1
2022,ISERE,Salaise-sur-Sanne,3361,980,2381,211,2170,2,FN,1024,5.925,31.1
2022,ISERE,Salaise-sur-Sanne,3361,980,2381,211,2170,2,LREM,1146,5.925,31.1
2022,ISERE,Corenc,3364,626,2738,178,2560,2,FN,520,5.925,31.1
2022,ISERE,Corenc,3364,626,2738,178,2560,2,LREM,2040,5.925,31.1
2022,ISERE,Heyrieux,3423,744,2679,206,2473,2,FN,1290,5.925,31.1
2022,ISERE,Heyrieux,3423,744,2679,206,2473,2,LREM,1183,5.925,31.1
2022,ISERE,Villette-d'Anthon,3455,614,2841,165,2676,2,FN,1289,5.925,31.1
2022,ISERE,Villette-d'Anthon,3455,614,2841,165,2676,2,LREM,1387,5.925,31.1
2022,ISERE,Saint-Quentin-Fallavier,3458,918,2540,230,2310,2,FN,1136,5.925,31.1
2022,ISERE,Saint-Quentin-Fallavier,3458,918,2540,230,2310,2,LREM,1174,5.925,31.1
2022,ISERE,Saint-Jean-de-Bournay,3467,731,2736,248,2488,2,FN,1334,5.925,31.1
2022,ISERE,Saint-Jean-de-Bournay,3467,731,2736,248,2488,2,LREM,1154,5.925,31.1
2022,ISERE,Le Versoud,3509,707,2802,227,2575,2,FN,926,5.925,31.1
2022,ISERE,Le Versoud,3509,707,2802,227,2575,2,LREM,1649,5.925,31.1
2022,ISERE,Saint-Martin-le-Vinoux,3586,1075,2511,224,2287,2,FN,631,5.925,31.1
2022,ISERE,Saint-Martin-le-Vinoux,3586,1075,2511,224,2287,2,LREM,1656,5.925,31.1
2022,ISERE,Pont-Evêque,3658,1328,2330,195,2135,2,FN,838,5.925,31.1
2022,ISERE,Pont-Evêque,3658,1328,2330,195,2135,2,LREM,1297,5.925,31.1
2022,ISERE,Le Péage-de-Roussillon,3690,1322,2368,168,2200,2,FN,953,5.925,31.1
2022,ISERE,Le Péage-de-Roussillon,3690,1322,2368,168,2200,2,LREM,1247,5.925,31.1
2022,ISERE,Ruy-Montceau,3751,770,2981,228,2753,2,FN,1186,5.925,31.1
2022,ISERE,Ruy-Montceau,3751,770,2981,228,2753,2,LREM,1567,5.925,31.1
2022,ISERE,Chasse-sur-Rhône,3828,1193,2635,212,2423,2,FN,1212,5.925,31.1
2022,ISERE,Chasse-sur-Rhône,3828,1193,2635,212,2423,2,LREM,1211,5.925,31.1
2022,ISERE,Villard-de-Lans,4062,1007,3055,262,2793,2,FN,907,5.925,31.1
2022,ISERE,Villard-de-Lans,4062,1007,3055,262,2793,2,LREM,1886,5.925,31.1
2022,ISERE,La Tronche,4070,900,3170,215,2955,2,FN,553,5.925,31.1
2022,ISERE,La Tronche,4070,900,3170,215,2955,2,LREM,2402,5.925,31.1
2022,ISERE,Coublevie,4149,914,3235,247,2988,2,FN,751,5.925,31.1
2022,ISERE,Coublevie,4149,914,3235,247,2988,2,LREM,2237,5.925,31.1
2022,ISERE,Montbonnot-Saint-Martin,4202,744,3458,206,3252,2,FN,796,5.925,31.1
2022,ISERE,Montbonnot-Saint-Martin,4202,744,3458,206,3252,2,LREM,2456,5.925,31.1
2022,ISERE,Rives,4242,1124,3118,257,2861,2,FN,1300,5.925,31.1
2022,ISERE,Rives,4242,1124,3118,257,2861,2,LREM,1561,5.925,31.1
2022,ISERE,Saint-Maurice-l'Exil,4249,1386,2863,225,2638,2,FN,1359,5.925,31.1
2022,ISERE,Saint-Maurice-l'Exil,4249,1386,2863,225,2638,2,LREM,1279,5.925,31.1
2022,ISERE,Gières,4520,1063,3457,258,3199,2,FN,978,5.925,31.1
2022,ISERE,Gières,4520,1063,3457,258,3199,2,LREM,2221,5.925,31.1
2022,ISERE,Les Abrets en Dauphiné,4548,1106,3442,274,3168,2,FN,1794,5.925,31.1
2022,ISERE,Les Abrets en Dauphiné,4548,1106,3442,274,3168,2,LREM,1374,5.925,31.1
2022,ISERE,La Verpillière,4605,1391,3214,254,2960,2,FN,1386,5.925,31.1
2022,ISERE,La Verpillière,4605,1391,3214,254,2960,2,LREM,1574,5.925,31.1
2022,ISERE,Saint-Martin-d'Uriage,4674,890,3784,248,3536,2,FN,815,5.925,31.1
2022,ISERE,Saint-Martin-d'Uriage,4674,890,3784,248,3536,2,LREM,2721,5.925,31.1
2022,ISERE,La Tour-du-Pin,4924,1690,3234,243,2991,2,FN,1344,5.925,31.1
2022,ISERE,La Tour-du-Pin,4924,1690,3234,243,2991,2,LREM,1647,5.925,31.1
2022,ISERE,Vizille,4979,1667,3312,284,3028,2,FN,1377,5.925,31.1
2022,ISERE,Vizille,4979,1667,3312,284,3028,2,LREM,1651,5.925,31.1
2022,ISERE,Domène,5049,1350,3699,336,3363,2,FN,1375,5.925,31.1
2022,ISERE,Domène,5049,1350,3699,336,3363,2,LREM,1988,5.925,31.1
2022,ISERE,Villard-Bonnot,5144,1392,3752,317,3435,2,FN,1389,5.925,31.1
2022,ISERE,Villard-Bonnot,5144,1392,3752,317,3435,2,LREM,2046,5.925,31.1
2022,ISERE,Saint-Marcellin,5205,1462,3743,384,3359,2,FN,1366,5.925,31.1
2022,ISERE,Saint-Marcellin,5205,1462,3743,384,3359,2,LREM,1993,5.925,31.1
2022,ISERE,Pontcharra,5221,1398,3823,317,3506,2,FN,1508,5.925,31.1
2022,ISERE,Pontcharra,5221,1398,3823,317,3506,2,LREM,1998,5.925,31.1
2022,ISERE,Varces-Allières-et-Risset,5265,1309,3956,289,3667,2,FN,1493,5.925,31.1
2022,ISERE,Varces-Allières-et-Risset,5265,1309,3956,289,3667,2,LREM,2174,5.925,31.1
2022,ISERE,Tignieu-Jameyzieu,5324,1502,3822,237,3585,2,FN,1806,5.925,31.1
2022,ISERE,Tignieu-Jameyzieu,5324,1502,3822,237,3585,2,LREM,1779,5.925,31.1
2022,ISERE,Roussillon,5572,1792,3780,346,3434,2,FN,1590,5.925,31.1
2022,ISERE,Roussillon,5572,1792,3780,346,3434,2,LREM,1844,5.925,31.1
2022,ISERE,Tullins,5591,1703,3888,329,3559,2,FN,1502,5.925,31.1
2022,ISERE,Tullins,5591,1703,3888,329,3559,2,LREM,2057,5.925,31.1
2022,ISERE,Seyssins,5838,1088,4750,372,4378,2,FN,1315,5.925,31.1
2022,ISERE,Seyssins,5838,1088,4750,372,4378,2,LREM,3063,5.925,31.1
2022,ISERE,Les Avenières Veyrins-Thuellin,5918,1651,4267,309,3958,2,FN,2253,5.925,31.1
2022,ISERE,Les Avenières Veyrins-Thuellin,5918,1651,4267,309,3958,2,LREM,1705,5.925,31.1
2022,ISERE,Saint-Ismier,5974,1177,4797,275,4522,2,FN,1034,5.925,31.1
2022,ISERE,Saint-Ismier,5974,1177,4797,275,4522,2,LREM,3488,5.925,31.1
2022,ISERE,Moirans,6069,1839,4230,408,3822,2,FN,1547,5.925,31.1
2022,ISERE,Moirans,6069,1839,4230,408,3822,2,LREM,2275,5.925,31.1
2022,ISERE,Le Pont-de-Claix,6502,2355,4147,357,3790,2,FN,1581,5.925,31.1
2022,ISERE,Le Pont-de-Claix,6502,2355,4147,357,3790,2,LREM,2209,5.925,31.1
2022,ISERE,Charvieu-Chavagneux,6505,1971,4534,291,4243,2,FN,2321,5.925,31.1
2022,ISERE,Charvieu-Chavagneux,6505,1971,4534,291,4243,2,LREM,1922,5.925,31.1
2022,ISERE,Claix,6650,1540,5110,383,4727,2,FN,1360,5.925,31.1
2022,ISERE,Claix,6650,1540,5110,383,4727,2,LREM,3367,5.925,31.1
2022,ISERE,Crolles,6653,1487,5166,412,4754,2,FN,1195,5.925,31.1
2022,ISERE,Crolles,6653,1487,5166,412,4754,2,LREM,3559,5.925,31.1
2022,ISERE,Vif,6676,1638,5038,400,4638,2,FN,2073,5.925,31.1
2022,ISERE,Vif,6676,1638,5038,400,4638,2,LREM,2565,5.925,31.1
2022,ISERE,Voreppe,6903,1535,5368,443,4925,2,FN,1702,5.925,31.1
2022,ISERE,Voreppe,6903,1535,5368,443,4925,2,LREM,3223,5.925,31.1
2022,ISERE,Eybens,7042,1876,5166,431,4735,2,FN,1550,5.925,31.1
2022,ISERE,Eybens,7042,1876,5166,431,4735,2,LREM,3185,5.925,31.1
2022,ISERE,Sassenage,8033,1794,6239,449,5790,2,FN,2242,5.925,31.1
2022,ISERE,Sassenage,8033,1794,6239,449,5790,2,LREM,3548,5.925,31.1
2022,ISERE,Seyssinet-Pariset,8325,2103,6222,533,5689,2,FN,1967,5.925,31.1
2022,ISERE,Seyssinet-Pariset,8325,2103,6222,533,5689,2,LREM,3722,5.925,31.1
2022,ISERE,L'Isle-d'Abeau,9844,3371,6473,439,6034,2,FN,2740,5.925,31.1
2022,ISERE,L'Isle-d'Abeau,9844,3371,6473,439,6034,2,LREM,3294,5.925,31.1
2022,ISERE,Villefontaine,11142,4311,6831,534,6297,2,FN,2573,5.925,31.1
2022,ISERE,Villefontaine,11142,4311,6831,534,6297,2,LREM,3724,5.925,31.1
2022,ISERE,Saint-Egrève,11839,2901,8938,709,8229,2,FN,2360,5.925,31.1
2022,ISERE,Saint-Egrève,11839,2901,8938,709,8229,2,LREM,5869,5.925,31.1
2022,ISERE,Fontaine,12913,4086,8827,744,8083,2,FN,2879,5.925,31.1
2022,ISERE,Fontaine,12913,4086,8827,744,8083,2,LREM,5204,5.925,31.1
2022,ISERE,Meylan,14214,3110,11104,712,10392,2,FN,2396,5.925,31.1
2022,ISERE,Meylan,14214,3110,11104,712,10392,2,LREM,7996,5.925,31.1
2022,ISERE,Voiron,15093,4447,10646,949,9697,2,FN,3163,5.925,31.1
2022,ISERE,Voiron,15093,4447,10646,949,9697,2,LREM,6534,5.925,31.1
2022,ISERE,Bourgoin-Jallieu,17466,5822,11644,980,10664,2,FN,4132,5.925,31.1
2022,ISERE,Bourgoin-Jallieu,17466,5822,11644,980,10664,2,LREM,6532,5.925,31.1
2022,ISERE,Saint-Martin-d'Hères,18098,6191,11907,1074,10833,2,FN,3614,5.925,31.1
2022,ISERE,Saint-Martin-d'Hères,18098,6191,11907,1074,10833,2,LREM,7219,5.925,31.1
2022,ISERE,Vienne,19136,5977,13159,1212,11947,2,FN,4171,5.925,31.1
2022,ISERE,Vienne,19136,5977,13159,1212,11947,2,LREM,7776,5.925,31.1
2022,ISERE,Echirolles,20686,7376,13310,1152,12158,2,FN,4167,5.925,31.1
2022,ISERE,Echirolles,20686,7376,13310,1152,12158,2,LREM,7991,5.925,31.1
2022,ISERE,Grenoble,86584,27656,58928,4784,54144,2,FN,11511,5.925,31.1
2022,ISERE,Grenoble,86584,27656,58928,4784,54144,2,LREM,42633,5.925,31.1
2017,ISERE,Monestier-d'Ambel,22,4,18,1,17,1,EELV,1,7.825,31.7
2017,ISERE,Monestier-d'Ambel,22,4,18,1,17,1,FN,3,7.825,31.7
2017,ISERE,Monestier-d'Ambel,22,4,18,1,17,1,LFI,0,7.825,31.7
2017,ISERE,Monestier-d'Ambel,22,4,18,1,17,1,LO,0,7.825,31.7
2017,ISERE,Monestier-d'Ambel,22,4,18,1,17,1,LR,3,7.825,31.7
2017,ISERE,Monestier-d'Ambel,22,4,18,1,17,1,LREM,5,7.825,31.7
2017,ISERE,Monestier-d'Ambel,22,4,18,1,17,1,NPA,1,7.825,31.7
2017,ISERE,Monestier-d'Ambel,22,4,18,1,17,1,PCF,0,7.825,31.7
2017,ISERE,Monestier-d'Ambel,22,4,18,1,17,1,REC,2,7.825,31.7
2017,ISERE,Monestier-d'Ambel,22,4,18,1,17,1,RES,2,7.825,31.7
2017,ISERE,Grenoble,27,27,0,0,0,1,EELV,0,7.825,31.7
2017,ISERE,Grenoble,27,27,0,0,0,1,FN,0,7.825,31.7
2017,ISERE,Grenoble,27,27,0,0,0,1,LFI,0,7.825,31.7
2017,ISERE,Grenoble,27,27,0,0,0,1,LO,0,7.825,31.7
2017,ISERE,Grenoble,27,27,0,0,0,1,LR,0,7.825,31.7
2017,ISERE,Grenoble,27,27,0,0,0,1,LREM,0,7.825,31.7
2017,ISERE,Grenoble,27,27,0,0,0,1,NPA,0,7.825,31.7
2017,ISERE,Grenoble,27,27,0,0,0,1,PCF,0,7.825,31.7
2017,ISERE,Grenoble,27,27,0,0,0,1,REC,0,7.825,31.7
2017,ISERE,Grenoble,27,27,0,0,0,1,RES,0,7.825,31.7
2017,ISERE,Ambel,33,5,28,1,27,1,EELV,1,7.825,31.7
2017,ISERE,Ambel,33,5,28,1,27,1,FN,7,7.825,31.7
2017,ISERE,Ambel,33,5,28,1,27,1,LFI,3,7.825,31.7
2017,ISERE,Ambel,33,5,28,1,27,1,LO,0,7.825,31.7
2017,ISERE,Ambel,33,5,28,1,27,1,LR,0,7.825,31.7
2017,ISERE,Ambel,33,5,28,1,27,1,LREM,11,7.825,31.7
2017,ISERE,Ambel,33,5,28,1,27,1,NPA,0,7.825,31.7
2017,ISERE,Ambel,33,5,28,1,27,1,PCF,0,7.825,31.7
2017,ISERE,Ambel,33,5,28,1,27,1,REC,2,7.825,31.7
2017,ISERE,Ambel,33,5,28,1,27,1,RES,1,7.825,31.7
2017,ISERE,Beaufin,34,3,31,0,31,1,EELV,4,7.825,31.7
2017,ISERE,Beaufin,34,3,31,0,31,1,FN,3,7.825,31.7
2017,ISERE,Beaufin,34,3,31,0,31,1,LFI,5,7.825,31.7
2017,ISERE,Beaufin,34,3,31,0,31,1,LO,0,7.825,31.7
2017,ISERE,Beaufin,34,3,31,0,31,1,LR,1,7.825,31.7
2017,ISERE,Beaufin,34,3,31,0,31,1,LREM,6,7.825,31.7
2017,ISERE,Beaufin,34,3,31,0,31,1,NPA,0,7.825,31.7
2017,ISERE,Beaufin,34,3,31,0,31,1,PCF,2,7.825,31.7
2017,ISERE,Beaufin,34,3,31,0,31,1,REC,1,7.825,31.7
2017,ISERE,Beaufin,34,3,31,0,31,1,RES,6,7.825,31.7
2017,ISERE,Villard-Reymond,34,8,26,0,26,1,EELV,1,7.825,31.7
2017,ISERE,Villard-Reymond,34,8,26,0,26,1,FN,2,7.825,31.7
2017,ISERE,Villard-Reymond,34,8,26,0,26,1,LFI,10,7.825,31.7
2017,ISERE,Villard-Reymond,34,8,26,0,26,1,LO,0,7.825,31.7
2017,ISERE,Villard-Reymond,34,8,26,0,26,1,LR,4,7.825,31.7
2017,ISERE,Villard-Reymond,34,8,26,0,26,1,LREM,2,7.825,31.7
2017,ISERE,Villard-Reymond,34,8,26,0,26,1,NPA,1,7.825,31.7
2017,ISERE,Villard-Reymond,34,8,26,0,26,1,PCF,0,7.825,31.7
2017,ISERE,Villard-Reymond,34,8,26,0,26,1,REC,1,7.825,31.7
2017,ISERE,Villard-Reymond,34,8,26,0,26,1,RES,1,7.825,31.7
2017,ISERE,Villard-Notre-Dame,38,7,31,1,30,1,EELV,4,7.825,31.7
2017,ISERE,Villard-Notre-Dame,38,7,31,1,30,1,FN,5,7.825,31.7
2017,ISERE,Villard-Notre-Dame,38,7,31,1,30,1,LFI,9,7.825,31.7
2017,ISERE,Villard-Notre-Dame,38,7,31,1,30,1,LO,0,7.825,31.7
2017,ISERE,Villard-Notre-Dame,38,7,31,1,30,1,LR,3,7.825,31.7
2017,ISERE,Villard-Notre-Dame,38,7,31,1,30,1,LREM,5,7.825,31.7
2017,ISERE,Villard-Notre-Dame,38,7,31,1,30,1,NPA,0,7.825,31.7
2017,ISERE,Villard-Notre-Dame,38,7,31,1,30,1,PCF,2,7.825,31.7
2017,ISERE,Villard-Notre-Dame,38,7,31,1,30,1,REC,0,7.825,31.7
2017,ISERE,Villard-Notre-Dame,38,7,31,1,30,1,RES,0,7.825,31.7
2017,ISERE,Oulles,39,7,32,3,29,1,EELV,1,7.825,31.7
2017,ISERE,Oulles,39,7,32,3,29,1,FN,12,7.825,31.7
2017,ISERE,Oulles,39,7,32,3,29,1,LFI,2,7.825,31.7
2017,ISERE,Oulles,39,7,32,3,29,1,LO,0,7.825,31.7
2017,ISERE,Oulles,39,7,32,3,29,1,LR,1,7.825,31.7
2017,ISERE,Oulles,39,7,32,3,29,1,LREM,7,7.825,31.7
2017,ISERE,Oulles,39,7,32,3,29,1,NPA,0,7.825,31.7
2017,ISERE,Oulles,39,7,32,3,29,1,PCF,0,7.825,31.7
2017,ISERE,Oulles,39,7,32,3,29,1,REC,1,7.825,31.7
2017,ISERE,Oulles,39,7,32,3,29,1,RES,2,7.825,31.7
2017,ISERE,Cognet,41,9,32,2,30,1,EELV,2,7.825,31.7
2017,ISERE,Cognet,41,9,32,2,30,1,FN,6,7.825,31.7
2017,ISERE,Cognet,41,9,32,2,30,1,LFI,8,7.825,31.7
2017,ISERE,Cognet,41,9,32,2,30,1,LO,0,7.825,31.7
2017,ISERE,Cognet,41,9,32,2,30,1,LR,0,7.825,31.7
2017,ISERE,Cognet,41,9,32,2,30,1,LREM,7,7.825,31.7
2017,ISERE,Cognet,41,9,32,2,30,1,NPA,0,7.825,31.7
2017,ISERE,Cognet,41,9,32,2,30,1,PCF,0,7.825,31.7
2017,ISERE,Cognet,41,9,32,2,30,1,REC,3,7.825,31.7
2017,ISERE,Cognet,41,9,32,2,30,1,RES,3,7.825,31.7
2017,ISERE,Sainte-Luce,55,17,38,1,37,1,EELV,3,7.825,31.7
2017,ISERE,Sainte-Luce,55,17,38,1,37,1,FN,9,7.825,31.7
2017,ISERE,Sainte-Luce,55,17,38,1,37,1,LFI,14,7.825,31.7
2017,ISERE,Sainte-Luce,55,17,38,1,37,1,LO,0,7.825,31.7
2017,ISERE,Sainte-Luce,55,17,38,1,37,1,LR,0,7.825,31.7
2017,ISERE,Sainte-Luce,55,17,38,1,37,1,LREM,8,7.825,31.7
2017,ISERE,Sainte-Luce,55,17,38,1,37,1,NPA,0,7.825,31.7
2017,ISERE,Sainte-Luce,55,17,38,1,37,1,PCF,0,7.825,31.7
2017,ISERE,Sainte-Luce,55,17,38,1,37,1,REC,1,7.825,31.7
2017,ISERE,Sainte-Luce,55,17,38,1,37,1,RES,0,7.825,31.7
2017,ISERE,La Valette,62,12,50,1,49,1,EELV,5,7.825,31.7
2017,ISERE,La Valette,62,12,50,1,49,1,FN,8,7.825,31.7
2017,ISERE,La Valette,62,12,50,1,49,1,LFI,14,7.825,31.7
2017,ISERE,La Valette,62,12,50,1,49,1,LO,0,7.825,31.7
2017,ISERE,La Valette,62,12,50,1,49,1,LR,0,7.825,31.7
2017,ISERE,La Valette,62,12,50,1,49,1,LREM,11,7.825,31.7
2017,ISERE,La Valette,62,12,50,1,49,1,NPA,2,7.825,31.7
2017,ISERE,La Valette,62,12,50,1,49,1,PCF,0,7.825,31.7
2017,ISERE,La Valette,62,12,50,1,49,1,REC,0,7.825,31.7
2017,ISERE,La Valette,62,12,50,1,49,1,RES,4,7.825,31.7
2017,ISERE,Malleval-en-Vercors,63,7,56,1,55,1,EELV,4,7.825,31.7
2017,ISERE,Malleval-en-Vercors,63,7,56,1,55,1,FN,7,7.825,31.7
2017,ISERE,Malleval-en-Vercors,63,7,56,1,55,1,LFI,23,7.825,31.7
2017,ISERE,Malleval-en-Vercors,63,7,56,1,55,1,LO,0,7.825,31.7
2017,ISERE,Malleval-en-Vercors,63,7,56,1,55,1,LR,0,7.825,31.7
2017,ISERE,Malleval-en-Vercors,63,7,56,1,55,1,LREM,14,7.825,31.7
2017,ISERE,Malleval-en-Vercors,63,7,56,1,55,1,NPA,2,7.825,31.7
2017,ISERE,Malleval-en-Vercors,63,7,56,1,55,1,PCF,0,7.825,31.7
2017,ISERE,Malleval-en-Vercors,63,7,56,1,55,1,REC,2,7.825,31.7
2017,ISERE,Malleval-en-Vercors,63,7,56,1,55,1,RES,2,7.825,31.7
2017,ISERE,Saint-Michel-en-Beaumont,65,13,52,0,52,1,EELV,2,7.825,31.7
2017,ISERE,Saint-Michel-en-Beaumont,65,13,52,0,52,1,FN,10,7.825,31.7
2017,ISERE,Saint-Michel-en-Beaumont,65,13,52,0,52,1,LFI,15,7.825,31.7
2017,ISERE,Saint-Michel-en-Beaumont,65,13,52,0,52,1,LO,1,7.825,31.7
2017,ISERE,Saint-Michel-en-Beaumont,65,13,52,0,52,1,LR,2,7.825,31.7
2017,ISERE,Saint-Michel-en-Beaumont,65,13,52,0,52,1,LREM,12,7.825,31.7
2017,ISERE,Saint-Michel-en-Beaumont,65,13,52,0,52,1,NPA,0,7.825,31.7
2017,ISERE,Saint-Michel-en-Beaumont,65,13,52,0,52,1,PCF,4,7.825,31.7
2017,ISERE,Saint-Michel-en-Beaumont,65,13,52,0,52,1,REC,2,7.825,31.7
2017,ISERE,Saint-Michel-en-Beaumont,65,13,52,0,52,1,RES,1,7.825,31.7
2017,ISERE,Marcieu,68,11,57,1,56,1,EELV,2,7.825,31.7
2017,ISERE,Marcieu,68,11,57,1,56,1,FN,21,7.825,31.7
2017,ISERE,Marcieu,68,11,57,1,56,1,LFI,11,7.825,31.7
2017,ISERE,Marcieu,68,11,57,1,56,1,LO,0,7.825,31.7
2017,ISERE,Marcieu,68,11,57,1,56,1,LR,0,7.825,31.7
2017,ISERE,Marcieu,68,11,57,1,56,1,LREM,15,7.825,31.7
2017,ISERE,Marcieu,68,11,57,1,56,1,NPA,0,7.825,31.7
2017,ISERE,Marcieu,68,11,57,1,56,1,PCF,1,7.825,31.7
2017,ISERE,Marcieu,68,11,57,1,56,1,REC,4,7.825,31.7
2017,ISERE,Marcieu,68,11,57,1,56,1,RES,2,7.825,31.7
2017,ISERE,Saint-Arey,75,7,68,3,65,1,EELV,3,7.825,31.7
2017,ISERE,Saint-Arey,75,7,68,3,65,1,FN,9,7.825,31.7
2017,ISERE,Saint-Arey,75,7,68,3,65,1,LFI,17,7.825,31.7
2017,ISERE,Saint-Arey,75,7,68,3,65,1,LO,0,7.825,31.7
2017,ISERE,Saint-Arey,75,7,68,3,65,1,LR,5,7.825,31.7
2017,ISERE,Saint-Arey,75,7,68,3,65,1,LREM,14,7.825,31.7
2017,ISERE,Saint-Arey,75,7,68,3,65,1,NPA,1,7.825,31.7
2017,ISERE,Saint-Arey,75,7,68,3,65,1,PCF,0,7.825,31.7
2017,ISERE,Saint-Arey,75,7,68,3,65,1,REC,11,7.825,31.7
2017,ISERE,Saint-Arey,75,7,68,3,65,1,RES,1,7.825,31.7
2017,ISERE,Quincieu,76,17,59,3,56,1,EELV,2,7.825,31.7
2017,ISERE,Quincieu,76,17,59,3,56,1,FN,18,7.825,31.7
2017,ISERE,Quincieu,76,17,59,3,56,1,LFI,10,7.825,31.7
2017,ISERE,Quincieu,76,17,59,3,56,1,LO,0,7.825,31.7
2017,ISERE,Quincieu,76,17,59,3,56,1,LR,2,7.825,31.7
2017,ISERE,Quincieu,76,17,59,3,56,1,LREM,11,7.825,31.7
2017,ISERE,Quincieu,76,17,59,3,56,1,NPA,2,7.825,31.7
2017,ISERE,Quincieu,76,17,59,3,56,1,PCF,0,7.825,31.7
2017,ISERE,Quincieu,76,17,59,3,56,1,REC,3,7.825,31.7
2017,ISERE,Quincieu,76,17,59,3,56,1,RES,2,7.825,31.7
2017,ISERE,Vaulnaveys-le-Bas,78,17,61,4,57,1,EELV,4,7.825,31.7
2017,ISERE,Vaulnaveys-le-Bas,78,17,61,4,57,1,FN,17,7.825,31.7
2017,ISERE,Vaulnaveys-le-Bas,78,17,61,4,57,1,LFI,6,7.825,31.7
2017,ISERE,Vaulnaveys-le-Bas,78,17,61,4,57,1,LO,0,7.825,31.7
2017,ISERE,Vaulnaveys-le-Bas,78,17,61,4,57,1,LR,1,7.825,31.7
2017,ISERE,Vaulnaveys-le-Bas,78,17,61,4,57,1,LREM,12,7.825,31.7
2017,ISERE,Vaulnaveys-le-Bas,78,17,61,4,57,1,NPA,1,7.825,31.7
2017,ISERE,Vaulnaveys-le-Bas,78,17,61,4,57,1,PCF,5,7.825,31.7
2017,ISERE,Vaulnaveys-le-Bas,78,17,61,4,57,1,REC,7,7.825,31.7
2017,ISERE,Vaulnaveys-le-Bas,78,17,61,4,57,1,RES,3,7.825,31.7
2017,ISERE,Bressieux,81,5,76,3,73,1,EELV,4,7.825,31.7
2017,ISERE,Bressieux,81,5,76,3,73,1,FN,11,7.825,31.7
2017,ISERE,Bressieux,81,5,76,3,73,1,LFI,11,7.825,31.7
2017,ISERE,Bressieux,81,5,76,3,73,1,LO,0,7.825,31.7
2017,ISERE,Bressieux,81,5,76,3,73,1,LR,6,7.825,31.7
2017,ISERE,Bressieux,81,5,76,3,73,1,LREM,25,7.825,31.7
2017,ISERE,Bressieux,81,5,76,3,73,1,NPA,1,7.825,31.7
2017,ISERE,Bressieux,81,5,76,3,73,1,PCF,5,7.825,31.7
2017,ISERE,Bressieux,81,5,76,3,73,1,REC,2,7.825,31.7
2017,ISERE,Bressieux,81,5,76,3,73,1,RES,2,7.825,31.7
2017,ISERE,Quet-en-Beaumont,83,24,59,2,57,1,EELV,2,7.825,31.7
2017,ISERE,Quet-en-Beaumont,83,24,59,2,57,1,FN,13,7.825,31.7
2017,ISERE,Quet-en-Beaumont,83,24,59,2,57,1,LFI,15,7.825,31.7
2017,ISERE,Quet-en-Beaumont,83,24,59,2,57,1,LO,0,7.825,31.7
2017,ISERE,Quet-en-Beaumont,83,24,59,2,57,1,LR,6,7.825,31.7
2017,ISERE,Quet-en-Beaumont,83,24,59,2,57,1,LREM,13,7.825,31.7
2017,ISERE,Quet-en-Beaumont,83,24,59,2,57,1,NPA,1,7.825,31.7
2017,ISERE,Quet-en-Beaumont,83,24,59,2,57,1,PCF,1,7.825,31.7
2017,ISERE,Quet-en-Beaumont,83,24,59,2,57,1,REC,3,7.825,31.7
2017,ISERE,Quet-en-Beaumont,83,24,59,2,57,1,RES,0,7.825,31.7
2017,ISERE,Saint-Barthélemy-de-Séchilienne,85,12,73,3,70,1,EELV,6,7.825,31.7
2017,ISERE,Saint-Barthélemy-de-Séchilienne,85,12,73,3,70,1,FN,15,7.825,31.7
2017,ISERE,Saint-Barthélemy-de-Séchilienne,85,12,73,3,70,1,LFI,21,7.825,31.7
2017,ISERE,Saint-Barthélemy-de-Séchilienne,85,12,73,3,70,1,LO,1,7.825,31.7
2017,ISERE,Saint-Barthélemy-de-Séchilienne,85,12,73,3,70,1,LR,0,7.825,31.7
2017,ISERE,Saint-Barthélemy-de-Séchilienne,85,12,73,3,70,1,LREM,16,7.825,31.7
2017,ISERE,Saint-Barthélemy-de-Séchilienne,85,12,73,3,70,1,NPA,0,7.825,31.7
2017,ISERE,Saint-Barthélemy-de-Séchilienne,85,12,73,3,70,1,PCF,2,7.825,31.7
2017,ISERE,Saint-Barthélemy-de-Séchilienne,85,12,73,3,70,1,REC,4,7.825,31.7
2017,ISERE,Saint-Barthélemy-de-Séchilienne,85,12,73,3,70,1,RES,0,7.825,31.7
2017,ISERE,Beauvoir-en-Royans,85,13,72,5,67,1,EELV,2,7.825,31.7
2017,ISERE,Beauvoir-en-Royans,85,13,72,5,67,1,FN,14,7.825,31.7
2017,ISERE,Beauvoir-en-Royans,85,13,72,5,67,1,LFI,27,7.825,31.7
2017,ISERE,Beauvoir-en-Royans,85,13,72,5,67,1,LO,0,7.825,31.7
2017,ISERE,Beauvoir-en-Royans,85,13,72,5,67,1,LR,2,7.825,31.7
2017,ISERE,Beauvoir-en-Royans,85,13,72,5,67,1,LREM,8,7.825,31.7
2017,ISERE,Beauvoir-en-Royans,85,13,72,5,67,1,NPA,2,7.825,31.7
2017,ISERE,Beauvoir-en-Royans,85,13,72,5,67,1,PCF,2,7.825,31.7
2017,ISERE,Beauvoir-en-Royans,85,13,72,5,67,1,REC,2,7.825,31.7
2017,ISERE,Beauvoir-en-Royans,85,13,72,5,67,1,RES,1,7.825,31.7
2017,ISERE,Chantepérier,85,19,66,3,63,1,EELV,3,7.825,31.7
2017,ISERE,Chantepérier,85,19,66,3,63,1,FN,13,7.825,31.7
2017,ISERE,Chantepérier,85,19,66,3,63,1,LFI,10,7.825,31.7
2017,ISERE,Chantepérier,85,19,66,3,63,1,LO,0,7.825,31.7
2017,ISERE,Chantepérier,85,19,66,3,63,1,LR,5,7.825,31.7
2017,ISERE,Chantepérier,85,19,66,3,63,1,LREM,24,7.825,31.7
2017,ISERE,Chantepérier,85,19,66,3,63,1,NPA,0,7.825,31.7
2017,ISERE,Chantepérier,85,19,66,3,63,1,PCF,2,7.825,31.7
2017,ISERE,Chantepérier,85,19,66,3,63,1,REC,4,7.825,31.7
2017,ISERE,Chantepérier,85,19,66,3,63,1,RES,1,7.825,31.7
2017,ISERE,Mont-Saint-Martin,90,9,81,3,78,1,EELV,8,7.825,31.7
2017,ISERE,Mont-Saint-Martin,90,9,81,3,78,1,FN,11,7.825,31.7
2017,ISERE,Mont-Saint-Martin,90,9,81,3,78,1,LFI,25,7.825,31.7
2017,ISERE,Mont-Saint-Martin,90,9,81,3,78,1,LO,1,7.825,31.7
2017,ISERE,Mont-Saint-Martin,90,9,81,3,78,1,LR,4,7.825,31.7
2017,ISERE,Mont-Saint-Martin,90,9,81,3,78,1,LREM,16,7.825,31.7
2017,ISERE,Mont-Saint-Martin,90,9,81,3,78,1,NPA,1,7.825,31.7
2017,ISERE,Mont-Saint-Martin,90,9,81,3,78,1,PCF,1,7.825,31.7
2017,ISERE,Mont-Saint-Martin,90,9,81,3,78,1,REC,3,7.825,31.7
2017,ISERE,Mont-Saint-Martin,90,9,81,3,78,1,RES,4,7.825,31.7
2017,ISERE,Mayres-Savel,91,17,74,1,73,1,EELV,3,7.825,31.7
2017,ISERE,Mayres-Savel,91,17,74,1,73,1,FN,14,7.825,31.7
2017,ISERE,Mayres-Savel,91,17,74,1,73,1,LFI,14,7.825,31.7
2017,ISERE,Mayres-Savel,91,17,74,1,73,1,LO,0,7.825,31.7
2017,ISERE,Mayres-Savel,91,17,74,1,73,1,LR,1,7.825,31.7
2017,ISERE,Mayres-Savel,91,17,74,1,73,1,LREM,22,7.825,31.7
2017,ISERE,Mayres-Savel,91,17,74,1,73,1,NPA,3,7.825,31.7
2017,ISERE,Mayres-Savel,91,17,74,1,73,1,PCF,6,7.825,31.7
2017,ISERE,Mayres-Savel,91,17,74,1,73,1,REC,3,7.825,31.7
2017,ISERE,Mayres-Savel,91,17,74,1,73,1,RES,1,7.825,31.7
2017,ISERE,Montfalcon,94,7,87,2,85,1,EELV,1,7.825,31.7
2017,ISERE,Montfalcon,94,7,87,2,85,1,FN,25,7.825,31.7
2017,ISERE,Montfalcon,94,7,87,2,85,1,LFI,23,7.825,31.7
2017,ISERE,Montfalcon,94,7,87,2,85,1,LO,0,7.825,31.7
2017,ISERE,Montfalcon,94,7,87,2,85,1,LR,10,7.825,31.7
2017,ISERE,Montfalcon,94,7,87,2,85,1,LREM,13,7.825,31.7
2017,ISERE,Montfalcon,94,7,87,2,85,1,NPA,0,7.825,31.7
2017,ISERE,Montfalcon,94,7,87,2,85,1,PCF,0,7.825,31.7
2017,ISERE,Montfalcon,94,7,87,2,85,1,REC,4,7.825,31.7
2017,ISERE,Montfalcon,94,7,87,2,85,1,RES,3,7.825,31.7
2017,ISERE,Bessins,95,12,83,3,80,1,EELV,6,7.825,31.7
2017,ISERE,Bessins,95,12,83,3,80,1,FN,13,7.825,31.7
2017,ISERE,Bessins,95,12,83,3,80,1,LFI,14,7.825,31.7
2017,ISERE,Bessins,95,12,83,3,80,1,LO,2,7.825,31.7
2017,ISERE,Bessins,95,12,83,3,80,1,LR,1,7.825,31.7
2017,ISERE,Bessins,95,12,83,3,80,1,LREM,26,7.825,31.7
2017,ISERE,Bessins,95,12,83,3,80,1,NPA,1,7.825,31.7
2017,ISERE,Bessins,95,12,83,3,80,1,PCF,0,7.825,31.7
2017,ISERE,Bessins,95,12,83,3,80,1,REC,9,7.825,31.7
2017,ISERE,Bessins,95,12,83,3,80,1,RES,6,7.825,31.7
2017,ISERE,Villard-Reculas,95,17,78,0,78,1,EELV,7,7.825,31.7
2017,ISERE,Villard-Reculas,95,17,78,0,78,1,FN,4,7.825,31.7
2017,ISERE,Villard-Reculas,95,17,78,0,78,1,LFI,16,7.825,31.7
2017,ISERE,Villard-Reculas,95,17,78,0,78,1,LO,0,7.825,31.7
2017,ISERE,Villard-Reculas,95,17,78,0,78,1,LR,8,7.825,31.7
2017,ISERE,Villard-Reculas,95,17,78,0,78,1,LREM,30,7.825,31.7
2017,ISERE,Villard-Reculas,95,17,78,0,78,1,NPA,1,7.825,31.7
2017,ISERE,Villard-Reculas,95,17,78,0,78,1,PCF,0,7.825,31.7
2017,ISERE,Villard-Reculas,95,17,78,0,78,1,REC,6,7.825,31.7
2017,ISERE,Villard-Reculas,95,17,78,0,78,1,RES,4,7.825,31.7
2017,ISERE,Châtelus,96,17,79,3,76,1,EELV,3,7.825,31.7
2017,ISERE,Châtelus,96,17,79,3,76,1,FN,25,7.825,31.7
2017,ISERE,Châtelus,96,17,79,3,76,1,LFI,11,7.825,31.7
2017,ISERE,Châtelus,96,17,79,3,76,1,LO,3,7.825,31.7
2017,ISERE,Châtelus,96,17,79,3,76,1,LR,0,7.825,31.7
2017,ISERE,Châtelus,96,17,79,3,76,1,LREM,10,7.825,31.7
2017,ISERE,Châtelus,96,17,79,3,76,1,NPA,1,7.825,31.7
2017,ISERE,Châtelus,96,17,79,3,76,1,PCF,0,7.825,31.7
2017,ISERE,Châtelus,96,17,79,3,76,1,REC,8,7.825,31.7
2017,ISERE,Châtelus,96,17,79,3,76,1,RES,9,7.825,31.7
2017,ISERE,Les Côtes-de-Corps,98,19,79,1,78,1,EELV,12,7.825,31.7
2017,ISERE,Les Côtes-de-Corps,98,19,79,1,78,1,FN,6,7.825,31.7
2017,ISERE,Les Côtes-de-Corps,98,19,79,1,78,1,LFI,22,7.825,31.7
2017,ISERE,Les Côtes-de-Corps,98,19,79,1,78,1,LO,0,7.825,31.7
2017,ISERE,Les Côtes-de-Corps,98,19,79,1,78,1,LR,2,7.825,31.7
2017,ISERE,Les Côtes-de-Corps,98,19,79,1,78,1,LREM,21,7.825,31.7
2017,ISERE,Les Côtes-de-Corps,98,19,79,1,78,1,NPA,3,7.825,31.7
2017,ISERE,Les Côtes-de-Corps,98,19,79,1,78,1,PCF,2,7.825,31.7
2017,ISERE,Les Côtes-de-Corps,98,19,79,1,78,1,REC,6,7.825,31.7
2017,ISERE,Les Côtes-de-Corps,98,19,79,1,78,1,RES,1,7.825,31.7
2017,ISERE,Oris-en-Rattier,103,24,79,3,76,1,EELV,6,7.825,31.7
2017,ISERE,Oris-en-Rattier,103,24,79,3,76,1,FN,11,7.825,31.7
2017,ISERE,Oris-en-Rattier,103,24,79,3,76,1,LFI,21,7.825,31.7
2017,ISERE,Oris-en-Rattier,103,24,79,3,76,1,LO,1,7.825,31.7
2017,ISERE,Oris-en-Rattier,103,24,79,3,76,1,LR,6,7.825,31.7
2017,ISERE,Oris-en-Rattier,103,24,79,3,76,1,LREM,19,7.825,31.7
2017,ISERE,Oris-en-Rattier,103,24,79,3,76,1,NPA,1,7.825,31.7
2017,ISERE,Oris-en-Rattier,103,24,79,3,76,1,PCF,6,7.825,31.7
2017,ISERE,Oris-en-Rattier,103,24,79,3,76,1,REC,0,7.825,31.7
2017,ISERE,Oris-en-Rattier,103,24,79,3,76,1,RES,3,7.825,31.7
2017,ISERE,Presles,106,19,87,2,85,1,EELV,7,7.825,31.7
2017,ISERE,Presles,106,19,87,2,85,1,FN,16,7.825,31.7
2017,ISERE,Presles,106,19,87,2,85,1,LFI,39,7.825,31.7
2017,ISERE,Presles,106,19,87,2,85,1,LO,1,7.825,31.7
2017,ISERE,Presles,106,19,87,2,85,1,LR,4,7.825,31.7
2017,ISERE,Presles,106,19,87,2,85,1,LREM,8,7.825,31.7
2017,ISERE,Presles,106,19,87,2,85,1,NPA,0,7.825,31.7
2017,ISERE,Presles,106,19,87,2,85,1,PCF,1,7.825,31.7
2017,ISERE,Presles,106,19,87,2,85,1,REC,4,7.825,31.7
2017,ISERE,Presles,106,19,87,2,85,1,RES,5,7.825,31.7
2017,ISERE,La Garde,108,27,81,0,81,1,EELV,10,7.825,31.7
2017,ISERE,La Garde,108,27,81,0,81,1,FN,17,7.825,31.7
2017,ISERE,La Garde,108,27,81,0,81,1,LFI,13,7.825,31.7
2017,ISERE,La Garde,108,27,81,0,81,1,LO,0,7.825,31.7
2017,ISERE,La Garde,108,27,81,0,81,1,LR,11,7.825,31.7
2017,ISERE,La Garde,108,27,81,0,81,1,LREM,12,7.825,31.7
2017,ISERE,La Garde,108,27,81,0,81,1,NPA,0,7.825,31.7
2017,ISERE,La Garde,108,27,81,0,81,1,PCF,1,7.825,31.7
2017,ISERE,La Garde,108,27,81,0,81,1,REC,7,7.825,31.7
2017,ISERE,La Garde,108,27,81,0,81,1,RES,6,7.825,31.7
2017,ISERE,Siévoz,110,17,93,1,92,1,EELV,7,7.825,31.7
2017,ISERE,Siévoz,110,17,93,1,92,1,FN,20,7.825,31.7
2017,ISERE,Siévoz,110,17,93,1,92,1,LFI,28,7.825,31.7
2017,ISERE,Siévoz,110,17,93,1,92,1,LO,0,7.825,31.7
2017,ISERE,Siévoz,110,17,93,1,92,1,LR,0,7.825,31.7
2017,ISERE,Siévoz,110,17,93,1,92,1,LREM,19,7.825,31.7
2017,ISERE,Siévoz,110,17,93,1,92,1,NPA,0,7.825,31.7
2017,ISERE,Siévoz,110,17,93,1,92,1,PCF,5,7.825,31.7
2017,ISERE,Siévoz,110,17,93,1,92,1,REC,0,7.825,31.7
2017,ISERE,Siévoz,110,17,93,1,92,1,RES,4,7.825,31.7
2017,ISERE,Clavans-en-Haut-Oisans,114,27,87,0,87,1,EELV,8,7.825,31.7
2017,ISERE,Clavans-en-Haut-Oisans,114,27,87,0,87,1,FN,21,7.825,31.7
2017,ISERE,Clavans-en-Haut-Oisans,114,27,87,0,87,1,LFI,17,7.825,31.7
2017,ISERE,Clavans-en-Haut-Oisans,114,27,87,0,87,1,LO,0,7.825,31.7
2017,ISERE,Clavans-en-Haut-Oisans,114,27,87,0,87,1,LR,3,7.825,31.7
2017,ISERE,Clavans-en-Haut-Oisans,114,27,87,0,87,1,LREM,26,7.825,31.7
2017,ISERE,Clavans-en-Haut-Oisans,114,27,87,0,87,1,NPA,0,7.825,31.7
2017,ISERE,Clavans-en-Haut-Oisans,114,27,87,0,87,1,PCF,1,7.825,31.7
2017,ISERE,Clavans-en-Haut-Oisans,114,27,87,0,87,1,REC,5,7.825,31.7
2017,ISERE,Clavans-en-Haut-Oisans,114,27,87,0,87,1,RES,3,7.825,31.7
2017,ISERE,Saint-Andéol,115,19,96,2,94,1,EELV,9,7.825,31.7
2017,ISERE,Saint-Andéol,115,19,96,2,94,1,FN,15,7.825,31.7
2017,ISERE,Saint-Andéol,115,19,96,2,94,1,LFI,24,7.825,31.7
2017,ISERE,Saint-Andéol,115,19,96,2,94,1,LO,2,7.825,31.7
2017,ISERE,Saint-Andéol,115,19,96,2,94,1,LR,4,7.825,31.7
2017,ISERE,Saint-Andéol,115,19,96,2,94,1,LREM,19,7.825,31.7
2017,ISERE,Saint-Andéol,115,19,96,2,94,1,NPA,1,7.825,31.7
2017,ISERE,Saint-Andéol,115,19,96,2,94,1,PCF,4,7.825,31.7
2017,ISERE,Saint-Andéol,115,19,96,2,94,1,REC,5,7.825,31.7
2017,ISERE,Saint-Andéol,115,19,96,2,94,1,RES,8,7.825,31.7
2017,ISERE,Blandin,118,17,101,1,100,1,EELV,4,7.825,31.7
2017,ISERE,Blandin,118,17,101,1,100,1,FN,26,7.825,31.7
2017,ISERE,Blandin,118,17,101,1,100,1,LFI,13,7.825,31.7
2017,ISERE,Blandin,118,17,101,1,100,1,LO,1,7.825,31.7
2017,ISERE,Blandin,118,17,101,1,100,1,LR,4,7.825,31.7
2017,ISERE,Blandin,118,17,101,1,100,1,LREM,25,7.825,31.7
2017,ISERE,Blandin,118,17,101,1,100,1,NPA,1,7.825,31.7
2017,ISERE,Blandin,118,17,101,1,100,1,PCF,3,7.825,31.7
2017,ISERE,Blandin,118,17,101,1,100,1,REC,16,7.825,31.7
2017,ISERE,Blandin,118,17,101,1,100,1,RES,4,7.825,31.7
2017,ISERE,Brion,121,22,99,5,94,1,EELV,6,7.825,31.7
2017,ISERE,Brion,121,22,99,5,94,1,FN,29,7.825,31.7
2017,ISERE,Brion,121,22,99,5,94,1,LFI,11,7.825,31.7
2017,ISERE,Brion,121,22,99,5,94,1,LO,0,7.825,31.7
2017,ISERE,Brion,121,22,99,5,94,1,LR,12,7.825,31.7
2017,ISERE,Brion,121,22,99,5,94,1,LREM,22,7.825,31.7
2017,ISERE,Brion,121,22,99,5,94,1,NPA,0,7.825,31.7
2017,ISERE,Brion,121,22,99,5,94,1,PCF,1,7.825,31.7
2017,ISERE,Brion,121,22,99,5,94,1,REC,5,7.825,31.7
2017,ISERE,Brion,121,22,99,5,94,1,RES,7,7.825,31.7
2017,ISERE,Marnans,121,26,95,3,92,1,EELV,5,7.825,31.7
2017,ISERE,Marnans,121,26,95,3,92,1,FN,30,7.825,31.7
2017,ISERE,Marnans,121,26,95,3,92,1,LFI,13,7.825,31.7
2017,ISERE,Marnans,121,26,95,3,92,1,LO,0,7.825,31.7
2017,ISERE,Marnans,121,26,95,3,92,1,LR,4,7.825,31.7
2017,ISERE,Marnans,121,26,95,3,92,1,LREM,17,7.825,31.7
2017,ISERE,Marnans,121,26,95,3,92,1,NPA,2,7.825,31.7
2017,ISERE,Marnans,121,26,95,3,92,1,PCF,3,7.825,31.7
2017,ISERE,Marnans,121,26,95,3,92,1,REC,6,7.825,31.7
2017,ISERE,Marnans,121,26,95,3,92,1,RES,2,7.825,31.7
2017,ISERE,Saint-Julien-de-l'Herms,121,28,93,2,91,1,EELV,5,7.825,31.7
2017,ISERE,Saint-Julien-de-l'Herms,121,28,93,2,91,1,FN,29,7.825,31.7
2017,ISERE,Saint-Julien-de-l'Herms,121,28,93,2,91,1,LFI,15,7.825,31.7
2017,ISERE,Saint-Julien-de-l'Herms,121,28,93,2,91,1,LO,1,7.825,31.7
2017,ISERE,Saint-Julien-de-l'Herms,121,28,93,2,91,1,LR,4,7.825,31.7
2017,ISERE,Saint-Julien-de-l'Herms,121,28,93,2,91,1,LREM,17,7.825,31.7
2017,ISERE,Saint-Julien-de-l'Herms,121,28,93,2,91,1,NPA,1,7.825,31.7
2017,ISERE,Saint-Julien-de-l'Herms,121,28,93,2,91,1,PCF,2,7.825,31.7
2017,ISERE,Saint-Julien-de-l'Herms,121,28,93,2,91,1,REC,13,7.825,31.7
2017,ISERE,Saint-Julien-de-l'Herms,121,28,93,2,91,1,RES,2,7.825,31.7
2017,ISERE,Saint-Christophe-en-Oisans,123,34,89,2,87,1,EELV,2,7.825,31.7
2017,ISERE,Saint-Christophe-en-Oisans,123,34,89,2,87,1,FN,13,7.825,31.7
2017,ISERE,Saint-Christophe-en-Oisans,123,34,89,2,87,1,LFI,19,7.825,31.7
2017,ISERE,Saint-Christophe-en-Oisans,123,34,89,2,87,1,LO,0,7.825,31.7
2017,ISERE,Saint-Christophe-en-Oisans,123,34,89,2,87,1,LR,3,7.825,31.7
2017,ISERE,Saint-Christophe-en-Oisans,123,34,89,2,87,1,LREM,33,7.825,31.7
2017,ISERE,Saint-Christophe-en-Oisans,123,34,89,2,87,1,NPA,0,7.825,31.7
2017,ISERE,Saint-Christophe-en-Oisans,123,34,89,2,87,1,PCF,3,7.825,31.7
2017,ISERE,Saint-Christophe-en-Oisans,123,34,89,2,87,1,REC,2,7.825,31.7
2017,ISERE,Saint-Christophe-en-Oisans,123,34,89,2,87,1,RES,9,7.825,31.7
2017,ISERE,Choranche,128,23,105,3,102,1,EELV,5,7.825,31.7
2017,ISERE,Choranche,128,23,105,3,102,1,FN,28,7.825,31.7
2017,ISERE,Choranche,128,23,105,3,102,1,LFI,19,7.825,31.7
2017,ISERE,Choranche,128,23,105,3,102,1,LO,1,7.825,31.7
2017,ISERE,Choranche,128,23,105,3,102,1,LR,3,7.825,31.7
2017,ISERE,Choranche,128,23,105,3,102,1,LREM,22,7.825,31.7
2017,ISERE,Choranche,128,23,105,3,102,1,NPA,2,7.825,31.7
2017,ISERE,Choranche,128,23,105,3,102,1,PCF,4,7.825,31.7
2017,ISERE,Choranche,128,23,105,3,102,1,REC,11,7.825,31.7
2017,ISERE,Choranche,128,23,105,3,102,1,RES,5,7.825,31.7
2017,ISERE,Percy,131,16,115,1,114,1,EELV,7,7.825,31.7
2017,ISERE,Percy,131,16,115,1,114,1,FN,16,7.825,31.7
2017,ISERE,Percy,131,16,115,1,114,1,LFI,44,7.825,31.7
2017,ISERE,Percy,131,16,115,1,114,1,LO,2,7.825,31.7
2017,ISERE,Percy,131,16,115,1,114,1,LR,4,7.825,31.7
2017,ISERE,Percy,131,16,115,1,114,1,LREM,25,7.825,31.7
2017,ISERE,Percy,131,16,115,1,114,1,NPA,6,7.825,31.7
2017,ISERE,Percy,131,16,115,1,114,1,PCF,3,7.825,31.7
2017,ISERE,Percy,131,16,115,1,114,1,REC,1,7.825,31.7
2017,ISERE,Percy,131,16,115,1,114,1,RES,4,7.825,31.7
2017,ISERE,Saint-Pierre-de-Méaroz,131,32,99,0,99,1,EELV,5,7.825,31.7
2017,ISERE,Saint-Pierre-de-Méaroz,131,32,99,0,99,1,FN,33,7.825,31.7
2017,ISERE,Saint-Pierre-de-Méaroz,131,32,99,0,99,1,LFI,25,7.825,31.7
2017,ISERE,Saint-Pierre-de-Méaroz,131,32,99,0,99,1,LO,0,7.825,31.7
2017,ISERE,Saint-Pierre-de-Méaroz,131,32,99,0,99,1,LR,2,7.825,31.7
2017,ISERE,Saint-Pierre-de-Méaroz,131,32,99,0,99,1,LREM,20,7.825,31.7
2017,ISERE,Saint-Pierre-de-Méaroz,131,32,99,0,99,1,NPA,0,7.825,31.7
2017,ISERE,Saint-Pierre-de-Méaroz,131,32,99,0,99,1,PCF,3,7.825,31.7
2017,ISERE,Saint-Pierre-de-Méaroz,131,32,99,0,99,1,REC,5,7.825,31.7
2017,ISERE,Saint-Pierre-de-Méaroz,131,32,99,0,99,1,RES,4,7.825,31.7
2017,ISERE,Chantepérier,133,21,112,1,111,1,EELV,8,7.825,31.7
2017,ISERE,Chantepérier,133,21,112,1,111,1,FN,25,7.825,31.7
2017,ISERE,Chantepérier,133,21,112,1,111,1,LFI,22,7.825,31.7
2017,ISERE,Chantepérier,133,21,112,1,111,1,LO,0,7.825,31.7
2017,ISERE,Chantepérier,133,21,112,1,111,1,LR,5,7.825,31.7
2017,ISERE,Chantepérier,133,21,112,1,111,1,LREM,36,7.825,31.7
2017,ISERE,Chantepérier,133,21,112,1,111,1,NPA,1,7.825,31.7
2017,ISERE,Chantepérier,133,21,112,1,111,1,PCF,4,7.825,31.7
2017,ISERE,Chantepérier,133,21,112,1,111,1,REC,5,7.825,31.7
2017,ISERE,Chantepérier,133,21,112,1,111,1,RES,2,7.825,31.7
2017,ISERE,Chalon,135,16,119,1,118,1,EELV,7,7.825,31.7
2017,ISERE,Chalon,135,16,119,1,118,1,FN,46,7.825,31.7
2017,ISERE,Chalon,135,16,119,1,118,1,LFI,18,7.825,31.7
2017,ISERE,Chalon,135,16,119,1,118,1,LO,0,7.825,31.7
2017,ISERE,Chalon,135,16,119,1,118,1,LR,5,7.825,31.7
2017,ISERE,Chalon,135,16,119,1,118,1,LREM,24,7.825,31.7
2017,ISERE,Chalon,135,16,119,1,118,1,NPA,0,7.825,31.7
2017,ISERE,Chalon,135,16,119,1,118,1,PCF,3,7.825,31.7
2017,ISERE,Chalon,135,16,119,1,118,1,REC,7,7.825,31.7
2017,ISERE,Chalon,135,16,119,1,118,1,RES,4,7.825,31.7
2017,ISERE,La Salette-Fallavaux,137,31,106,3,103,1,EELV,2,7.825,31.7
2017,ISERE,La Salette-Fallavaux,137,31,106,3,103,1,FN,29,7.825,31.7
2017,ISERE,La Salette-Fallavaux,137,31,106,3,103,1,LFI,14,7.825,31.7
2017,ISERE,La Salette-Fallavaux,137,31,106,3,103,1,LO,0,7.825,31.7
2017,ISERE,La Salette-Fallavaux,137,31,106,3,103,1,LR,5,7.825,31.7
2017,ISERE,La Salette-Fallavaux,137,31,106,3,103,1,LREM,30,7.825,31.7
2017,ISERE,La Salette-Fallavaux,137,31,106,3,103,1,NPA,0,7.825,31.7
2017,ISERE,La Salette-Fallavaux,137,31,106,3,103,1,PCF,3,7.825,31.7
2017,ISERE,La Salette-Fallavaux,137,31,106,3,103,1,REC,12,7.825,31.7
2017,ISERE,La Salette-Fallavaux,137,31,106,3,103,1,RES,3,7.825,31.7
2017,ISERE,La Motte-Saint-Martin,139,11,128,5,123,1,EELV,7,7.825,31.7
2017,ISERE,La Motte-Saint-Martin,139,11,128,5,123,1,FN,26,7.825,31.7
2017,ISERE,La Motte-Saint-Martin,139,11,128,5,123,1,LFI,37,7.825,31.7
2017,ISERE,La Motte-Saint-Martin,139,11,128,5,123,1,LO,0,7.825,31.7
2017,ISERE,La Motte-Saint-Martin,139,11,128,5,123,1,LR,7,7.825,31.7
2017,ISERE,La Motte-Saint-Martin,139,11,128,5,123,1,LREM,26,7.825,31.7
2017,ISERE,La Motte-Saint-Martin,139,11,128,5,123,1,NPA,0,7.825,31.7
2017,ISERE,La Motte-Saint-Martin,139,11,128,5,123,1,PCF,3,7.825,31.7
2017,ISERE,La Motte-Saint-Martin,139,11,128,5,123,1,REC,10,7.825,31.7
2017,ISERE,La Motte-Saint-Martin,139,11,128,5,123,1,RES,2,7.825,31.7
2017,ISERE,Saint-Maurice-en-Trièves,143,25,118,2,116,1,EELV,4,7.825,31.7
2017,ISERE,Saint-Maurice-en-Trièves,143,25,118,2,116,1,FN,37,7.825,31.7
2017,ISERE,Saint-Maurice-en-Trièves,143,25,118,2,116,1,LFI,29,7.825,31.7
2017,ISERE,Saint-Maurice-en-Trièves,143,25,118,2,116,1,LO,2,7.825,31.7
2017,ISERE,Saint-Maurice-en-Trièves,143,25,118,2,116,1,LR,8,7.825,31.7
2017,ISERE,Saint-Maurice-en-Trièves,143,25,118,2,116,1,LREM,16,7.825,31.7
2017,ISERE,Saint-Maurice-en-Trièves,143,25,118,2,116,1,NPA,0,7.825,31.7
2017,ISERE,Saint-Maurice-en-Trièves,143,25,118,2,116,1,PCF,1,7.825,31.7
2017,ISERE,Saint-Maurice-en-Trièves,143,25,118,2,116,1,REC,12,7.825,31.7
2017,ISERE,Saint-Maurice-en-Trièves,143,25,118,2,116,1,RES,5,7.825,31.7
2017,ISERE,Sousville,144,26,118,1,117,1,EELV,8,7.825,31.7
2017,ISERE,Sousville,144,26,118,1,117,1,FN,33,7.825,31.7
2017,ISERE,Sousville,144,26,118,1,117,1,LFI,15,7.825,31.7
2017,ISERE,Sousville,144,26,118,1,117,1,LO,0,7.825,31.7
2017,ISERE,Sousville,144,26,118,1,117,1,LR,6,7.825,31.7
2017,ISERE,Sousville,144,26,118,1,117,1,LREM,27,7.825,31.7
2017,ISERE,Sousville,144,26,118,1,117,1,NPA,0,7.825,31.7
2017,ISERE,Sousville,144,26,118,1,117,1,PCF,3,7.825,31.7
2017,ISERE,Sousville,144,26,118,1,117,1,REC,15,7.825,31.7
2017,ISERE,Sousville,144,26,118,1,117,1,RES,5,7.825,31.7
2017,ISERE,Lavars,149,30,119,2,117,1,EELV,3,7.825,31.7
2017,ISERE,Lavars,149,30,119,2,117,1,FN,27,7.825,31.7
2017,ISERE,Lavars,149,30,119,2,117,1,LFI,40,7.825,31.7
2017,ISERE,Lavars,149,30,119,2,117,1,LO,2,7.825,31.7
2017,ISERE,Lavars,149,30,119,2,117,1,LR,2,7.825,31.7
2017,ISERE,Lavars,149,30,119,2,117,1,LREM,27,7.825,31.7
2017,ISERE,Lavars,149,30,119,2,117,1,NPA,0,7.825,31.7
2017,ISERE,Lavars,149,30,119,2,117,1,PCF,4,7.825,31.7
2017,ISERE,Lavars,149,30,119,2,117,1,REC,5,7.825,31.7
2017,ISERE,Lavars,149,30,119,2,117,1,RES,4,7.825,31.7
2017,ISERE,Besse,149,45,104,0,104,1,EELV,2,7.825,31.7
2017,ISERE,Besse,149,45,104,0,104,1,FN,26,7.825,31.7
2017,ISERE,Besse,149,45,104,0,104,1,LFI,7,7.825,31.7
2017,ISERE,Besse,149,45,104,0,104,1,LO,2,7.825,31.7
2017,ISERE,Besse,149,45,104,0,104,1,LR,6,7.825,31.7
2017,ISERE,Besse,149,45,104,0,104,1,LREM,45,7.825,31.7
2017,ISERE,Besse,149,45,104,0,104,1,NPA,1,7.825,31.7
2017,ISERE,Besse,149,45,104,0,104,1,PCF,4,7.825,31.7
2017,ISERE,Besse,149,45,104,0,104,1,REC,3,7.825,31.7
2017,ISERE,Besse,149,45,104,0,104,1,RES,4,7.825,31.7
2017,ISERE,Saint-Martin-de-Clelles,153,13,140,1,139,1,EELV,22,7.825,31.7
2017,ISERE,Saint-Martin-de-Clelles,153,13,140,1,139,1,FN,23,7.825,31.7
2017,ISERE,Saint-Martin-de-Clelles,153,13,140,1,139,1,LFI,35,7.825,31.7
2017,ISERE,Saint-Martin-de-Clelles,153,13,140,1,139,1,LO,1,7.825,31.7
2017,ISERE,Saint-Martin-de-Clelles,153,13,140,1,139,1,LR,5,7.825,31.7
2017,ISERE,Saint-Martin-de-Clelles,153,13,140,1,139,1,LREM,26,7.825,31.7
2017,ISERE,Saint-Martin-de-Clelles,153,13,140,1,139,1,NPA,2,7.825,31.7
2017,ISERE,Saint-Martin-de-Clelles,153,13,140,1,139,1,PCF,4,7.825,31.7
2017,ISERE,Saint-Martin-de-Clelles,153,13,140,1,139,1,REC,10,7.825,31.7
2017,ISERE,Saint-Martin-de-Clelles,153,13,140,1,139,1,RES,6,7.825,31.7
2017,ISERE,Lavaldens,157,21,136,0,136,1,EELV,4,7.825,31.7
2017,ISERE,Lavaldens,157,21,136,0,136,1,FN,28,7.825,31.7
2017,ISERE,Lavaldens,157,21,136,0,136,1,LFI,35,7.825,31.7
2017,ISERE,Lavaldens,157,21,136,0,136,1,LO,0,7.825,31.7
2017,ISERE,Lavaldens,157,21,136,0,136,1,LR,4,7.825,31.7
2017,ISERE,Lavaldens,157,21,136,0,136,1,LREM,36,7.825,31.7
2017,ISERE,Lavaldens,157,21,136,0,136,1,NPA,1,7.825,31.7
2017,ISERE,Lavaldens,157,21,136,0,136,1,PCF,2,7.825,31.7
2017,ISERE,Lavaldens,157,21,136,0,136,1,REC,12,7.825,31.7
2017,ISERE,Lavaldens,157,21,136,0,136,1,RES,9,7.825,31.7
2017,ISERE,Cornillon-en-Trièves,160,31,129,3,126,1,EELV,7,7.825,31.7
2017,ISERE,Cornillon-en-Trièves,160,31,129,3,126,1,FN,22,7.825,31.7
2017,ISERE,Cornillon-en-Trièves,160,31,129,3,126,1,LFI,36,7.825,31.7
2017,ISERE,Cornillon-en-Trièves,160,31,129,3,126,1,LO,1,7.825,31.7
2017,ISERE,Cornillon-en-Trièves,160,31,129,3,126,1,LR,4,7.825,31.7
2017,ISERE,Cornillon-en-Trièves,160,31,129,3,126,1,LREM,29,7.825,31.7
2017,ISERE,Cornillon-en-Trièves,160,31,129,3,126,1,NPA,1,7.825,31.7
2017,ISERE,Cornillon-en-Trièves,160,31,129,3,126,1,PCF,7,7.825,31.7
2017,ISERE,Cornillon-en-Trièves,160,31,129,3,126,1,REC,2,7.825,31.7
2017,ISERE,Cornillon-en-Trièves,160,31,129,3,126,1,RES,7,7.825,31.7
2017,ISERE,Hurtières,163,33,130,1,129,1,EELV,21,7.825,31.7
2017,ISERE,Hurtières,163,33,130,1,129,1,FN,27,7.825,31.7
2017,ISERE,Hurtières,163,33,130,1,129,1,LFI,27,7.825,31.7
2017,ISERE,Hurtières,163,33,130,1,129,1,LO,0,7.825,31.7
2017,ISERE,Hurtières,163,33,130,1,129,1,LR,9,7.825,31.7
2017,ISERE,Hurtières,163,33,130,1,129,1,LREM,28,7.825,31.7
2017,ISERE,Hurtières,163,33,130,1,129,1,NPA,0,7.825,31.7
2017,ISERE,Hurtières,163,33,130,1,129,1,PCF,0,7.825,31.7
2017,ISERE,Hurtières,163,33,130,1,129,1,REC,9,7.825,31.7
2017,ISERE,Hurtières,163,33,130,1,129,1,RES,3,7.825,31.7
2017,ISERE,Prébois,163,38,125,2,123,1,EELV,5,7.825,31.7
2017,ISERE,Prébois,163,38,125,2,123,1,FN,15,7.825,31.7
2017,ISERE,Prébois,163,38,125,2,123,1,LFI,34,7.825,31.7
2017,ISERE,Prébois,163,38,125,2,123,1,LO,0,7.825,31.7
2017,ISERE,Prébois,163,38,125,2,123,1,LR,4,7.825,31.7
2017,ISERE,Prébois,163,38,125,2,123,1,LREM,36,7.825,31.7
2017,ISERE,Prébois,163,38,125,2,123,1,NPA,0,7.825,31.7
2017,ISERE,Prébois,163,38,125,2,123,1,PCF,6,7.825,31.7
2017,ISERE,Prébois,163,38,125,2,123,1,REC,11,7.825,31.7
2017,ISERE,Prébois,163,38,125,2,123,1,RES,4,7.825,31.7
2017,ISERE,Ornon,170,37,133,2,131,1,EELV,14,7.825,31.7
2017,ISERE,Ornon,170,37,133,2,131,1,FN,16,7.825,31.7
2017,ISERE,Ornon,170,37,133,2,131,1,LFI,39,7.825,31.7
2017,ISERE,Ornon,170,37,133,2,131,1,LO,2,7.825,31.7
2017,ISERE,Ornon,170,37,133,2,131,1,LR,4,7.825,31.7
2017,ISERE,Ornon,170,37,133,2,131,1,LREM,38,7.825,31.7
2017,ISERE,Ornon,170,37,133,2,131,1,NPA,2,7.825,31.7
2017,ISERE,Ornon,170,37,133,2,131,1,PCF,3,7.825,31.7
2017,ISERE,Ornon,170,37,133,2,131,1,REC,2,7.825,31.7
2017,ISERE,Ornon,170,37,133,2,131,1,RES,5,7.825,31.7
2017,ISERE,Mizoën,177,35,142,2,140,1,EELV,7,7.825,31.7
2017,ISERE,Mizoën,177,35,142,2,140,1,FN,23,7.825,31.7
2017,ISERE,Mizoën,177,35,142,2,140,1,LFI,42,7.825,31.7
2017,ISERE,Mizoën,177,35,142,2,140,1,LO,2,7.825,31.7
2017,ISERE,Mizoën,177,35,142,2,140,1,LR,11,7.825,31.7
2017,ISERE,Mizoën,177,35,142,2,140,1,LREM,26,7.825,31.7
2017,ISERE,Mizoën,177,35,142,2,140,1,NPA,6,7.825,31.7
2017,ISERE,Mizoën,177,35,142,2,140,1,PCF,6,7.825,31.7
2017,ISERE,Mizoën,177,35,142,2,140,1,REC,11,7.825,31.7
2017,ISERE,Mizoën,177,35,142,2,140,1,RES,2,7.825,31.7
2017,ISERE,Sainte-Marie-du-Mont,184,21,163,2,161,1,EELV,15,7.825,31.7
2017,ISERE,Sainte-Marie-du-Mont,184,21,163,2,161,1,FN,22,7.825,31.7
2017,ISERE,Sainte-Marie-du-Mont,184,21,163,2,161,1,LFI,46,7.825,31.7
2017,ISERE,Sainte-Marie-du-Mont,184,21,163,2,161,1,LO,3,7.825,31.7
2017,ISERE,Sainte-Marie-du-Mont,184,21,163,2,161,1,LR,4,7.825,31.7
2017,ISERE,Sainte-Marie-du-Mont,184,21,163,2,161,1,LREM,52,7.825,31.7
2017,ISERE,Sainte-Marie-du-Mont,184,21,163,2,161,1,NPA,1,7.825,31.7
2017,ISERE,Sainte-Marie-du-Mont,184,21,163,2,161,1,PCF,4,7.825,31.7
2017,ISERE,Sainte-Marie-du-Mont,184,21,163,2,161,1,REC,5,7.825,31.7
2017,ISERE,Sainte-Marie-du-Mont,184,21,163,2,161,1,RES,5,7.825,31.7
2017,ISERE,Pellafol,184,52,132,4,128,1,EELV,6,7.825,31.7
2017,ISERE,Pellafol,184,52,132,4,128,1,FN,24,7.825,31.7
2017,ISERE,Pellafol,184,52,132,4,128,1,LFI,28,7.825,31.7
2017,ISERE,Pellafol,184,52,132,4,128,1,LO,1,7.825,31.7
2017,ISERE,Pellafol,184,52,132,4,128,1,LR,9,7.825,31.7
2017,ISERE,Pellafol,184,52,132,4,128,1,LREM,36,7.825,31.7
2017,ISERE,Pellafol,184,52,132,4,128,1,NPA,1,7.825,31.7
2017,ISERE,Pellafol,184,52,132,4,128,1,PCF,4,7.825,31.7
2017,ISERE,Pellafol,184,52,132,4,128,1,REC,7,7.825,31.7
2017,ISERE,Pellafol,184,52,132,4,128,1,RES,6,7.825,31.7
2017,ISERE,Voissant,188,48,140,5,135,1,EELV,13,7.825,31.7
2017,ISERE,Voissant,188,48,140,5,135,1,FN,29,7.825,31.7
2017,ISERE,Voissant,188,48,140,5,135,1,LFI,19,7.825,31.7
2017,ISERE,Voissant,188,48,140,5,135,1,LO,1,7.825,31.7
2017,ISERE,Voissant,188,48,140,5,135,1,LR,2,7.825,31.7
2017,ISERE,Voissant,188,48,140,5,135,1,LREM,46,7.825,31.7
2017,ISERE,Voissant,188,48,140,5,135,1,NPA,0,7.825,31.7
2017,ISERE,Voissant,188,48,140,5,135,1,PCF,3,7.825,31.7
2017,ISERE,Voissant,188,48,140,5,135,1,REC,14,7.825,31.7
2017,ISERE,Voissant,188,48,140,5,135,1,RES,2,7.825,31.7
2017,ISERE,Saint-Guillaume,189,25,164,1,163,1,EELV,5,7.825,31.7
2017,ISERE,Saint-Guillaume,189,25,164,1,163,1,FN,41,7.825,31.7
2017,ISERE,Saint-Guillaume,189,25,164,1,163,1,LFI,30,7.825,31.7
2017,ISERE,Saint-Guillaume,189,25,164,1,163,1,LO,1,7.825,31.7
2017,ISERE,Saint-Guillaume,189,25,164,1,163,1,LR,17,7.825,31.7
2017,ISERE,Saint-Guillaume,189,25,164,1,163,1,LREM,42,7.825,31.7
2017,ISERE,Saint-Guillaume,189,25,164,1,163,1,NPA,2,7.825,31.7
2017,ISERE,Saint-Guillaume,189,25,164,1,163,1,PCF,3,7.825,31.7
2017,ISERE,Saint-Guillaume,189,25,164,1,163,1,REC,9,7.825,31.7
2017,ISERE,Saint-Guillaume,189,25,164,1,163,1,RES,11,7.825,31.7
2017,ISERE,Seyssinet-Pariset,190,28,162,2,160,1,EELV,20,7.825,31.7
2017,ISERE,Seyssinet-Pariset,190,28,162,2,160,1,FN,24,7.825,31.7
2017,ISERE,Seyssinet-Pariset,190,28,162,2,160,1,LFI,44,7.825,31.7
2017,ISERE,Seyssinet-Pariset,190,28,162,2,160,1,LO,2,7.825,31.7
2017,ISERE,Seyssinet-Pariset,190,28,162,2,160,1,LR,15,7.825,31.7
2017,ISERE,Seyssinet-Pariset,190,28,162,2,160,1,LREM,30,7.825,31.7
2017,ISERE,Seyssinet-Pariset,190,28,162,2,160,1,NPA,1,7.825,31.7
2017,ISERE,Seyssinet-Pariset,190,28,162,2,160,1,PCF,2,7.825,31.7
2017,ISERE,Seyssinet-Pariset,190,28,162,2,160,1,REC,11,7.825,31.7
2017,ISERE,Seyssinet-Pariset,190,28,162,2,160,1,RES,6,7.825,31.7
2017,ISERE,Livet-et-Gavet,190,39,151,9,142,1,EELV,0,7.825,31.7
2017,ISERE,Livet-et-Gavet,190,39,151,9,142,1,FN,49,7.825,31.7
2017,ISERE,Livet-et-Gavet,190,39,151,9,142,1,LFI,43,7.825,31.7
2017,ISERE,Livet-et-Gavet,190,39,151,9,142,1,LO,0,7.825,31.7
2017,ISERE,Livet-et-Gavet,190,39,151,9,142,1,LR,5,7.825,31.7
2017,ISERE,Livet-et-Gavet,190,39,151,9,142,1,LREM,23,7.825,31.7
2017,ISERE,Livet-et-Gavet,190,39,151,9,142,1,NPA,2,7.825,31.7
2017,ISERE,Livet-et-Gavet,190,39,151,9,142,1,PCF,0,7.825,31.7
2017,ISERE,Livet-et-Gavet,190,39,151,9,142,1,REC,11,7.825,31.7
2017,ISERE,Livet-et-Gavet,190,39,151,9,142,1,RES,6,7.825,31.7
2017,ISERE,Sarcenas,191,31,160,3,157,1,EELV,23,7.825,31.7
2017,ISERE,Sarcenas,191,31,160,3,157,1,FN,14,7.825,31.7
2017,ISERE,Sarcenas,191,31,160,3,157,1,LFI,62,7.825,31.7
2017,ISERE,Sarcenas,191,31,160,3,157,1,LO,0,7.825,31.7
2017,ISERE,Sarcenas,191,31,160,3,157,1,LR,3,7.825,31.7
2017,ISERE,Sarcenas,191,31,160,3,157,1,LREM,37,7.825,31.7
2017,ISERE,Sarcenas,191,31,160,3,157,1,NPA,3,7.825,31.7
2017,ISERE,Sarcenas,191,31,160,3,157,1,PCF,3,7.825,31.7
2017,ISERE,Sarcenas,191,31,160,3,157,1,REC,4,7.825,31.7
2017,ISERE,Sarcenas,191,31,160,3,157,1,RES,3,7.825,31.7
2017,ISERE,Le Haut-Bréda,192,29,163,3,160,1,EELV,9,7.825,31.7
2017,ISERE,Le Haut-Bréda,192,29,163,3,160,1,FN,31,7.825,31.7
2017,ISERE,Le Haut-Bréda,192,29,163,3,160,1,LFI,42,7.825,31.7
2017,ISERE,Le Haut-Bréda,192,29,163,3,160,1,LO,0,7.825,31.7
2017,ISERE,Le Haut-Bréda,192,29,163,3,160,1,LR,7,7.825,31.7
2017,ISERE,Le Haut-Bréda,192,29,163,3,160,1,LREM,40,7.825,31.7
2017,ISERE,Le Haut-Bréda,192,29,163,3,160,1,NPA,3,7.825,31.7
2017,ISERE,Le Haut-Bréda,192,29,163,3,160,1,PCF,6,7.825,31.7
2017,ISERE,Le Haut-Bréda,192,29,163,3,160,1,REC,10,7.825,31.7
2017,ISERE,Le Haut-Bréda,192,29,163,3,160,1,RES,8,7.825,31.7
2017,ISERE,Lalley,192,44,148,2,146,1,EELV,17,7.825,31.7
2017,ISERE,Lalley,192,44,148,2,146,1,FN,16,7.825,31.7
2017,ISERE,Lalley,192,44,148,2,146,1,LFI,39,7.825,31.7
2017,ISERE,Lalley,192,44,148,2,146,1,LO,4,7.825,31.7
2017,ISERE,Lalley,192,44,148,2,146,1,LR,7,7.825,31.7
2017,ISERE,Lalley,192,44,148,2,146,1,LREM,40,7.825,31.7
2017,ISERE,Lalley,192,44,148,2,146,1,NPA,0,7.825,31.7
2017,ISERE,Lalley,192,44,148,2,146,1,PCF,4,7.825,31.7
2017,ISERE,Lalley,192,44,148,2,146,1,REC,3,7.825,31.7
2017,ISERE,Lalley,192,44,148,2,146,1,RES,12,7.825,31.7
2017,ISERE,Avignonet,195,36,159,4,155,1,EELV,7,7.825,31.7
2017,ISERE,Avignonet,195,36,159,4,155,1,FN,19,7.825,31.7
2017,ISERE,Avignonet,195,36,159,4,155,1,LFI,25,7.825,31.7
2017,ISERE,Avignonet,195,36,159,4,155,1,LO,0,7.825,31.7
2017,ISERE,Avignonet,195,36,159,4,155,1,LR,8,7.825,31.7
2017,ISERE,Avignonet,195,36,159,4,155,1,LREM,72,7.825,31.7
2017,ISERE,Avignonet,195,36,159,4,155,1,NPA,0,7.825,31.7
2017,ISERE,Avignonet,195,36,159,4,155,1,PCF,2,7.825,31.7
2017,ISERE,Avignonet,195,36,159,4,155,1,REC,7,7.825,31.7
2017,ISERE,Avignonet,195,36,159,4,155,1,RES,10,7.825,31.7
2017,ISERE,Entraigues,195,41,154,1,153,1,EELV,7,7.825,31.7
2017,ISERE,Entraigues,195,41,154,1,153,1,FN,47,7.825,31.7
2017,ISERE,Entraigues,195,41,154,1,153,1,LFI,25,7.825,31.7
2017,ISERE,Entraigues,195,41,154,1,153,1,LO,0,7.825,31.7
2017,ISERE,Entraigues,195,41,154,1,153,1,LR,9,7.825,31.7
2017,ISERE,Entraigues,195,41,154,1,153,1,LREM,35,7.825,31.7
2017,ISERE,Entraigues,195,41,154,1,153,1,NPA,0,7.825,31.7
2017,ISERE,Entraigues,195,41,154,1,153,1,PCF,4,7.825,31.7
2017,ISERE,Entraigues,195,41,154,1,153,1,REC,11,7.825,31.7
2017,ISERE,Entraigues,195,41,154,1,153,1,RES,5,7.825,31.7
2017,ISERE,Porte-des-Bonnevaux,198,35,163,2,161,1,EELV,6,7.825,31.7
2017,ISERE,Porte-des-Bonnevaux,198,35,163,2,161,1,FN,55,7.825,31.7
2017,ISERE,Porte-des-Bonnevaux,198,35,163,2,161,1,LFI,24,7.825,31.7
2017,ISERE,Porte-des-Bonnevaux,198,35,163,2,161,1,LO,2,7.825,31.7
2017,ISERE,Porte-des-Bonnevaux,198,35,163,2,161,1,LR,7,7.825,31.7
2017,ISERE,Porte-des-Bonnevaux,198,35,163,2,161,1,LREM,34,7.825,31.7
2017,ISERE,Porte-des-Bonnevaux,198,35,163,2,161,1,NPA,0,7.825,31.7
2017,ISERE,Porte-des-Bonnevaux,198,35,163,2,161,1,PCF,4,7.825,31.7
2017,ISERE,Porte-des-Bonnevaux,198,35,163,2,161,1,REC,20,7.825,31.7
2017,ISERE,Porte-des-Bonnevaux,198,35,163,2,161,1,RES,1,7.825,31.7
2017,ISERE,La Morte,200,57,143,3,140,1,EELV,2,7.825,31.7
2017,ISERE,La Morte,200,57,143,3,140,1,FN,28,7.825,31.7
2017,ISERE,La Morte,200,57,143,3,140,1,LFI,35,7.825,31.7
2017,ISERE,La Morte,200,57,143,3,140,1,LO,0,7.825,31.7
2017,ISERE,La Morte,200,57,143,3,140,1,LR,4,7.825,31.7
2017,ISERE,La Morte,200,57,143,3,140,1,LREM,44,7.825,31.7
2017,ISERE,La Morte,200,57,143,3,140,1,NPA,0,7.825,31.7
2017,ISERE,La Morte,200,57,143,3,140,1,PCF,3,7.825,31.7
2017,ISERE,La Morte,200,57,143,3,140,1,REC,10,7.825,31.7
2017,ISERE,La Morte,200,57,143,3,140,1,RES,5,7.825,31.7
2017,ISERE,Tréminis,204,29,175,5,170,1,EELV,6,7.825,31.7
2017,ISERE,Tréminis,204,29,175,5,170,1,FN,31,7.825,31.7
2017,ISERE,Tréminis,204,29,175,5,170,1,LFI,51,7.825,31.7
2017,ISERE,Tréminis,204,29,175,5,170,1,LO,1,7.825,31.7
2017,ISERE,Tréminis,204,29,175,5,170,1,LR,9,7.825,31.7
2017,ISERE,Tréminis,204,29,175,5,170,1,LREM,32,7.825,31.7
2017,ISERE,Tréminis,204,29,175,5,170,1,NPA,0,7.825,31.7
2017,ISERE,Tréminis,204,29,175,5,170,1,PCF,6,7.825,31.7
2017,ISERE,Tréminis,204,29,175,5,170,1,REC,9,7.825,31.7
2017,ISERE,Tréminis,204,29,175,5,170,1,RES,10,7.825,31.7
2017,ISERE,Le Gua,205,44,161,5,156,1,EELV,12,7.825,31.7
2017,ISERE,Le Gua,205,44,161,5,156,1,FN,42,7.825,31.7
2017,ISERE,Le Gua,205,44,161,5,156,1,LFI,26,7.825,31.7
2017,ISERE,Le Gua,205,44,161,5,156,1,LO,0,7.825,31.7
2017,ISERE,Le Gua,205,44,161,5,156,1,LR,5,7.825,31.7
2017,ISERE,Le Gua,205,44,161,5,156,1,LREM,39,7.825,31.7
2017,ISERE,Le Gua,205,44,161,5,156,1,NPA,0,7.825,31.7
2017,ISERE,Le Gua,205,44,161,5,156,1,PCF,10,7.825,31.7
2017,ISERE,Le Gua,205,44,161,5,156,1,REC,7,7.825,31.7
2017,ISERE,Le Gua,205,44,161,5,156,1,RES,2,7.825,31.7
2017,ISERE,Chassignieu,206,36,170,4,166,1,EELV,4,7.825,31.7
2017,ISERE,Chassignieu,206,36,170,4,166,1,FN,57,7.825,31.7
2017,ISERE,Chassignieu,206,36,170,4,166,1,LFI,21,7.825,31.7
2017,ISERE,Chassignieu,206,36,170,4,166,1,LO,1,7.825,31.7
2017,ISERE,Chassignieu,206,36,170,4,166,1,LR,8,7.825,31.7
2017,ISERE,Chassignieu,206,36,170,4,166,1,LREM,38,7.825,31.7
2017,ISERE,Chassignieu,206,36,170,4,166,1,NPA,3,7.825,31.7
2017,ISERE,Chassignieu,206,36,170,4,166,1,PCF,0,7.825,31.7
2017,ISERE,Chassignieu,206,36,170,4,166,1,REC,14,7.825,31.7
2017,ISERE,Chassignieu,206,36,170,4,166,1,RES,10,7.825,31.7
2017,ISERE,Châtel en Trièves,207,38,169,1,168,1,EELV,16,7.825,31.7
2017,ISERE,Châtel en Trièves,207,38,169,1,168,1,FN,42,7.825,31.7
2017,ISERE,Châtel en Trièves,207,38,169,1,168,1,LFI,34,7.825,31.7
2017,ISERE,Châtel en Trièves,207,38,169,1,168,1,LO,3,7.825,31.7
2017,ISERE,Châtel en Trièves,207,38,169,1,168,1,LR,10,7.825,31.7
2017,ISERE,Châtel en Trièves,207,38,169,1,168,1,LREM,44,7.825,31.7
2017,ISERE,Châtel en Trièves,207,38,169,1,168,1,NPA,1,7.825,31.7
2017,ISERE,Châtel en Trièves,207,38,169,1,168,1,PCF,7,7.825,31.7
2017,ISERE,Châtel en Trièves,207,38,169,1,168,1,REC,2,7.825,31.7
2017,ISERE,Châtel en Trièves,207,38,169,1,168,1,RES,4,7.825,31.7
2017,ISERE,Valjouffrey,210,52,158,4,154,1,EELV,6,7.825,31.7
2017,ISERE,Valjouffrey,210,52,158,4,154,1,FN,30,7.825,31.7
2017,ISERE,Valjouffrey,210,52,158,4,154,1,LFI,27,7.825,31.7
2017,ISERE,Valjouffrey,210,52,158,4,154,1,LO,2,7.825,31.7
2017,ISERE,Valjouffrey,210,52,158,4,154,1,LR,7,7.825,31.7
2017,ISERE,Valjouffrey,210,52,158,4,154,1,LREM,45,7.825,31.7
2017,ISERE,Valjouffrey,210,52,158,4,154,1,NPA,4,7.825,31.7
2017,ISERE,Valjouffrey,210,52,158,4,154,1,PCF,10,7.825,31.7
2017,ISERE,Valjouffrey,210,52,158,4,154,1,REC,8,7.825,31.7
2017,ISERE,Valjouffrey,210,52,158,4,154,1,RES,3,7.825,31.7
2017,ISERE,Le Moutaret,212,30,182,4,178,1,EELV,13,7.825,31.7
2017,ISERE,Le Moutaret,212,30,182,4,178,1,FN,35,7.825,31.7
2017,ISERE,Le Moutaret,212,30,182,4,178,1,LFI,48,7.825,31.7
2017,ISERE,Le Moutaret,212,30,182,4,178,1,LO,1,7.825,31.7
2017,ISERE,Le Moutaret,212,30,182,4,178,1,LR,7,7.825,31.7
2017,ISERE,Le Moutaret,212,30,182,4,178,1,LREM,47,7.825,31.7
2017,ISERE,Le Moutaret,212,30,182,4,178,1,NPA,1,7.825,31.7
2017,ISERE,Le Moutaret,212,30,182,4,178,1,PCF,3,7.825,31.7
2017,ISERE,Le Moutaret,212,30,182,4,178,1,REC,10,7.825,31.7
2017,ISERE,Le Moutaret,212,30,182,4,178,1,RES,8,7.825,31.7
2017,ISERE,Plan,212,32,180,7,173,1,EELV,11,7.825,31.7
2017,ISERE,Plan,212,32,180,7,173,1,FN,39,7.825,31.7
2017,ISERE,Plan,212,32,180,7,173,1,LFI,23,7.825,31.7
2017,ISERE,Plan,212,32,180,7,173,1,LO,4,7.825,31.7
2017,ISERE,Plan,212,32,180,7,173,1,LR,5,7.825,31.7
2017,ISERE,Plan,212,32,180,7,173,1,LREM,44,7.825,31.7
2017,ISERE,Plan,212,32,180,7,173,1,NPA,3,7.825,31.7
2017,ISERE,Plan,212,32,180,7,173,1,PCF,0,7.825,31.7
2017,ISERE,Plan,212,32,180,7,173,1,REC,17,7.825,31.7
2017,ISERE,Plan,212,32,180,7,173,1,RES,14,7.825,31.7
2017,ISERE,Saint-Clair-sur-Galaure,212,42,170,3,167,1,EELV,6,7.825,31.7
2017,ISERE,Saint-Clair-sur-Galaure,212,42,170,3,167,1,FN,36,7.825,31.7
2017,ISERE,Saint-Clair-sur-Galaure,212,42,170,3,167,1,LFI,24,7.825,31.7
2017,ISERE,Saint-Clair-sur-Galaure,212,42,170,3,167,1,LO,5,7.825,31.7
2017,ISERE,Saint-Clair-sur-Galaure,212,42,170,3,167,1,LR,11,7.825,31.7
2017,ISERE,Saint-Clair-sur-Galaure,212,42,170,3,167,1,LREM,63,7.825,31.7
2017,ISERE,Saint-Clair-sur-Galaure,212,42,170,3,167,1,NPA,2,7.825,31.7
2017,ISERE,Saint-Clair-sur-Galaure,212,42,170,3,167,1,PCF,3,7.825,31.7
2017,ISERE,Saint-Clair-sur-Galaure,212,42,170,3,167,1,REC,6,7.825,31.7
2017,ISERE,Saint-Clair-sur-Galaure,212,42,170,3,167,1,RES,4,7.825,31.7
2017,ISERE,Vernas,213,46,167,4,163,1,EELV,11,7.825,31.7
2017,ISERE,Vernas,213,46,167,4,163,1,FN,42,7.825,31.7
2017,ISERE,Vernas,213,46,167,4,163,1,LFI,43,7.825,31.7
2017,ISERE,Vernas,213,46,167,4,163,1,LO,0,7.825,31.7
2017,ISERE,Vernas,213,46,167,4,163,1,LR,8,7.825,31.7
2017,ISERE,Vernas,213,46,167,4,163,1,LREM,32,7.825,31.7
2017,ISERE,Vernas,213,46,167,4,163,1,NPA,0,7.825,31.7
2017,ISERE,Vernas,213,46,167,4,163,1,PCF,3,7.825,31.7
2017,ISERE,Vernas,213,46,167,4,163,1,REC,13,7.825,31.7
2017,ISERE,Vernas,213,46,167,4,163,1,RES,5,7.825,31.7
2017,ISERE,Le Freney-d'Oisans,214,51,163,2,161,1,EELV,11,7.825,31.7
2017,ISERE,Le Freney-d'Oisans,214,51,163,2,161,1,FN,29,7.825,31.7
2017,ISERE,Le Freney-d'Oisans,214,51,163,2,161,1,LFI,42,7.825,31.7
2017,ISERE,Le Freney-d'Oisans,214,51,163,2,161,1,LO,1,7.825,31.7
2017,ISERE,Le Freney-d'Oisans,214,51,163,2,161,1,LR,2,7.825,31.7
2017,ISERE,Le Freney-d'Oisans,214,51,163,2,161,1,LREM,36,7.825,31.7
2017,ISERE,Le Freney-d'Oisans,214,51,163,2,161,1,NPA,6,7.825,31.7
2017,ISERE,Le Freney-d'Oisans,214,51,163,2,161,1,PCF,3,7.825,31.7
2017,ISERE,Le Freney-d'Oisans,214,51,163,2,161,1,REC,11,7.825,31.7
2017,ISERE,Le Freney-d'Oisans,214,51,163,2,161,1,RES,13,7.825,31.7
2017,ISERE,La Motte-Saint-Martin,215,38,177,5,172,1,EELV,12,7.825,31.7
2017,ISERE,La Motte-Saint-Martin,215,38,177,5,172,1,FN,43,7.825,31.7
2017,ISERE,La Motte-Saint-Martin,215,38,177,5,172,1,LFI,47,7.825,31.7
2017,ISERE,La Motte-Saint-Martin,215,38,177,5,172,1,LO,1,7.825,31.7
2017,ISERE,La Motte-Saint-Martin,215,38,177,5,172,1,LR,4,7.825,31.7
2017,ISERE,La Motte-Saint-Martin,215,38,177,5,172,1,LREM,28,7.825,31.7
2017,ISERE,La Motte-Saint-Martin,215,38,177,5,172,1,NPA,5,7.825,31.7
2017,ISERE,La Motte-Saint-Martin,215,38,177,5,172,1,PCF,8,7.825,31.7
2017,ISERE,La Motte-Saint-Martin,215,38,177,5,172,1,REC,10,7.825,31.7
2017,ISERE,La Motte-Saint-Martin,215,38,177,5,172,1,RES,6,7.825,31.7
2017,ISERE,Lentiol,216,37,179,7,172,1,EELV,9,7.825,31.7
2017,ISERE,Lentiol,216,37,179,7,172,1,FN,46,7.825,31.7
2017,ISERE,Lentiol,216,37,179,7,172,1,LFI,52,7.825,31.7
2017,ISERE,Lentiol,216,37,179,7,172,1,LO,1,7.825,31.7
2017,ISERE,Lentiol,216,37,179,7,172,1,LR,18,7.825,31.7
2017,ISERE,Lentiol,216,37,179,7,172,1,LREM,22,7.825,31.7
2017,ISERE,Lentiol,216,37,179,7,172,1,NPA,2,7.825,31.7
2017,ISERE,Lentiol,216,37,179,7,172,1,PCF,2,7.825,31.7
2017,ISERE,Lentiol,216,37,179,7,172,1,REC,5,7.825,31.7
2017,ISERE,Lentiol,216,37,179,7,172,1,RES,11,7.825,31.7
2017,ISERE,Treffort,218,33,185,6,179,1,EELV,10,7.825,31.7
2017,ISERE,Treffort,218,33,185,6,179,1,FN,26,7.825,31.7
2017,ISERE,Treffort,218,33,185,6,179,1,LFI,26,7.825,31.7
2017,ISERE,Treffort,218,33,185,6,179,1,LO,3,7.825,31.7
2017,ISERE,Treffort,218,33,185,6,179,1,LR,10,7.825,31.7
2017,ISERE,Treffort,218,33,185,6,179,1,LREM,67,7.825,31.7
2017,ISERE,Treffort,218,33,185,6,179,1,NPA,0,7.825,31.7
2017,ISERE,Treffort,218,33,185,6,179,1,PCF,8,7.825,31.7
2017,ISERE,Treffort,218,33,185,6,179,1,REC,12,7.825,31.7
2017,ISERE,Treffort,218,33,185,6,179,1,RES,8,7.825,31.7
2017,ISERE,Saint-Paul-lès-Monestier,222,35,187,1,186,1,EELV,10,7.825,31.7
2017,ISERE,Saint-Paul-lès-Monestier,222,35,187,1,186,1,FN,29,7.825,31.7
2017,ISERE,Saint-Paul-lès-Monestier,222,35,187,1,186,1,LFI,40,7.825,31.7
2017,ISERE,Saint-Paul-lès-Monestier,222,35,187,1,186,1,LO,0,7.825,31.7
2017,ISERE,Saint-Paul-lès-Monestier,222,35,187,1,186,1,LR,12,7.825,31.7
2017,ISERE,Saint-Paul-lès-Monestier,222,35,187,1,186,1,LREM,52,7.825,31.7
2017,ISERE,Saint-Paul-lès-Monestier,222,35,187,1,186,1,NPA,2,7.825,31.7
2017,ISERE,Saint-Paul-lès-Monestier,222,35,187,1,186,1,PCF,7,7.825,31.7
2017,ISERE,Saint-Paul-lès-Monestier,222,35,187,1,186,1,REC,17,7.825,31.7
2017,ISERE,Saint-Paul-lès-Monestier,222,35,187,1,186,1,RES,9,7.825,31.7
2017,ISERE,Ponsonnas,234,29,205,7,198,1,EELV,11,7.825,31.7
2017,ISERE,Ponsonnas,234,29,205,7,198,1,FN,45,7.825,31.7
2017,ISERE,Ponsonnas,234,29,205,7,198,1,LFI,46,7.825,31.7
2017,ISERE,Ponsonnas,234,29,205,7,198,1,LO,0,7.825,31.7
2017,ISERE,Ponsonnas,234,29,205,7,198,1,LR,9,7.825,31.7
2017,ISERE,Ponsonnas,234,29,205,7,198,1,LREM,50,7.825,31.7
2017,ISERE,Ponsonnas,234,29,205,7,198,1,NPA,0,7.825,31.7
2017,ISERE,Ponsonnas,234,29,205,7,198,1,PCF,6,7.825,31.7
2017,ISERE,Ponsonnas,234,29,205,7,198,1,REC,13,7.825,31.7
2017,ISERE,Ponsonnas,234,29,205,7,198,1,RES,9,7.825,31.7
2017,ISERE,Châtel en Trièves,234,40,194,4,190,1,EELV,9,7.825,31.7
2017,ISERE,Châtel en Trièves,234,40,194,4,190,1,FN,26,7.825,31.7
2017,ISERE,Châtel en Trièves,234,40,194,4,190,1,LFI,69,7.825,31.7
2017,ISERE,Châtel en Trièves,234,40,194,4,190,1,LO,0,7.825,31.7
2017,ISERE,Châtel en Trièves,234,40,194,4,190,1,LR,11,7.825,31.7
2017,ISERE,Châtel en Trièves,234,40,194,4,190,1,LREM,39,7.825,31.7
2017,ISERE,Châtel en Trièves,234,40,194,4,190,1,NPA,2,7.825,31.7
2017,ISERE,Châtel en Trièves,234,40,194,4,190,1,PCF,6,7.825,31.7
2017,ISERE,Châtel en Trièves,234,40,194,4,190,1,REC,9,7.825,31.7
2017,ISERE,Châtel en Trièves,234,40,194,4,190,1,RES,12,7.825,31.7
2017,ISERE,Le Monestier-du-Percy,237,26,211,5,206,1,EELV,11,7.825,31.7
2017,ISERE,Le Monestier-du-Percy,237,26,211,5,206,1,FN,27,7.825,31.7
2017,ISERE,Le Monestier-du-Percy,237,26,211,5,206,1,LFI,77,7.825,31.7
2017,ISERE,Le Monestier-du-Percy,237,26,211,5,206,1,LO,0,7.825,31.7
2017,ISERE,Le Monestier-du-Percy,237,26,211,5,206,1,LR,10,7.825,31.7
2017,ISERE,Le Monestier-du-Percy,237,26,211,5,206,1,LREM,49,7.825,31.7
2017,ISERE,Le Monestier-du-Percy,237,26,211,5,206,1,NPA,8,7.825,31.7
2017,ISERE,Le Monestier-du-Percy,237,26,211,5,206,1,PCF,3,7.825,31.7
2017,ISERE,Le Monestier-du-Percy,237,26,211,5,206,1,REC,6,7.825,31.7
2017,ISERE,Le Monestier-du-Percy,237,26,211,5,206,1,RES,4,7.825,31.7
2017,ISERE,Saint-Didier-de-Bizonnes,237,50,187,3,184,1,EELV,7,7.825,31.7
2017,ISERE,Saint-Didier-de-Bizonnes,237,50,187,3,184,1,FN,67,7.825,31.7
2017,ISERE,Saint-Didier-de-Bizonnes,237,50,187,3,184,1,LFI,42,7.825,31.7
2017,ISERE,Saint-Didier-de-Bizonnes,237,50,187,3,184,1,LO,2,7.825,31.7
2017,ISERE,Saint-Didier-de-Bizonnes,237,50,187,3,184,1,LR,7,7.825,31.7
2017,ISERE,Saint-Didier-de-Bizonnes,237,50,187,3,184,1,LREM,34,7.825,31.7
2017,ISERE,Saint-Didier-de-Bizonnes,237,50,187,3,184,1,NPA,0,7.825,31.7
2017,ISERE,Saint-Didier-de-Bizonnes,237,50,187,3,184,1,PCF,3,7.825,31.7
2017,ISERE,Saint-Didier-de-Bizonnes,237,50,187,3,184,1,REC,8,7.825,31.7
2017,ISERE,Saint-Didier-de-Bizonnes,237,50,187,3,184,1,RES,7,7.825,31.7
2017,ISERE,Auris,237,66,171,3,168,1,EELV,6,7.825,31.7
2017,ISERE,Auris,237,66,171,3,168,1,FN,40,7.825,31.7
2017,ISERE,Auris,237,66,171,3,168,1,LFI,33,7.825,31.7
2017,ISERE,Auris,237,66,171,3,168,1,LO,0,7.825,31.7
2017,ISERE,Auris,237,66,171,3,168,1,LR,11,7.825,31.7
2017,ISERE,Auris,237,66,171,3,168,1,LREM,53,7.825,31.7
2017,ISERE,Auris,237,66,171,3,168,1,NPA,1,7.825,31.7
2017,ISERE,Auris,237,66,171,3,168,1,PCF,0,7.825,31.7
2017,ISERE,Auris,237,66,171,3,168,1,REC,11,7.825,31.7
2017,ISERE,Auris,237,66,171,3,168,1,RES,5,7.825,31.7
2017,ISERE,Les Deux-Alpes,237,84,153,3,150,1,EELV,10,7.825,31.7
2017,ISERE,Les Deux-Alpes,237,84,153,3,150,1,FN,23,7.825,31.7
2017,ISERE,Les Deux-Alpes,237,84,153,3,150,1,LFI,32,7.825,31.7
2017,ISERE,Les Deux-Alpes,237,84,153,3,150,1,LO,1,7.825,31.7
2017,ISERE,Les Deux-Alpes,237,84,153,3,150,1,LR,5,7.825,31.7
2017,ISERE,Les Deux-Alpes,237,84,153,3,150,1,LREM,53,7.825,31.7
2017,ISERE,Les Deux-Alpes,237,84,153,3,150,1,NPA,1,7.825,31.7
2017,ISERE,Les Deux-Alpes,237,84,153,3,150,1,PCF,0,7.825,31.7
2017,ISERE,Les Deux-Alpes,237,84,153,3,150,1,REC,8,7.825,31.7
2017,ISERE,Les Deux-Alpes,237,84,153,3,150,1,RES,9,7.825,31.7
2017,ISERE,Saint-Jean-le-Vieux,238,36,202,2,200,1,EELV,17,7.825,31.7
2017,ISERE,Saint-Jean-le-Vieux,238,36,202,2,200,1,FN,34,7.825,31.7
2017,ISERE,Saint-Jean-le-Vieux,238,36,202,2,200,1,LFI,38,7.825,31.7
2017,ISERE,Saint-Jean-le-Vieux,238,36,202,2,200,1,LO,0,7.825,31.7
2017,ISERE,Saint-Jean-le-Vieux,238,36,202,2,200,1,LR,11,7.825,31.7
2017,ISERE,Saint-Jean-le-Vieux,238,36,202,2,200,1,LREM,71,7.825,31.7
2017,ISERE,Saint-Jean-le-Vieux,238,36,202,2,200,1,NPA,2,7.825,31.7
2017,ISERE,Saint-Jean-le-Vieux,238,36,202,2,200,1,PCF,0,7.825,31.7
2017,ISERE,Saint-Jean-le-Vieux,238,36,202,2,200,1,REC,16,7.825,31.7
2017,ISERE,Saint-Jean-le-Vieux,238,36,202,2,200,1,RES,8,7.825,31.7
2017,ISERE,Saint-Michel-de-Saint-Geoirs,240,33,207,6,201,1,EELV,10,7.825,31.7
2017,ISERE,Saint-Michel-de-Saint-Geoirs,240,33,207,6,201,1,FN,47,7.825,31.7
2017,ISERE,Saint-Michel-de-Saint-Geoirs,240,33,207,6,201,1,LFI,33,7.825,31.7
2017,ISERE,Saint-Michel-de-Saint-Geoirs,240,33,207,6,201,1,LO,2,7.825,31.7
2017,ISERE,Saint-Michel-de-Saint-Geoirs,240,33,207,6,201,1,LR,12,7.825,31.7
2017,ISERE,Saint-Michel-de-Saint-Geoirs,240,33,207,6,201,1,LREM,53,7.825,31.7
2017,ISERE,Saint-Michel-de-Saint-Geoirs,240,33,207,6,201,1,NPA,1,7.825,31.7
2017,ISERE,Saint-Michel-de-Saint-Geoirs,240,33,207,6,201,1,PCF,4,7.825,31.7
2017,ISERE,Saint-Michel-de-Saint-Geoirs,240,33,207,6,201,1,REC,18,7.825,31.7
2017,ISERE,Saint-Michel-de-Saint-Geoirs,240,33,207,6,201,1,RES,9,7.825,31.7
2017,ISERE,Montagne,240,55,185,6,179,1,EELV,5,7.825,31.7
2017,ISERE,Montagne,240,55,185,6,179,1,FN,49,7.825,31.7
2017,ISERE,Montagne,240,55,185,6,179,1,LFI,45,7.825,31.7
2017,ISERE,Montagne,240,55,185,6,179,1,LO,2,7.825,31.7
2017,ISERE,Montagne,240,55,185,6,179,1,LR,5,7.825,31.7
2017,ISERE,Montagne,240,55,185,6,179,1,LREM,37,7.825,31.7
2017,ISERE,Montagne,240,55,185,6,179,1,NPA,1,7.825,31.7
2017,ISERE,Montagne,240,55,185,6,179,1,PCF,10,7.825,31.7
2017,ISERE,Montagne,240,55,185,6,179,1,REC,9,7.825,31.7
2017,ISERE,Montagne,240,55,185,6,179,1,RES,3,7.825,31.7
2017,ISERE,Saint-Barthélemy-de-Séchilienne,246,44,202,4,198,1,EELV,7,7.825,31.7
2017,ISERE,Saint-Barthélemy-de-Séchilienne,246,44,202,4,198,1,FN,54,7.825,31.7
2017,ISERE,Saint-Barthélemy-de-Séchilienne,246,44,202,4,198,1,LFI,51,7.825,31.7
2017,ISERE,Saint-Barthélemy-de-Séchilienne,246,44,202,4,198,1,LO,3,7.825,31.7
2017,ISERE,Saint-Barthélemy-de-Séchilienne,246,44,202,4,198,1,LR,4,7.825,31.7
2017,ISERE,Saint-Barthélemy-de-Séchilienne,246,44,202,4,198,1,LREM,49,7.825,31.7
2017,ISERE,Saint-Barthélemy-de-Séchilienne,246,44,202,4,198,1,NPA,3,7.825,31.7
2017,ISERE,Saint-Barthélemy-de-Séchilienne,246,44,202,4,198,1,PCF,3,7.825,31.7
2017,ISERE,Saint-Barthélemy-de-Séchilienne,246,44,202,4,198,1,REC,13,7.825,31.7
2017,ISERE,Saint-Barthélemy-de-Séchilienne,246,44,202,4,198,1,RES,6,7.825,31.7
2017,ISERE,Oz,246,57,189,6,183,1,EELV,18,7.825,31.7
2017,ISERE,Oz,246,57,189,6,183,1,FN,27,7.825,31.7
2017,ISERE,Oz,246,57,189,6,183,1,LFI,45,7.825,31.7
2017,ISERE,Oz,246,57,189,6,183,1,LO,0,7.825,31.7
2017,ISERE,Oz,246,57,189,6,183,1,LR,20,7.825,31.7
2017,ISERE,Oz,246,57,189,6,183,1,LREM,46,7.825,31.7
2017,ISERE,Oz,246,57,189,6,183,1,NPA,2,7.825,31.7
2017,ISERE,Oz,246,57,189,6,183,1,PCF,1,7.825,31.7
2017,ISERE,Oz,246,57,189,6,183,1,REC,10,7.825,31.7
2017,ISERE,Oz,246,57,189,6,183,1,RES,8,7.825,31.7
2017,ISERE,Serre-Nerpol,246,66,180,18,162,1,EELV,4,7.825,31.7
2017,ISERE,Serre-Nerpol,246,66,180,18,162,1,FN,52,7.825,31.7
2017,ISERE,Serre-Nerpol,246,66,180,18,162,1,LFI,19,7.825,31.7
2017,ISERE,Serre-Nerpol,246,66,180,18,162,1,LO,2,7.825,31.7
2017,ISERE,Serre-Nerpol,246,66,180,18,162,1,LR,12,7.825,31.7
2017,ISERE,Serre-Nerpol,246,66,180,18,162,1,LREM,43,7.825,31.7
2017,ISERE,Serre-Nerpol,246,66,180,18,162,1,NPA,2,7.825,31.7
2017,ISERE,Serre-Nerpol,246,66,180,18,162,1,PCF,2,7.825,31.7
2017,ISERE,Serre-Nerpol,246,66,180,18,162,1,REC,8,7.825,31.7
2017,ISERE,Serre-Nerpol,246,66,180,18,162,1,RES,10,7.825,31.7
2017,ISERE,Saint-Martin-de-Vaulserre,247,47,200,8,192,1,EELV,13,7.825,31.7
2017,ISERE,Saint-Martin-de-Vaulserre,247,47,200,8,192,1,FN,44,7.825,31.7
2017,ISERE,Saint-Martin-de-Vaulserre,247,47,200,8,192,1,LFI,34,7.825,31.7
2017,ISERE,Saint-Martin-de-Vaulserre,247,47,200,8,192,1,LO,2,7.825,31.7
2017,ISERE,Saint-Martin-de-Vaulserre,247,47,200,8,192,1,LR,8,7.825,31.7
2017,ISERE,Saint-Martin-de-Vaulserre,247,47,200,8,192,1,LREM,56,7.825,31.7
2017,ISERE,Saint-Martin-de-Vaulserre,247,47,200,8,192,1,NPA,1,7.825,31.7
2017,ISERE,Saint-Martin-de-Vaulserre,247,47,200,8,192,1,PCF,4,7.825,31.7
2017,ISERE,Saint-Martin-de-Vaulserre,247,47,200,8,192,1,REC,10,7.825,31.7
2017,ISERE,Saint-Martin-de-Vaulserre,247,47,200,8,192,1,RES,15,7.825,31.7
2017,ISERE,Saint-Michel-les-Portes,250,37,213,5,208,1,EELV,16,7.825,31.7
2017,ISERE,Saint-Michel-les-Portes,250,37,213,5,208,1,FN,36,7.825,31.7
2017,ISERE,Saint-Michel-les-Portes,250,37,213,5,208,1,LFI,67,7.825,31.7
2017,ISERE,Saint-Michel-les-Portes,250,37,213,5,208,1,LO,1,7.825,31.7
2017,ISERE,Saint-Michel-les-Portes,250,37,213,5,208,1,LR,8,7.825,31.7
2017,ISERE,Saint-Michel-les-Portes,250,37,213,5,208,1,LREM,52,7.825,31.7
2017,ISERE,Saint-Michel-les-Portes,250,37,213,5,208,1,NPA,1,7.825,31.7
2017,ISERE,Saint-Michel-les-Portes,250,37,213,5,208,1,PCF,5,7.825,31.7
2017,ISERE,Saint-Michel-les-Portes,250,37,213,5,208,1,REC,8,7.825,31.7
2017,ISERE,Saint-Michel-les-Portes,250,37,213,5,208,1,RES,9,7.825,31.7
2017,ISERE,La Forteresse,253,56,197,1,196,1,EELV,7,7.825,31.7
2017,ISERE,La Forteresse,253,56,197,1,196,1,FN,56,7.825,31.7
2017,ISERE,La Forteresse,253,56,197,1,196,1,LFI,40,7.825,31.7
2017,ISERE,La Forteresse,253,56,197,1,196,1,LO,2,7.825,31.7
2017,ISERE,La Forteresse,253,56,197,1,196,1,LR,22,7.825,31.7
2017,ISERE,La Forteresse,253,56,197,1,196,1,LREM,33,7.825,31.7
2017,ISERE,La Forteresse,253,56,197,1,196,1,NPA,1,7.825,31.7
2017,ISERE,La Forteresse,253,56,197,1,196,1,PCF,4,7.825,31.7
2017,ISERE,La Forteresse,253,56,197,1,196,1,REC,13,7.825,31.7
2017,ISERE,La Forteresse,253,56,197,1,196,1,RES,7,7.825,31.7
2017,ISERE,Saint-Paul-d'Izeaux,257,63,194,4,190,1,EELV,8,7.825,31.7
2017,ISERE,Saint-Paul-d'Izeaux,257,63,194,4,190,1,FN,62,7.825,31.7
2017,ISERE,Saint-Paul-d'Izeaux,257,63,194,4,190,1,LFI,35,7.825,31.7
2017,ISERE,Saint-Paul-d'Izeaux,257,63,194,4,190,1,LO,1,7.825,31.7
2017,ISERE,Saint-Paul-d'Izeaux,257,63,194,4,190,1,LR,6,7.825,31.7
2017,ISERE,Saint-Paul-d'Izeaux,257,63,194,4,190,1,LREM,39,7.825,31.7
2017,ISERE,Saint-Paul-d'Izeaux,257,63,194,4,190,1,NPA,1,7.825,31.7
2017,ISERE,Saint-Paul-d'Izeaux,257,63,194,4,190,1,PCF,6,7.825,31.7
2017,ISERE,Saint-Paul-d'Izeaux,257,63,194,4,190,1,REC,12,7.825,31.7
2017,ISERE,Saint-Paul-d'Izeaux,257,63,194,4,190,1,RES,12,7.825,31.7
2017,ISERE,Saint-Mury-Monteymond,258,22,236,5,231,1,EELV,21,7.825,31.7
2017,ISERE,Saint-Mury-Monteymond,258,22,236,5,231,1,FN,49,7.825,31.7
2017,ISERE,Saint-Mury-Monteymond,258,22,236,5,231,1,LFI,55,7.825,31.7
2017,ISERE,Saint-Mury-Monteymond,258,22,236,5,231,1,LO,2,7.825,31.7
2017,ISERE,Saint-Mury-Monteymond,258,22,236,5,231,1,LR,5,7.825,31.7
2017,ISERE,Saint-Mury-Monteymond,258,22,236,5,231,1,LREM,46,7.825,31.7
2017,ISERE,Saint-Mury-Monteymond,258,22,236,5,231,1,NPA,4,7.825,31.7
2017,ISERE,Saint-Mury-Monteymond,258,22,236,5,231,1,PCF,10,7.825,31.7
2017,ISERE,Saint-Mury-Monteymond,258,22,236,5,231,1,REC,17,7.825,31.7
2017,ISERE,Saint-Mury-Monteymond,258,22,236,5,231,1,RES,9,7.825,31.7
2017,ISERE,Lieudieu,259,62,197,197,0,1,EELV,0,7.825,31.7
2017,ISERE,Lieudieu,259,62,197,197,0,1,FN,0,7.825,31.7
2017,ISERE,Lieudieu,259,62,197,197,0,1,LFI,0,7.825,31.7
2017,ISERE,Lieudieu,259,62,197,197,0,1,LO,0,7.825,31.7
2017,ISERE,Lieudieu,259,62,197,197,0,1,LR,0,7.825,31.7
2017,ISERE,Lieudieu,259,62,197,197,0,1,LREM,0,7.825,31.7
2017,ISERE,Lieudieu,259,62,197,197,0,1,NPA,0,7.825,31.7
2017,ISERE,Lieudieu,259,62,197,197,0,1,PCF,0,7.825,31.7
2017,ISERE,Lieudieu,259,62,197,197,0,1,REC,0,7.825,31.7
2017,ISERE,Lieudieu,259,62,197,197,0,1,RES,0,7.825,31.7
2017,ISERE,Roissard,262,39,223,2,221,1,EELV,11,7.825,31.7
2017,ISERE,Roissard,262,39,223,2,221,1,FN,55,7.825,31.7
2017,ISERE,Roissard,262,39,223,2,221,1,LFI,57,7.825,31.7
2017,ISERE,Roissard,262,39,223,2,221,1,LO,0,7.825,31.7
2017,ISERE,Roissard,262,39,223,2,221,1,LR,12,7.825,31.7
2017,ISERE,Roissard,262,39,223,2,221,1,LREM,42,7.825,31.7
2017,ISERE,Roissard,262,39,223,2,221,1,NPA,4,7.825,31.7
2017,ISERE,Roissard,262,39,223,2,221,1,PCF,9,7.825,31.7
2017,ISERE,Roissard,262,39,223,2,221,1,REC,8,7.825,31.7
2017,ISERE,Roissard,262,39,223,2,221,1,RES,16,7.825,31.7
2017,ISERE,Château-Bernard,262,55,207,1,206,1,EELV,15,7.825,31.7
2017,ISERE,Château-Bernard,262,55,207,1,206,1,FN,37,7.825,31.7
2017,ISERE,Château-Bernard,262,55,207,1,206,1,LFI,43,7.825,31.7
2017,ISERE,Château-Bernard,262,55,207,1,206,1,LO,2,7.825,31.7
2017,ISERE,Château-Bernard,262,55,207,1,206,1,LR,17,7.825,31.7
2017,ISERE,Château-Bernard,262,55,207,1,206,1,LREM,60,7.825,31.7
2017,ISERE,Château-Bernard,262,55,207,1,206,1,NPA,2,7.825,31.7
2017,ISERE,Château-Bernard,262,55,207,1,206,1,PCF,5,7.825,31.7
2017,ISERE,Château-Bernard,262,55,207,1,206,1,REC,15,7.825,31.7
2017,ISERE,Château-Bernard,262,55,207,1,206,1,RES,7,7.825,31.7
2017,ISERE,Le Haut-Bréda,263,40,223,5,218,1,EELV,13,7.825,31.7
2017,ISERE,Le Haut-Bréda,263,40,223,5,218,1,FN,37,7.825,31.7
2017,ISERE,Le Haut-Bréda,263,40,223,5,218,1,LFI,47,7.825,31.7
2017,ISERE,Le Haut-Bréda,263,40,223,5,218,1,LO,0,7.825,31.7
2017,ISERE,Le Haut-Bréda,263,40,223,5,218,1,LR,22,7.825,31.7
2017,ISERE,Le Haut-Bréda,263,40,223,5,218,1,LREM,57,7.825,31.7
2017,ISERE,Le Haut-Bréda,263,40,223,5,218,1,NPA,2,7.825,31.7
2017,ISERE,Le Haut-Bréda,263,40,223,5,218,1,PCF,5,7.825,31.7
2017,ISERE,Le Haut-Bréda,263,40,223,5,218,1,REC,13,7.825,31.7
2017,ISERE,Le Haut-Bréda,263,40,223,5,218,1,RES,11,7.825,31.7
2017,ISERE,Saint-Baudille-et-Pipet,266,46,220,6,214,1,EELV,11,7.825,31.7
2017,ISERE,Saint-Baudille-et-Pipet,266,46,220,6,214,1,FN,37,7.825,31.7
2017,ISERE,Saint-Baudille-et-Pipet,266,46,220,6,214,1,LFI,55,7.825,31.7
2017,ISERE,Saint-Baudille-et-Pipet,266,46,220,6,214,1,LO,0,7.825,31.7
2017,ISERE,Saint-Baudille-et-Pipet,266,46,220,6,214,1,LR,22,7.825,31.7
2017,ISERE,Saint-Baudille-et-Pipet,266,46,220,6,214,1,LREM,59,7.825,31.7
2017,ISERE,Saint-Baudille-et-Pipet,266,46,220,6,214,1,NPA,0,7.825,31.7
2017,ISERE,Saint-Baudille-et-Pipet,266,46,220,6,214,1,PCF,1,7.825,31.7
2017,ISERE,Saint-Baudille-et-Pipet,266,46,220,6,214,1,REC,12,7.825,31.7
2017,ISERE,Saint-Baudille-et-Pipet,266,46,220,6,214,1,RES,8,7.825,31.7
2017,ISERE,Livet-et-Gavet,268,70,198,1,197,1,EELV,2,7.825,31.7
2017,ISERE,Livet-et-Gavet,268,70,198,1,197,1,FN,85,7.825,31.7
2017,ISERE,Livet-et-Gavet,268,70,198,1,197,1,LFI,36,7.825,31.7
2017,ISERE,Livet-et-Gavet,268,70,198,1,197,1,LO,2,7.825,31.7
2017,ISERE,Livet-et-Gavet,268,70,198,1,197,1,LR,6,7.825,31.7
2017,ISERE,Livet-et-Gavet,268,70,198,1,197,1,LREM,37,7.825,31.7
2017,ISERE,Livet-et-Gavet,268,70,198,1,197,1,NPA,1,7.825,31.7
2017,ISERE,Livet-et-Gavet,268,70,198,1,197,1,PCF,4,7.825,31.7
2017,ISERE,Livet-et-Gavet,268,70,198,1,197,1,REC,9,7.825,31.7
2017,ISERE,Livet-et-Gavet,268,70,198,1,197,1,RES,8,7.825,31.7
2017,ISERE,Le Gua,275,47,228,2,226,1,EELV,12,7.825,31.7
2017,ISERE,Le Gua,275,47,228,2,226,1,FN,36,7.825,31.7
2017,ISERE,Le Gua,275,47,228,2,226,1,LFI,83,7.825,31.7
2017,ISERE,Le Gua,275,47,228,2,226,1,LO,0,7.825,31.7
2017,ISERE,Le Gua,275,47,228,2,226,1,LR,11,7.825,31.7
2017,ISERE,Le Gua,275,47,228,2,226,1,LREM,43,7.825,31.7
2017,ISERE,Le Gua,275,47,228,2,226,1,NPA,2,7.825,31.7
2017,ISERE,Le Gua,275,47,228,2,226,1,PCF,8,7.825,31.7
2017,ISERE,Le Gua,275,47,228,2,226,1,REC,16,7.825,31.7
2017,ISERE,Le Gua,275,47,228,2,226,1,RES,6,7.825,31.7
2017,ISERE,Bossieu,278,61,217,7,210,1,EELV,8,7.825,31.7
2017,ISERE,Bossieu,278,61,217,7,210,1,FN,80,7.825,31.7
2017,ISERE,Bossieu,278,61,217,7,210,1,LFI,27,7.825,31.7
2017,ISERE,Bossieu,278,61,217,7,210,1,LO,0,7.825,31.7
2017,ISERE,Bossieu,278,61,217,7,210,1,LR,16,7.825,31.7
2017,ISERE,Bossieu,278,61,217,7,210,1,LREM,35,7.825,31.7
2017,ISERE,Bossieu,278,61,217,7,210,1,NPA,1,7.825,31.7
2017,ISERE,Bossieu,278,61,217,7,210,1,PCF,6,7.825,31.7
2017,ISERE,Bossieu,278,61,217,7,210,1,REC,19,7.825,31.7
2017,ISERE,Bossieu,278,61,217,7,210,1,RES,7,7.825,31.7
2017,ISERE,Cholonge,280,42,238,5,233,1,EELV,23,7.825,31.7
2017,ISERE,Cholonge,280,42,238,5,233,1,FN,60,7.825,31.7
2017,ISERE,Cholonge,280,42,238,5,233,1,LFI,47,7.825,31.7
2017,ISERE,Cholonge,280,42,238,5,233,1,LO,4,7.825,31.7
2017,ISERE,Cholonge,280,42,238,5,233,1,LR,18,7.825,31.7
2017,ISERE,Cholonge,280,42,238,5,233,1,LREM,21,7.825,31.7
2017,ISERE,Cholonge,280,42,238,5,233,1,NPA,1,7.825,31.7
2017,ISERE,Cholonge,280,42,238,5,233,1,PCF,8,7.825,31.7
2017,ISERE,Cholonge,280,42,238,5,233,1,REC,27,7.825,31.7
2017,ISERE,Cholonge,280,42,238,5,233,1,RES,11,7.825,31.7
2017,ISERE,Huez,281,48,233,6,227,1,EELV,16,7.825,31.7
2017,ISERE,Huez,281,48,233,6,227,1,FN,45,7.825,31.7
2017,ISERE,Huez,281,48,233,6,227,1,LFI,38,7.825,31.7
2017,ISERE,Huez,281,48,233,6,227,1,LO,0,7.825,31.7
2017,ISERE,Huez,281,48,233,6,227,1,LR,5,7.825,31.7
2017,ISERE,Huez,281,48,233,6,227,1,LREM,83,7.825,31.7
2017,ISERE,Huez,281,48,233,6,227,1,NPA,4,7.825,31.7
2017,ISERE,Huez,281,48,233,6,227,1,PCF,3,7.825,31.7
2017,ISERE,Huez,281,48,233,6,227,1,REC,19,7.825,31.7
2017,ISERE,Huez,281,48,233,6,227,1,RES,6,7.825,31.7
2017,ISERE,Rencurel,282,51,231,4,227,1,EELV,12,7.825,31.7
2017,ISERE,Rencurel,282,51,231,4,227,1,FN,45,7.825,31.7
2017,ISERE,Rencurel,282,51,231,4,227,1,LFI,65,7.825,31.7
2017,ISERE,Rencurel,282,51,231,4,227,1,LO,1,7.825,31.7
2017,ISERE,Rencurel,282,51,231,4,227,1,LR,9,7.825,31.7
2017,ISERE,Rencurel,282,51,231,4,227,1,LREM,54,7.825,31.7
2017,ISERE,Rencurel,282,51,231,4,227,1,NPA,4,7.825,31.7
2017,ISERE,Rencurel,282,51,231,4,227,1,PCF,13,7.825,31.7
2017,ISERE,Rencurel,282,51,231,4,227,1,REC,11,7.825,31.7
2017,ISERE,Rencurel,282,51,231,4,227,1,RES,4,7.825,31.7
2017,ISERE,Porte-des-Bonnevaux,285,53,232,7,225,1,EELV,6,7.825,31.7
2017,ISERE,Porte-des-Bonnevaux,285,53,232,7,225,1,FN,74,7.825,31.7
2017,ISERE,Porte-des-Bonnevaux,285,53,232,7,225,1,LFI,32,7.825,31.7
2017,ISERE,Porte-des-Bonnevaux,285,53,232,7,225,1,LO,2,7.825,31.7
2017,ISERE,Porte-des-Bonnevaux,285,53,232,7,225,1,LR,17,7.825,31.7
2017,ISERE,Porte-des-Bonnevaux,285,53,232,7,225,1,LREM,62,7.825,31.7
2017,ISERE,Porte-des-Bonnevaux,285,53,232,7,225,1,NPA,0,7.825,31.7
2017,ISERE,Porte-des-Bonnevaux,285,53,232,7,225,1,PCF,1,7.825,31.7
2017,ISERE,Porte-des-Bonnevaux,285,53,232,7,225,1,REC,9,7.825,31.7
2017,ISERE,Porte-des-Bonnevaux,285,53,232,7,225,1,RES,10,7.825,31.7
2017,ISERE,Montchaboud,286,46,240,10,230,1,EELV,25,7.825,31.7
2017,ISERE,Montchaboud,286,46,240,10,230,1,FN,34,7.825,31.7
2017,ISERE,Montchaboud,286,46,240,10,230,1,LFI,52,7.825,31.7
2017,ISERE,Montchaboud,286,46,240,10,230,1,LO,0,7.825,31.7
2017,ISERE,Montchaboud,286,46,240,10,230,1,LR,10,7.825,31.7
2017,ISERE,Montchaboud,286,46,240,10,230,1,LREM,66,7.825,31.7
2017,ISERE,Montchaboud,286,46,240,10,230,1,NPA,2,7.825,31.7
2017,ISERE,Montchaboud,286,46,240,10,230,1,PCF,2,7.825,31.7
2017,ISERE,Montchaboud,286,46,240,10,230,1,REC,22,7.825,31.7
2017,ISERE,Montchaboud,286,46,240,10,230,1,RES,7,7.825,31.7
2017,ISERE,Morette,287,31,256,5,251,1,EELV,11,7.825,31.7
2017,ISERE,Morette,287,31,256,5,251,1,FN,66,7.825,31.7
2017,ISERE,Morette,287,31,256,5,251,1,LFI,44,7.825,31.7
2017,ISERE,Morette,287,31,256,5,251,1,LO,1,7.825,31.7
2017,ISERE,Morette,287,31,256,5,251,1,LR,9,7.825,31.7
2017,ISERE,Morette,287,31,256,5,251,1,LREM,71,7.825,31.7
2017,ISERE,Morette,287,31,256,5,251,1,NPA,3,7.825,31.7
2017,ISERE,Morette,287,31,256,5,251,1,PCF,6,7.825,31.7
2017,ISERE,Morette,287,31,256,5,251,1,REC,12,7.825,31.7
2017,ISERE,Morette,287,31,256,5,251,1,RES,13,7.825,31.7
2017,ISERE,Murinais,293,46,247,4,243,1,EELV,19,7.825,31.7
2017,ISERE,Murinais,293,46,247,4,243,1,FN,68,7.825,31.7
2017,ISERE,Murinais,293,46,247,4,243,1,LFI,55,7.825,31.7
2017,ISERE,Murinais,293,46,247,4,243,1,LO,0,7.825,31.7
2017,ISERE,Murinais,293,46,247,4,243,1,LR,4,7.825,31.7
2017,ISERE,Murinais,293,46,247,4,243,1,LREM,48,7.825,31.7
2017,ISERE,Murinais,293,46,247,4,243,1,NPA,4,7.825,31.7
2017,ISERE,Murinais,293,46,247,4,243,1,PCF,0,7.825,31.7
2017,ISERE,Murinais,293,46,247,4,243,1,REC,19,7.825,31.7
2017,ISERE,Murinais,293,46,247,4,243,1,RES,14,7.825,31.7
2017,ISERE,Saint-André-en-Royans,294,37,257,5,252,1,EELV,13,7.825,31.7
2017,ISERE,Saint-André-en-Royans,294,37,257,5,252,1,FN,53,7.825,31.7
2017,ISERE,Saint-André-en-Royans,294,37,257,5,252,1,LFI,74,7.825,31.7
2017,ISERE,Saint-André-en-Royans,294,37,257,5,252,1,LO,0,7.825,31.7
2017,ISERE,Saint-André-en-Royans,294,37,257,5,252,1,LR,23,7.825,31.7
2017,ISERE,Saint-André-en-Royans,294,37,257,5,252,1,LREM,49,7.825,31.7
2017,ISERE,Saint-André-en-Royans,294,37,257,5,252,1,NPA,3,7.825,31.7
2017,ISERE,Saint-André-en-Royans,294,37,257,5,252,1,PCF,3,7.825,31.7
2017,ISERE,Saint-André-en-Royans,294,37,257,5,252,1,REC,14,7.825,31.7
2017,ISERE,Saint-André-en-Royans,294,37,257,5,252,1,RES,7,7.825,31.7
2017,ISERE,Penol,294,49,245,4,241,1,EELV,9,7.825,31.7
2017,ISERE,Penol,294,49,245,4,241,1,FN,80,7.825,31.7
2017,ISERE,Penol,294,49,245,4,241,1,LFI,22,7.825,31.7
2017,ISERE,Penol,294,49,245,4,241,1,LO,2,7.825,31.7
2017,ISERE,Penol,294,49,245,4,241,1,LR,24,7.825,31.7
2017,ISERE,Penol,294,49,245,4,241,1,LREM,59,7.825,31.7
2017,ISERE,Penol,294,49,245,4,241,1,NPA,2,7.825,31.7
2017,ISERE,Penol,294,49,245,4,241,1,PCF,3,7.825,31.7
2017,ISERE,Penol,294,49,245,4,241,1,REC,18,7.825,31.7
2017,ISERE,Penol,294,49,245,4,241,1,RES,12,7.825,31.7
2017,ISERE,Chichilianne,297,29,268,7,261,1,EELV,23,7.825,31.7
2017,ISERE,Chichilianne,297,29,268,7,261,1,FN,57,7.825,31.7
2017,ISERE,Chichilianne,297,29,268,7,261,1,LFI,68,7.825,31.7
2017,ISERE,Chichilianne,297,29,268,7,261,1,LO,1,7.825,31.7
2017,ISERE,Chichilianne,297,29,268,7,261,1,LR,5,7.825,31.7
2017,ISERE,Chichilianne,297,29,268,7,261,1,LREM,57,7.825,31.7
2017,ISERE,Chichilianne,297,29,268,7,261,1,NPA,0,7.825,31.7
2017,ISERE,Chichilianne,297,29,268,7,261,1,PCF,7,7.825,31.7
2017,ISERE,Chichilianne,297,29,268,7,261,1,REC,8,7.825,31.7
2017,ISERE,Chichilianne,297,29,268,7,261,1,RES,18,7.825,31.7
2017,ISERE,Prunières,299,49,250,5,245,1,EELV,7,7.825,31.7
2017,ISERE,Prunières,299,49,250,5,245,1,FN,59,7.825,31.7
2017,ISERE,Prunières,299,49,250,5,245,1,LFI,66,7.825,31.7
2017,ISERE,Prunières,299,49,250,5,245,1,LO,2,7.825,31.7
2017,ISERE,Prunières,299,49,250,5,245,1,LR,11,7.825,31.7
2017,ISERE,Prunières,299,49,250,5,245,1,LREM,34,7.825,31.7
2017,ISERE,Prunières,299,49,250,5,245,1,NPA,3,7.825,31.7
2017,ISERE,Prunières,299,49,250,5,245,1,PCF,11,7.825,31.7
2017,ISERE,Prunières,299,49,250,5,245,1,REC,19,7.825,31.7
2017,ISERE,Prunières,299,49,250,5,245,1,RES,17,7.825,31.7
2017,ISERE,Auberives-en-Royans,301,52,249,2,247,1,EELV,15,7.825,31.7
2017,ISERE,Auberives-en-Royans,301,52,249,2,247,1,FN,67,7.825,31.7
2017,ISERE,Auberives-en-Royans,301,52,249,2,247,1,LFI,50,7.825,31.7
2017,ISERE,Auberives-en-Royans,301,52,249,2,247,1,LO,3,7.825,31.7
2017,ISERE,Auberives-en-Royans,301,52,249,2,247,1,LR,11,7.825,31.7
2017,ISERE,Auberives-en-Royans,301,52,249,2,247,1,LREM,51,7.825,31.7
2017,ISERE,Auberives-en-Royans,301,52,249,2,247,1,NPA,2,7.825,31.7
2017,ISERE,Auberives-en-Royans,301,52,249,2,247,1,PCF,6,7.825,31.7
2017,ISERE,Auberives-en-Royans,301,52,249,2,247,1,REC,14,7.825,31.7
2017,ISERE,Auberives-en-Royans,301,52,249,2,247,1,RES,14,7.825,31.7
2017,ISERE,Saint-Jean-d'Hérans,306,56,250,4,246,1,EELV,10,7.825,31.7
2017,ISERE,Saint-Jean-d'Hérans,306,56,250,4,246,1,FN,65,7.825,31.7
2017,ISERE,Saint-Jean-d'Hérans,306,56,250,4,246,1,LFI,66,7.825,31.7
2017,ISERE,Saint-Jean-d'Hérans,306,56,250,4,246,1,LO,3,7.825,31.7
2017,ISERE,Saint-Jean-d'Hérans,306,56,250,4,246,1,LR,13,7.825,31.7
2017,ISERE,Saint-Jean-d'Hérans,306,56,250,4,246,1,LREM,41,7.825,31.7
2017,ISERE,Saint-Jean-d'Hérans,306,56,250,4,246,1,NPA,2,7.825,31.7
2017,ISERE,Saint-Jean-d'Hérans,306,56,250,4,246,1,PCF,9,7.825,31.7
2017,ISERE,Saint-Jean-d'Hérans,306,56,250,4,246,1,REC,17,7.825,31.7
2017,ISERE,Saint-Jean-d'Hérans,306,56,250,4,246,1,RES,4,7.825,31.7
2017,ISERE,Veyssilieu,309,47,262,4,258,1,EELV,16,7.825,31.7
2017,ISERE,Veyssilieu,309,47,262,4,258,1,FN,64,7.825,31.7
2017,ISERE,Veyssilieu,309,47,262,4,258,1,LFI,41,7.825,31.7
2017,ISERE,Veyssilieu,309,47,262,4,258,1,LO,2,7.825,31.7
2017,ISERE,Veyssilieu,309,47,262,4,258,1,LR,8,7.825,31.7
2017,ISERE,Veyssilieu,309,47,262,4,258,1,LREM,70,7.825,31.7
2017,ISERE,Veyssilieu,309,47,262,4,258,1,NPA,4,7.825,31.7
2017,ISERE,Veyssilieu,309,47,262,4,258,1,PCF,4,7.825,31.7
2017,ISERE,Veyssilieu,309,47,262,4,258,1,REC,20,7.825,31.7
2017,ISERE,Veyssilieu,309,47,262,4,258,1,RES,16,7.825,31.7
2017,ISERE,Royas,311,52,259,12,247,1,EELV,4,7.825,31.7
2017,ISERE,Royas,311,52,259,12,247,1,FN,76,7.825,31.7
2017,ISERE,Royas,311,52,259,12,247,1,LFI,27,7.825,31.7
2017,ISERE,Royas,311,52,259,12,247,1,LO,0,7.825,31.7
2017,ISERE,Royas,311,52,259,12,247,1,LR,11,7.825,31.7
2017,ISERE,Royas,311,52,259,12,247,1,LREM,68,7.825,31.7
2017,ISERE,Royas,311,52,259,12,247,1,NPA,1,7.825,31.7
2017,ISERE,Royas,311,52,259,12,247,1,PCF,3,7.825,31.7
2017,ISERE,Royas,311,52,259,12,247,1,REC,29,7.825,31.7
2017,ISERE,Royas,311,52,259,12,247,1,RES,11,7.825,31.7
2017,ISERE,La Salle-en-Beaumont,311,69,242,6,236,1,EELV,9,7.825,31.7
2017,ISERE,La Salle-en-Beaumont,311,69,242,6,236,1,FN,84,7.825,31.7
2017,ISERE,La Salle-en-Beaumont,311,69,242,6,236,1,LFI,47,7.825,31.7
2017,ISERE,La Salle-en-Beaumont,311,69,242,6,236,1,LO,2,7.825,31.7
2017,ISERE,La Salle-en-Beaumont,311,69,242,6,236,1,LR,12,7.825,31.7
2017,ISERE,La Salle-en-Beaumont,311,69,242,6,236,1,LREM,40,7.825,31.7
2017,ISERE,La Salle-en-Beaumont,311,69,242,6,236,1,NPA,0,7.825,31.7
2017,ISERE,La Salle-en-Beaumont,311,69,242,6,236,1,PCF,6,7.825,31.7
2017,ISERE,La Salle-en-Beaumont,311,69,242,6,236,1,REC,15,7.825,31.7
2017,ISERE,La Salle-en-Beaumont,311,69,242,6,236,1,RES,8,7.825,31.7
2017,ISERE,Miribel-Lanchâtre,316,41,275,8,267,1,EELV,13,7.825,31.7
2017,ISERE,Miribel-Lanchâtre,316,41,275,8,267,1,FN,74,7.825,31.7
2017,ISERE,Miribel-Lanchâtre,316,41,275,8,267,1,LFI,64,7.825,31.7
2017,ISERE,Miribel-Lanchâtre,316,41,275,8,267,1,LO,0,7.825,31.7
2017,ISERE,Miribel-Lanchâtre,316,41,275,8,267,1,LR,7,7.825,31.7
2017,ISERE,Miribel-Lanchâtre,316,41,275,8,267,1,LREM,62,7.825,31.7
2017,ISERE,Miribel-Lanchâtre,316,41,275,8,267,1,NPA,0,7.825,31.7
2017,ISERE,Miribel-Lanchâtre,316,41,275,8,267,1,PCF,6,7.825,31.7
2017,ISERE,Miribel-Lanchâtre,316,41,275,8,267,1,REC,22,7.825,31.7
2017,ISERE,Miribel-Lanchâtre,316,41,275,8,267,1,RES,9,7.825,31.7
2017,ISERE,Chantesse,321,50,271,10,261,1,EELV,17,7.825,31.7
2017,ISERE,Chantesse,321,50,271,10,261,1,FN,83,7.825,31.7
2017,ISERE,Chantesse,321,50,271,10,261,1,LFI,45,7.825,31.7
2017,ISERE,Chantesse,321,50,271,10,261,1,LO,1,7.825,31.7
2017,ISERE,Chantesse,321,50,271,10,261,1,LR,9,7.825,31.7
2017,ISERE,Chantesse,321,50,271,10,261,1,LREM,57,7.825,31.7
2017,ISERE,Chantesse,321,50,271,10,261,1,NPA,2,7.825,31.7
2017,ISERE,Chantesse,321,50,271,10,261,1,PCF,6,7.825,31.7
2017,ISERE,Chantesse,321,50,271,10,261,1,REC,14,7.825,31.7
2017,ISERE,Chantesse,321,50,271,10,261,1,RES,10,7.825,31.7
2017,ISERE,Saint-Romain-de-Surieu,327,37,290,8,282,1,EELV,7,7.825,31.7
2017,ISERE,Saint-Romain-de-Surieu,327,37,290,8,282,1,FN,86,7.825,31.7
2017,ISERE,Saint-Romain-de-Surieu,327,37,290,8,282,1,LFI,40,7.825,31.7
2017,ISERE,Saint-Romain-de-Surieu,327,37,290,8,282,1,LO,3,7.825,31.7
2017,ISERE,Saint-Romain-de-Surieu,327,37,290,8,282,1,LR,11,7.825,31.7
2017,ISERE,Saint-Romain-de-Surieu,327,37,290,8,282,1,LREM,71,7.825,31.7
2017,ISERE,Saint-Romain-de-Surieu,327,37,290,8,282,1,NPA,1,7.825,31.7
2017,ISERE,Saint-Romain-de-Surieu,327,37,290,8,282,1,PCF,12,7.825,31.7
2017,ISERE,Saint-Romain-de-Surieu,327,37,290,8,282,1,REC,31,7.825,31.7
2017,ISERE,Saint-Romain-de-Surieu,327,37,290,8,282,1,RES,10,7.825,31.7
2017,ISERE,Apprieu,327,75,252,7,245,1,EELV,18,7.825,31.7
2017,ISERE,Apprieu,327,75,252,7,245,1,FN,81,7.825,31.7
2017,ISERE,Apprieu,327,75,252,7,245,1,LFI,45,7.825,31.7
2017,ISERE,Apprieu,327,75,252,7,245,1,LO,0,7.825,31.7
2017,ISERE,Apprieu,327,75,252,7,245,1,LR,3,7.825,31.7
2017,ISERE,Apprieu,327,75,252,7,245,1,LREM,52,7.825,31.7
2017,ISERE,Apprieu,327,75,252,7,245,1,NPA,2,7.825,31.7
2017,ISERE,Apprieu,327,75,252,7,245,1,PCF,9,7.825,31.7
2017,ISERE,Apprieu,327,75,252,7,245,1,REC,12,7.825,31.7
2017,ISERE,Apprieu,327,75,252,7,245,1,RES,5,7.825,31.7
2017,ISERE,Vatilieu,335,52,283,6,277,1,EELV,22,7.825,31.7
2017,ISERE,Vatilieu,335,52,283,6,277,1,FN,58,7.825,31.7
2017,ISERE,Vatilieu,335,52,283,6,277,1,LFI,47,7.825,31.7
2017,ISERE,Vatilieu,335,52,283,6,277,1,LO,2,7.825,31.7
2017,ISERE,Vatilieu,335,52,283,6,277,1,LR,14,7.825,31.7
2017,ISERE,Vatilieu,335,52,283,6,277,1,LREM,81,7.825,31.7
2017,ISERE,Vatilieu,335,52,283,6,277,1,NPA,4,7.825,31.7
2017,ISERE,Vatilieu,335,52,283,6,277,1,PCF,4,7.825,31.7
2017,ISERE,Vatilieu,335,52,283,6,277,1,REC,21,7.825,31.7
2017,ISERE,Vatilieu,335,52,283,6,277,1,RES,13,7.825,31.7
2017,ISERE,Burcin,336,49,287,7,280,1,EELV,6,7.825,31.7
2017,ISERE,Burcin,336,49,287,7,280,1,FN,61,7.825,31.7
2017,ISERE,Burcin,336,49,287,7,280,1,LFI,27,7.825,31.7
2017,ISERE,Burcin,336,49,287,7,280,1,LO,2,7.825,31.7
2017,ISERE,Burcin,336,49,287,7,280,1,LR,27,7.825,31.7
2017,ISERE,Burcin,336,49,287,7,280,1,LREM,88,7.825,31.7
2017,ISERE,Burcin,336,49,287,7,280,1,NPA,2,7.825,31.7
2017,ISERE,Burcin,336,49,287,7,280,1,PCF,3,7.825,31.7
2017,ISERE,Burcin,336,49,287,7,280,1,REC,37,7.825,31.7
2017,ISERE,Burcin,336,49,287,7,280,1,RES,8,7.825,31.7
2017,ISERE,Cras,337,49,288,5,283,1,EELV,14,7.825,31.7
2017,ISERE,Cras,337,49,288,5,283,1,FN,82,7.825,31.7
2017,ISERE,Cras,337,49,288,5,283,1,LFI,75,7.825,31.7
2017,ISERE,Cras,337,49,288,5,283,1,LO,3,7.825,31.7
2017,ISERE,Cras,337,49,288,5,283,1,LR,8,7.825,31.7
2017,ISERE,Cras,337,49,288,5,283,1,LREM,52,7.825,31.7
2017,ISERE,Cras,337,49,288,5,283,1,NPA,2,7.825,31.7
2017,ISERE,Cras,337,49,288,5,283,1,PCF,9,7.825,31.7
2017,ISERE,Cras,337,49,288,5,283,1,REC,12,7.825,31.7
2017,ISERE,Cras,337,49,288,5,283,1,RES,6,7.825,31.7
2017,ISERE,Saint-Albin-de-Vaulserre,337,58,279,8,271,1,EELV,10,7.825,31.7
2017,ISERE,Saint-Albin-de-Vaulserre,337,58,279,8,271,1,FN,87,7.825,31.7
2017,ISERE,Saint-Albin-de-Vaulserre,337,58,279,8,271,1,LFI,38,7.825,31.7
2017,ISERE,Saint-Albin-de-Vaulserre,337,58,279,8,271,1,LO,1,7.825,31.7
2017,ISERE,Saint-Albin-de-Vaulserre,337,58,279,8,271,1,LR,11,7.825,31.7
2017,ISERE,Saint-Albin-de-Vaulserre,337,58,279,8,271,1,LREM,72,7.825,31.7
2017,ISERE,Saint-Albin-de-Vaulserre,337,58,279,8,271,1,NPA,2,7.825,31.7
2017,ISERE,Saint-Albin-de-Vaulserre,337,58,279,8,271,1,PCF,4,7.825,31.7
2017,ISERE,Saint-Albin-de-Vaulserre,337,58,279,8,271,1,REC,20,7.825,31.7
2017,ISERE,Saint-Albin-de-Vaulserre,337,58,279,8,271,1,RES,11,7.825,31.7
2017,ISERE,Vasselin,341,59,282,5,277,1,EELV,11,7.825,31.7
2017,ISERE,Vasselin,341,59,282,5,277,1,FN,93,7.825,31.7
2017,ISERE,Vasselin,341,59,282,5,277,1,LFI,39,7.825,31.7
2017,ISERE,Vasselin,341,59,282,5,277,1,LO,1,7.825,31.7
2017,ISERE,Vasselin,341,59,282,5,277,1,LR,10,7.825,31.7
2017,ISERE,Vasselin,341,59,282,5,277,1,LREM,59,7.825,31.7
2017,ISERE,Vasselin,341,59,282,5,277,1,NPA,1,7.825,31.7
2017,ISERE,Vasselin,341,59,282,5,277,1,PCF,6,7.825,31.7
2017,ISERE,Vasselin,341,59,282,5,277,1,REC,27,7.825,31.7
2017,ISERE,Vasselin,341,59,282,5,277,1,RES,9,7.825,31.7
2017,ISERE,Plateau des Petites Roches,342,57,285,9,276,1,EELV,29,7.825,31.7
2017,ISERE,Plateau des Petites Roches,342,57,285,9,276,1,FN,20,7.825,31.7
2017,ISERE,Plateau des Petites Roches,342,57,285,9,276,1,LFI,110,7.825,31.7
2017,ISERE,Plateau des Petites Roches,342,57,285,9,276,1,LO,1,7.825,31.7
2017,ISERE,Plateau des Petites Roches,342,57,285,9,276,1,LR,7,7.825,31.7
2017,ISERE,Plateau des Petites Roches,342,57,285,9,276,1,LREM,70,7.825,31.7
2017,ISERE,Plateau des Petites Roches,342,57,285,9,276,1,NPA,3,7.825,31.7
2017,ISERE,Plateau des Petites Roches,342,57,285,9,276,1,PCF,2,7.825,31.7
2017,ISERE,Plateau des Petites Roches,342,57,285,9,276,1,REC,9,7.825,31.7
2017,ISERE,Plateau des Petites Roches,342,57,285,9,276,1,RES,6,7.825,31.7
2017,ISERE,Saint-Appolinard,342,69,273,7,266,1,EELV,6,7.825,31.7
2017,ISERE,Saint-Appolinard,342,69,273,7,266,1,FN,82,7.825,31.7
2017,ISERE,Saint-Appolinard,342,69,273,7,266,1,LFI,41,7.825,31.7
2017,ISERE,Saint-Appolinard,342,69,273,7,266,1,LO,2,7.825,31.7
2017,ISERE,Saint-Appolinard,342,69,273,7,266,1,LR,11,7.825,31.7
2017,ISERE,Saint-Appolinard,342,69,273,7,266,1,LREM,78,7.825,31.7
2017,ISERE,Saint-Appolinard,342,69,273,7,266,1,NPA,3,7.825,31.7
2017,ISERE,Saint-Appolinard,342,69,273,7,266,1,PCF,5,7.825,31.7
2017,ISERE,Saint-Appolinard,342,69,273,7,266,1,REC,17,7.825,31.7
2017,ISERE,Saint-Appolinard,342,69,273,7,266,1,RES,6,7.825,31.7
2017,ISERE,Val-de-Virieu,345,72,273,3,270,1,EELV,14,7.825,31.7
2017,ISERE,Val-de-Virieu,345,72,273,3,270,1,FN,81,7.825,31.7
2017,ISERE,Val-de-Virieu,345,72,273,3,270,1,LFI,48,7.825,31.7
2017,ISERE,Val-de-Virieu,345,72,273,3,270,1,LO,0,7.825,31.7
2017,ISERE,Val-de-Virieu,345,72,273,3,270,1,LR,12,7.825,31.7
2017,ISERE,Val-de-Virieu,345,72,273,3,270,1,LREM,66,7.825,31.7
2017,ISERE,Val-de-Virieu,345,72,273,3,270,1,NPA,2,7.825,31.7
2017,ISERE,Val-de-Virieu,345,72,273,3,270,1,PCF,5,7.825,31.7
2017,ISERE,Val-de-Virieu,345,72,273,3,270,1,REC,21,7.825,31.7
2017,ISERE,Val-de-Virieu,345,72,273,3,270,1,RES,10,7.825,31.7
2017,ISERE,Montrevel,346,60,286,6,280,1,EELV,12,7.825,31.7
2017,ISERE,Montrevel,346,60,286,6,280,1,FN,112,7.825,31.7
2017,ISERE,Montrevel,346,60,286,6,280,1,LFI,38,7.825,31.7
2017,ISERE,Montrevel,346,60,286,6,280,1,LO,3,7.825,31.7
2017,ISERE,Montrevel,346,60,286,6,280,1,LR,13,7.825,31.7
2017,ISERE,Montrevel,346,60,286,6,280,1,LREM,45,7.825,31.7
2017,ISERE,Montrevel,346,60,286,6,280,1,NPA,4,7.825,31.7
2017,ISERE,Montrevel,346,60,286,6,280,1,PCF,3,7.825,31.7
2017,ISERE,Montrevel,346,60,286,6,280,1,REC,18,7.825,31.7
2017,ISERE,Montrevel,346,60,286,6,280,1,RES,14,7.825,31.7
2017,ISERE,Laffrey,348,70,278,14,264,1,EELV,15,7.825,31.7
2017,ISERE,Laffrey,348,70,278,14,264,1,FN,77,7.825,31.7
2017,ISERE,Laffrey,348,70,278,14,264,1,LFI,52,7.825,31.7
2017,ISERE,Laffrey,348,70,278,14,264,1,LO,0,7.825,31.7
2017,ISERE,Laffrey,348,70,278,14,264,1,LR,11,7.825,31.7
2017,ISERE,Laffrey,348,70,278,14,264,1,LREM,49,7.825,31.7
2017,ISERE,Laffrey,348,70,278,14,264,1,NPA,0,7.825,31.7
2017,ISERE,Laffrey,348,70,278,14,264,1,PCF,5,7.825,31.7
2017,ISERE,Laffrey,348,70,278,14,264,1,REC,30,7.825,31.7
2017,ISERE,Laffrey,348,70,278,14,264,1,RES,7,7.825,31.7
2017,ISERE,La Flachère,349,57,292,8,284,1,EELV,23,7.825,31.7
2017,ISERE,La Flachère,349,57,292,8,284,1,FN,69,7.825,31.7
2017,ISERE,La Flachère,349,57,292,8,284,1,LFI,49,7.825,31.7
2017,ISERE,La Flachère,349,57,292,8,284,1,LO,2,7.825,31.7
2017,ISERE,La Flachère,349,57,292,8,284,1,LR,10,7.825,31.7
2017,ISERE,La Flachère,349,57,292,8,284,1,LREM,71,7.825,31.7
2017,ISERE,La Flachère,349,57,292,8,284,1,NPA,3,7.825,31.7
2017,ISERE,La Flachère,349,57,292,8,284,1,PCF,8,7.825,31.7
2017,ISERE,La Flachère,349,57,292,8,284,1,REC,26,7.825,31.7
2017,ISERE,La Flachère,349,57,292,8,284,1,RES,8,7.825,31.7
2017,ISERE,Charette,350,61,289,9,280,1,EELV,20,7.825,31.7
2017,ISERE,Charette,350,61,289,9,280,1,FN,117,7.825,31.7
2017,ISERE,Charette,350,61,289,9,280,1,LFI,44,7.825,31.7
2017,ISERE,Charette,350,61,289,9,280,1,LO,2,7.825,31.7
2017,ISERE,Charette,350,61,289,9,280,1,LR,7,7.825,31.7
2017,ISERE,Charette,350,61,289,9,280,1,LREM,49,7.825,31.7
2017,ISERE,Charette,350,61,289,9,280,1,NPA,2,7.825,31.7
2017,ISERE,Charette,350,61,289,9,280,1,PCF,6,7.825,31.7
2017,ISERE,Charette,350,61,289,9,280,1,REC,20,7.825,31.7
2017,ISERE,Charette,350,61,289,9,280,1,RES,7,7.825,31.7
2017,ISERE,Chasselay,352,88,264,7,257,1,EELV,9,7.825,31.7
2017,ISERE,Chasselay,352,88,264,7,257,1,FN,66,7.825,31.7
2017,ISERE,Chasselay,352,88,264,7,257,1,LFI,51,7.825,31.7
2017,ISERE,Chasselay,352,88,264,7,257,1,LO,1,7.825,31.7
2017,ISERE,Chasselay,352,88,264,7,257,1,LR,21,7.825,31.7
2017,ISERE,Chasselay,352,88,264,7,257,1,LREM,51,7.825,31.7
2017,ISERE,Chasselay,352,88,264,7,257,1,NPA,3,7.825,31.7
2017,ISERE,Chasselay,352,88,264,7,257,1,PCF,7,7.825,31.7
2017,ISERE,Chasselay,352,88,264,7,257,1,REC,27,7.825,31.7
2017,ISERE,Chasselay,352,88,264,7,257,1,RES,14,7.825,31.7
2017,ISERE,Saint-Pierre-de-Chartreuse,353,48,305,8,297,1,EELV,41,7.825,31.7
2017,ISERE,Saint-Pierre-de-Chartreuse,353,48,305,8,297,1,FN,28,7.825,31.7
2017,ISERE,Saint-Pierre-de-Chartreuse,353,48,305,8,297,1,LFI,103,7.825,31.7
2017,ISERE,Saint-Pierre-de-Chartreuse,353,48,305,8,297,1,LO,2,7.825,31.7
2017,ISERE,Saint-Pierre-de-Chartreuse,353,48,305,8,297,1,LR,7,7.825,31.7
2017,ISERE,Saint-Pierre-de-Chartreuse,353,48,305,8,297,1,LREM,77,7.825,31.7
2017,ISERE,Saint-Pierre-de-Chartreuse,353,48,305,8,297,1,NPA,2,7.825,31.7
2017,ISERE,Saint-Pierre-de-Chartreuse,353,48,305,8,297,1,PCF,4,7.825,31.7
2017,ISERE,Saint-Pierre-de-Chartreuse,353,48,305,8,297,1,REC,11,7.825,31.7
2017,ISERE,Saint-Pierre-de-Chartreuse,353,48,305,8,297,1,RES,8,7.825,31.7
2017,ISERE,Villard-Saint-Christophe,354,77,277,7,270,1,EELV,6,7.825,31.7
2017,ISERE,Villard-Saint-Christophe,354,77,277,7,270,1,FN,69,7.825,31.7
2017,ISERE,Villard-Saint-Christophe,354,77,277,7,270,1,LFI,49,7.825,31.7
2017,ISERE,Villard-Saint-Christophe,354,77,277,7,270,1,LO,2,7.825,31.7
2017,ISERE,Villard-Saint-Christophe,354,77,277,7,270,1,LR,10,7.825,31.7
2017,ISERE,Villard-Saint-Christophe,354,77,277,7,270,1,LREM,71,7.825,31.7
2017,ISERE,Villard-Saint-Christophe,354,77,277,7,270,1,NPA,3,7.825,31.7
2017,ISERE,Villard-Saint-Christophe,354,77,277,7,270,1,PCF,17,7.825,31.7
2017,ISERE,Villard-Saint-Christophe,354,77,277,7,270,1,REC,19,7.825,31.7
2017,ISERE,Villard-Saint-Christophe,354,77,277,7,270,1,RES,14,7.825,31.7
2017,ISERE,Crêts en Belledonne,356,66,290,4,286,1,EELV,26,7.825,31.7
2017,ISERE,Crêts en Belledonne,356,66,290,4,286,1,FN,75,7.825,31.7
2017,ISERE,Crêts en Belledonne,356,66,290,4,286,1,LFI,61,7.825,31.7
2017,ISERE,Crêts en Belledonne,356,66,290,4,286,1,LO,1,7.825,31.7
2017,ISERE,Crêts en Belledonne,356,66,290,4,286,1,LR,10,7.825,31.7
2017,ISERE,Crêts en Belledonne,356,66,290,4,286,1,LREM,68,7.825,31.7
2017,ISERE,Crêts en Belledonne,356,66,290,4,286,1,NPA,2,7.825,31.7
2017,ISERE,Crêts en Belledonne,356,66,290,4,286,1,PCF,7,7.825,31.7
2017,ISERE,Crêts en Belledonne,356,66,290,4,286,1,REC,21,7.825,31.7
2017,ISERE,Crêts en Belledonne,356,66,290,4,286,1,RES,8,7.825,31.7
2017,ISERE,Châtenay,356,73,283,5,278,1,EELV,10,7.825,31.7
2017,ISERE,Châtenay,356,73,283,5,278,1,FN,81,7.825,31.7
2017,ISERE,Châtenay,356,73,283,5,278,1,LFI,51,7.825,31.7
2017,ISERE,Châtenay,356,73,283,5,278,1,LO,5,7.825,31.7
2017,ISERE,Châtenay,356,73,283,5,278,1,LR,17,7.825,31.7
2017,ISERE,Châtenay,356,73,283,5,278,1,LREM,73,7.825,31.7
2017,ISERE,Châtenay,356,73,283,5,278,1,NPA,3,7.825,31.7
2017,ISERE,Châtenay,356,73,283,5,278,1,PCF,4,7.825,31.7
2017,ISERE,Châtenay,356,73,283,5,278,1,REC,10,7.825,31.7
2017,ISERE,Châtenay,356,73,283,5,278,1,RES,9,7.825,31.7
2017,ISERE,Saint-Sulpice-des-Rivoires,357,59,298,7,291,1,EELV,12,7.825,31.7
2017,ISERE,Saint-Sulpice-des-Rivoires,357,59,298,7,291,1,FN,80,7.825,31.7
2017,ISERE,Saint-Sulpice-des-Rivoires,357,59,298,7,291,1,LFI,48,7.825,31.7
2017,ISERE,Saint-Sulpice-des-Rivoires,357,59,298,7,291,1,LO,0,7.825,31.7
2017,ISERE,Saint-Sulpice-des-Rivoires,357,59,298,7,291,1,LR,22,7.825,31.7
2017,ISERE,Saint-Sulpice-des-Rivoires,357,59,298,7,291,1,LREM,84,7.825,31.7
2017,ISERE,Saint-Sulpice-des-Rivoires,357,59,298,7,291,1,NPA,5,7.825,31.7
2017,ISERE,Saint-Sulpice-des-Rivoires,357,59,298,7,291,1,PCF,5,7.825,31.7
2017,ISERE,Saint-Sulpice-des-Rivoires,357,59,298,7,291,1,REC,14,7.825,31.7
2017,ISERE,Saint-Sulpice-des-Rivoires,357,59,298,7,291,1,RES,7,7.825,31.7
2017,ISERE,Granieu,361,57,304,5,299,1,EELV,15,7.825,31.7
2017,ISERE,Granieu,361,57,304,5,299,1,FN,90,7.825,31.7
2017,ISERE,Granieu,361,57,304,5,299,1,LFI,52,7.825,31.7
2017,ISERE,Granieu,361,57,304,5,299,1,LO,5,7.825,31.7
2017,ISERE,Granieu,361,57,304,5,299,1,LR,8,7.825,31.7
2017,ISERE,Granieu,361,57,304,5,299,1,LREM,84,7.825,31.7
2017,ISERE,Granieu,361,57,304,5,299,1,NPA,2,7.825,31.7
2017,ISERE,Granieu,361,57,304,5,299,1,PCF,2,7.825,31.7
2017,ISERE,Granieu,361,57,304,5,299,1,REC,18,7.825,31.7
2017,ISERE,Granieu,361,57,304,5,299,1,RES,13,7.825,31.7
2017,ISERE,Eydoche,365,53,312,7,305,1,EELV,11,7.825,31.7
2017,ISERE,Eydoche,365,53,312,7,305,1,FN,122,7.825,31.7
2017,ISERE,Eydoche,365,53,312,7,305,1,LFI,27,7.825,31.7
2017,ISERE,Eydoche,365,53,312,7,305,1,LO,1,7.825,31.7
2017,ISERE,Eydoche,365,53,312,7,305,1,LR,20,7.825,31.7
2017,ISERE,Eydoche,365,53,312,7,305,1,LREM,80,7.825,31.7
2017,ISERE,Eydoche,365,53,312,7,305,1,NPA,2,7.825,31.7
2017,ISERE,Eydoche,365,53,312,7,305,1,PCF,3,7.825,31.7
2017,ISERE,Eydoche,365,53,312,7,305,1,REC,10,7.825,31.7
2017,ISERE,Eydoche,365,53,312,7,305,1,RES,14,7.825,31.7
2017,ISERE,Notre-Dame-de-l'Osier,370,54,316,3,313,1,EELV,25,7.825,31.7
2017,ISERE,Notre-Dame-de-l'Osier,370,54,316,3,313,1,FN,91,7.825,31.7
2017,ISERE,Notre-Dame-de-l'Osier,370,54,316,3,313,1,LFI,56,7.825,31.7
2017,ISERE,Notre-Dame-de-l'Osier,370,54,316,3,313,1,LO,3,7.825,31.7
2017,ISERE,Notre-Dame-de-l'Osier,370,54,316,3,313,1,LR,12,7.825,31.7
2017,ISERE,Notre-Dame-de-l'Osier,370,54,316,3,313,1,LREM,66,7.825,31.7
2017,ISERE,Notre-Dame-de-l'Osier,370,54,316,3,313,1,NPA,1,7.825,31.7
2017,ISERE,Notre-Dame-de-l'Osier,370,54,316,3,313,1,PCF,4,7.825,31.7
2017,ISERE,Notre-Dame-de-l'Osier,370,54,316,3,313,1,REC,30,7.825,31.7
2017,ISERE,Notre-Dame-de-l'Osier,370,54,316,3,313,1,RES,8,7.825,31.7
2017,ISERE,Engins,370,55,315,4,311,1,EELV,43,7.825,31.7
2017,ISERE,Engins,370,55,315,4,311,1,FN,42,7.825,31.7
2017,ISERE,Engins,370,55,315,4,311,1,LFI,79,7.825,31.7
2017,ISERE,Engins,370,55,315,4,311,1,LO,5,7.825,31.7
2017,ISERE,Engins,370,55,315,4,311,1,LR,8,7.825,31.7
2017,ISERE,Engins,370,55,315,4,311,1,LREM,73,7.825,31.7
2017,ISERE,Engins,370,55,315,4,311,1,NPA,2,7.825,31.7
2017,ISERE,Engins,370,55,315,4,311,1,PCF,9,7.825,31.7
2017,ISERE,Engins,370,55,315,4,311,1,REC,21,7.825,31.7
2017,ISERE,Engins,370,55,315,4,311,1,RES,11,7.825,31.7
2017,ISERE,Les Deux-Alpes,372,111,261,8,253,1,EELV,14,7.825,31.7
2017,ISERE,Les Deux-Alpes,372,111,261,8,253,1,FN,64,7.825,31.7
2017,ISERE,Les Deux-Alpes,372,111,261,8,253,1,LFI,42,7.825,31.7
2017,ISERE,Les Deux-Alpes,372,111,261,8,253,1,LO,0,7.825,31.7
2017,ISERE,Les Deux-Alpes,372,111,261,8,253,1,LR,12,7.825,31.7
2017,ISERE,Les Deux-Alpes,372,111,261,8,253,1,LREM,70,7.825,31.7
2017,ISERE,Les Deux-Alpes,372,111,261,8,253,1,NPA,2,7.825,31.7
2017,ISERE,Les Deux-Alpes,372,111,261,8,253,1,PCF,7,7.825,31.7
2017,ISERE,Les Deux-Alpes,372,111,261,8,253,1,REC,30,7.825,31.7
2017,ISERE,Les Deux-Alpes,372,111,261,8,253,1,RES,11,7.825,31.7
2017,ISERE,Satolas-et-Bonce,373,70,303,3,300,1,EELV,8,7.825,31.7
2017,ISERE,Satolas-et-Bonce,373,70,303,3,300,1,FN,114,7.825,31.7
2017,ISERE,Satolas-et-Bonce,373,70,303,3,300,1,LFI,53,7.825,31.7
2017,ISERE,Satolas-et-Bonce,373,70,303,3,300,1,LO,1,7.825,31.7
2017,ISERE,Satolas-et-Bonce,373,70,303,3,300,1,LR,7,7.825,31.7
2017,ISERE,Satolas-et-Bonce,373,70,303,3,300,1,LREM,61,7.825,31.7
2017,ISERE,Satolas-et-Bonce,373,70,303,3,300,1,NPA,0,7.825,31.7
2017,ISERE,Satolas-et-Bonce,373,70,303,3,300,1,PCF,9,7.825,31.7
2017,ISERE,Satolas-et-Bonce,373,70,303,3,300,1,REC,27,7.825,31.7
2017,ISERE,Satolas-et-Bonce,373,70,303,3,300,1,RES,10,7.825,31.7
2017,ISERE,Le Champ-près-Froges,375,68,307,7,300,1,EELV,25,7.825,31.7
2017,ISERE,Le Champ-près-Froges,375,68,307,7,300,1,FN,50,7.825,31.7
2017,ISERE,Le Champ-près-Froges,375,68,307,7,300,1,LFI,60,7.825,31.7
2017,ISERE,Le Champ-près-Froges,375,68,307,7,300,1,LO,0,7.825,31.7
2017,ISERE,Le Champ-près-Froges,375,68,307,7,300,1,LR,12,7.825,31.7
2017,ISERE,Le Champ-près-Froges,375,68,307,7,300,1,LREM,101,7.825,31.7
2017,ISERE,Le Champ-près-Froges,375,68,307,7,300,1,NPA,7,7.825,31.7
2017,ISERE,Le Champ-près-Froges,375,68,307,7,300,1,PCF,12,7.825,31.7
2017,ISERE,Le Champ-près-Froges,375,68,307,7,300,1,REC,15,7.825,31.7
2017,ISERE,Le Champ-près-Froges,375,68,307,7,300,1,RES,10,7.825,31.7
2017,ISERE,Saint-Laurent-en-Beaumont,376,60,316,2,314,1,EELV,5,7.825,31.7
2017,ISERE,Saint-Laurent-en-Beaumont,376,60,316,2,314,1,FN,92,7.825,31.7
2017,ISERE,Saint-Laurent-en-Beaumont,376,60,316,2,314,1,LFI,68,7.825,31.7
2017,ISERE,Saint-Laurent-en-Beaumont,376,60,316,2,314,1,LO,4,7.825,31.7
2017,ISERE,Saint-Laurent-en-Beaumont,376,60,316,2,314,1,LR,9,7.825,31.7
2017,ISERE,Saint-Laurent-en-Beaumont,376,60,316,2,314,1,LREM,73,7.825,31.7
2017,ISERE,Saint-Laurent-en-Beaumont,376,60,316,2,314,1,NPA,1,7.825,31.7
2017,ISERE,Saint-Laurent-en-Beaumont,376,60,316,2,314,1,PCF,7,7.825,31.7
2017,ISERE,Saint-Laurent-en-Beaumont,376,60,316,2,314,1,REC,23,7.825,31.7
2017,ISERE,Saint-Laurent-en-Beaumont,376,60,316,2,314,1,RES,10,7.825,31.7
2017,ISERE,Livet-et-Gavet,376,96,280,4,276,1,EELV,2,7.825,31.7
2017,ISERE,Livet-et-Gavet,376,96,280,4,276,1,FN,91,7.825,31.7
2017,ISERE,Livet-et-Gavet,376,96,280,4,276,1,LFI,122,7.825,31.7
2017,ISERE,Livet-et-Gavet,376,96,280,4,276,1,LO,2,7.825,31.7
2017,ISERE,Livet-et-Gavet,376,96,280,4,276,1,LR,7,7.825,31.7
2017,ISERE,Livet-et-Gavet,376,96,280,4,276,1,LREM,25,7.825,31.7
2017,ISERE,Livet-et-Gavet,376,96,280,4,276,1,NPA,1,7.825,31.7
2017,ISERE,Livet-et-Gavet,376,96,280,4,276,1,PCF,7,7.825,31.7
2017,ISERE,Livet-et-Gavet,376,96,280,4,276,1,REC,7,7.825,31.7
2017,ISERE,Livet-et-Gavet,376,96,280,4,276,1,RES,5,7.825,31.7
2017,ISERE,La Sure en Chartreuse,378,67,311,2,309,1,EELV,27,7.825,31.7
2017,ISERE,La Sure en Chartreuse,378,67,311,2,309,1,FN,39,7.825,31.7
2017,ISERE,La Sure en Chartreuse,378,67,311,2,309,1,LFI,73,7.825,31.7
2017,ISERE,La Sure en Chartreuse,378,67,311,2,309,1,LO,5,7.825,31.7
2017,ISERE,La Sure en Chartreuse,378,67,311,2,309,1,LR,13,7.825,31.7
2017,ISERE,La Sure en Chartreuse,378,67,311,2,309,1,LREM,111,7.825,31.7
2017,ISERE,La Sure en Chartreuse,378,67,311,2,309,1,NPA,0,7.825,31.7
2017,ISERE,La Sure en Chartreuse,378,67,311,2,309,1,PCF,5,7.825,31.7
2017,ISERE,La Sure en Chartreuse,378,67,311,2,309,1,REC,15,7.825,31.7
2017,ISERE,La Sure en Chartreuse,378,67,311,2,309,1,RES,3,7.825,31.7
2017,ISERE,Sainte-Marie-d'Alloix,380,48,332,2,330,1,EELV,28,7.825,31.7
2017,ISERE,Sainte-Marie-d'Alloix,380,48,332,2,330,1,FN,81,7.825,31.7
2017,ISERE,Sainte-Marie-d'Alloix,380,48,332,2,330,1,LFI,56,7.825,31.7
2017,ISERE,Sainte-Marie-d'Alloix,380,48,332,2,330,1,LO,2,7.825,31.7
2017,ISERE,Sainte-Marie-d'Alloix,380,48,332,2,330,1,LR,16,7.825,31.7
2017,ISERE,Sainte-Marie-d'Alloix,380,48,332,2,330,1,LREM,87,7.825,31.7
2017,ISERE,Sainte-Marie-d'Alloix,380,48,332,2,330,1,NPA,1,7.825,31.7
2017,ISERE,Sainte-Marie-d'Alloix,380,48,332,2,330,1,PCF,6,7.825,31.7
2017,ISERE,Sainte-Marie-d'Alloix,380,48,332,2,330,1,REC,35,7.825,31.7
2017,ISERE,Sainte-Marie-d'Alloix,380,48,332,2,330,1,RES,11,7.825,31.7
2017,ISERE,Corrençon-en-Vercors,382,70,312,6,306,1,EELV,26,7.825,31.7
2017,ISERE,Corrençon-en-Vercors,382,70,312,6,306,1,FN,44,7.825,31.7
2017,ISERE,Corrençon-en-Vercors,382,70,312,6,306,1,LFI,42,7.825,31.7
2017,ISERE,Corrençon-en-Vercors,382,70,312,6,306,1,LO,1,7.825,31.7
2017,ISERE,Corrençon-en-Vercors,382,70,312,6,306,1,LR,27,7.825,31.7
2017,ISERE,Corrençon-en-Vercors,382,70,312,6,306,1,LREM,122,7.825,31.7
2017,ISERE,Corrençon-en-Vercors,382,70,312,6,306,1,NPA,2,7.825,31.7
2017,ISERE,Corrençon-en-Vercors,382,70,312,6,306,1,PCF,6,7.825,31.7
2017,ISERE,Corrençon-en-Vercors,382,70,312,6,306,1,REC,22,7.825,31.7
2017,ISERE,Corrençon-en-Vercors,382,70,312,6,306,1,RES,4,7.825,31.7
2017,ISERE,Saint-Geoirs,386,75,311,11,300,1,EELV,8,7.825,31.7
2017,ISERE,Saint-Geoirs,386,75,311,11,300,1,FN,70,7.825,31.7
2017,ISERE,Saint-Geoirs,386,75,311,11,300,1,LFI,49,7.825,31.7
2017,ISERE,Saint-Geoirs,386,75,311,11,300,1,LO,2,7.825,31.7
2017,ISERE,Saint-Geoirs,386,75,311,11,300,1,LR,18,7.825,31.7
2017,ISERE,Saint-Geoirs,386,75,311,11,300,1,LREM,83,7.825,31.7
2017,ISERE,Saint-Geoirs,386,75,311,11,300,1,NPA,2,7.825,31.7
2017,ISERE,Saint-Geoirs,386,75,311,11,300,1,PCF,4,7.825,31.7
2017,ISERE,Saint-Geoirs,386,75,311,11,300,1,REC,28,7.825,31.7
2017,ISERE,Saint-Geoirs,386,75,311,11,300,1,RES,27,7.825,31.7
2017,ISERE,Porte-des-Bonnevaux,387,88,299,9,290,1,EELV,18,7.825,31.7
2017,ISERE,Porte-des-Bonnevaux,387,88,299,9,290,1,FN,86,7.825,31.7
2017,ISERE,Porte-des-Bonnevaux,387,88,299,9,290,1,LFI,42,7.825,31.7
2017,ISERE,Porte-des-Bonnevaux,387,88,299,9,290,1,LO,3,7.825,31.7
2017,ISERE,Porte-des-Bonnevaux,387,88,299,9,290,1,LR,13,7.825,31.7
2017,ISERE,Porte-des-Bonnevaux,387,88,299,9,290,1,LREM,72,7.825,31.7
2017,ISERE,Porte-des-Bonnevaux,387,88,299,9,290,1,NPA,1,7.825,31.7
2017,ISERE,Porte-des-Bonnevaux,387,88,299,9,290,1,PCF,5,7.825,31.7
2017,ISERE,Porte-des-Bonnevaux,387,88,299,9,290,1,REC,18,7.825,31.7
2017,ISERE,Porte-des-Bonnevaux,387,88,299,9,290,1,RES,18,7.825,31.7
2017,ISERE,Gresse-en-Vercors,388,64,324,7,317,1,EELV,26,7.825,31.7
2017,ISERE,Gresse-en-Vercors,388,64,324,7,317,1,FN,56,7.825,31.7
2017,ISERE,Gresse-en-Vercors,388,64,324,7,317,1,LFI,87,7.825,31.7
2017,ISERE,Gresse-en-Vercors,388,64,324,7,317,1,LO,2,7.825,31.7
2017,ISERE,Gresse-en-Vercors,388,64,324,7,317,1,LR,27,7.825,31.7
2017,ISERE,Gresse-en-Vercors,388,64,324,7,317,1,LREM,77,7.825,31.7
2017,ISERE,Gresse-en-Vercors,388,64,324,7,317,1,NPA,1,7.825,31.7
2017,ISERE,Gresse-en-Vercors,388,64,324,7,317,1,PCF,7,7.825,31.7
2017,ISERE,Gresse-en-Vercors,388,64,324,7,317,1,REC,17,7.825,31.7
2017,ISERE,Gresse-en-Vercors,388,64,324,7,317,1,RES,7,7.825,31.7
2017,ISERE,Saint-Gervais,392,106,286,6,280,1,EELV,12,7.825,31.7
2017,ISERE,Saint-Gervais,392,106,286,6,280,1,FN,94,7.825,31.7
2017,ISERE,Saint-Gervais,392,106,286,6,280,1,LFI,55,7.825,31.7
2017,ISERE,Saint-Gervais,392,106,286,6,280,1,LO,3,7.825,31.7
2017,ISERE,Saint-Gervais,392,106,286,6,280,1,LR,12,7.825,31.7
2017,ISERE,Saint-Gervais,392,106,286,6,280,1,LREM,51,7.825,31.7
2017,ISERE,Saint-Gervais,392,106,286,6,280,1,NPA,5,7.825,31.7
2017,ISERE,Saint-Gervais,392,106,286,6,280,1,PCF,6,7.825,31.7
2017,ISERE,Saint-Gervais,392,106,286,6,280,1,REC,24,7.825,31.7
2017,ISERE,Saint-Gervais,392,106,286,6,280,1,RES,7,7.825,31.7
2017,ISERE,Monteynard,393,55,338,10,328,1,EELV,18,7.825,31.7
2017,ISERE,Monteynard,393,55,338,10,328,1,FN,110,7.825,31.7
2017,ISERE,Monteynard,393,55,338,10,328,1,LFI,62,7.825,31.7
2017,ISERE,Monteynard,393,55,338,10,328,1,LO,1,7.825,31.7
2017,ISERE,Monteynard,393,55,338,10,328,1,LR,6,7.825,31.7
2017,ISERE,Monteynard,393,55,338,10,328,1,LREM,72,7.825,31.7
2017,ISERE,Monteynard,393,55,338,10,328,1,NPA,4,7.825,31.7
2017,ISERE,Monteynard,393,55,338,10,328,1,PCF,4,7.825,31.7
2017,ISERE,Monteynard,393,55,338,10,328,1,REC,18,7.825,31.7
2017,ISERE,Monteynard,393,55,338,10,328,1,RES,14,7.825,31.7
2017,ISERE,Notre-Dame-de-Commiers,402,58,344,5,339,1,EELV,21,7.825,31.7
2017,ISERE,Notre-Dame-de-Commiers,402,58,344,5,339,1,FN,102,7.825,31.7
2017,ISERE,Notre-Dame-de-Commiers,402,58,344,5,339,1,LFI,63,7.825,31.7
2017,ISERE,Notre-Dame-de-Commiers,402,58,344,5,339,1,LO,0,7.825,31.7
2017,ISERE,Notre-Dame-de-Commiers,402,58,344,5,339,1,LR,8,7.825,31.7
2017,ISERE,Notre-Dame-de-Commiers,402,58,344,5,339,1,LREM,88,7.825,31.7
2017,ISERE,Notre-Dame-de-Commiers,402,58,344,5,339,1,NPA,3,7.825,31.7
2017,ISERE,Notre-Dame-de-Commiers,402,58,344,5,339,1,PCF,10,7.825,31.7
2017,ISERE,Notre-Dame-de-Commiers,402,58,344,5,339,1,REC,23,7.825,31.7
2017,ISERE,Notre-Dame-de-Commiers,402,58,344,5,339,1,RES,6,7.825,31.7
2017,ISERE,Corps,402,83,319,11,308,1,EELV,13,7.825,31.7
2017,ISERE,Corps,402,83,319,11,308,1,FN,82,7.825,31.7
2017,ISERE,Corps,402,83,319,11,308,1,LFI,39,7.825,31.7
2017,ISERE,Corps,402,83,319,11,308,1,LO,1,7.825,31.7
2017,ISERE,Corps,402,83,319,11,308,1,LR,24,7.825,31.7
2017,ISERE,Corps,402,83,319,11,308,1,LREM,98,7.825,31.7
2017,ISERE,Corps,402,83,319,11,308,1,NPA,0,7.825,31.7
2017,ISERE,Corps,402,83,319,11,308,1,PCF,5,7.825,31.7
2017,ISERE,Corps,402,83,319,11,308,1,REC,23,7.825,31.7
2017,ISERE,Corps,402,83,319,11,308,1,RES,14,7.825,31.7
2017,ISERE,Vaujany,405,82,323,5,318,1,EELV,12,7.825,31.7
2017,ISERE,Vaujany,405,82,323,5,318,1,FN,75,7.825,31.7
2017,ISERE,Vaujany,405,82,323,5,318,1,LFI,47,7.825,31.7
2017,ISERE,Vaujany,405,82,323,5,318,1,LO,1,7.825,31.7
2017,ISERE,Vaujany,405,82,323,5,318,1,LR,9,7.825,31.7
2017,ISERE,Vaujany,405,82,323,5,318,1,LREM,120,7.825,31.7
2017,ISERE,Vaujany,405,82,323,5,318,1,NPA,1,7.825,31.7
2017,ISERE,Vaujany,405,82,323,5,318,1,PCF,6,7.825,31.7
2017,ISERE,Vaujany,405,82,323,5,318,1,REC,30,7.825,31.7
2017,ISERE,Vaujany,405,82,323,5,318,1,RES,8,7.825,31.7
2017,ISERE,Proveysieux,406,60,346,9,337,1,EELV,39,7.825,31.7
2017,ISERE,Proveysieux,406,60,346,9,337,1,FN,41,7.825,31.7
2017,ISERE,Proveysieux,406,60,346,9,337,1,LFI,96,7.825,31.7
2017,ISERE,Proveysieux,406,60,346,9,337,1,LO,1,7.825,31.7
2017,ISERE,Proveysieux,406,60,346,9,337,1,LR,6,7.825,31.7
2017,ISERE,Proveysieux,406,60,346,9,337,1,LREM,91,7.825,31.7
2017,ISERE,Proveysieux,406,60,346,9,337,1,NPA,2,7.825,31.7
2017,ISERE,Proveysieux,406,60,346,9,337,1,PCF,16,7.825,31.7
2017,ISERE,Proveysieux,406,60,346,9,337,1,REC,15,7.825,31.7
2017,ISERE,Proveysieux,406,60,346,9,337,1,RES,11,7.825,31.7
2017,ISERE,Belmont,406,68,338,8,330,1,EELV,13,7.825,31.7
2017,ISERE,Belmont,406,68,338,8,330,1,FN,124,7.825,31.7
2017,ISERE,Belmont,406,68,338,8,330,1,LFI,44,7.825,31.7
2017,ISERE,Belmont,406,68,338,8,330,1,LO,0,7.825,31.7
2017,ISERE,Belmont,406,68,338,8,330,1,LR,6,7.825,31.7
2017,ISERE,Belmont,406,68,338,8,330,1,LREM,76,7.825,31.7
2017,ISERE,Belmont,406,68,338,8,330,1,NPA,9,7.825,31.7
2017,ISERE,Belmont,406,68,338,8,330,1,PCF,3,7.825,31.7
2017,ISERE,Belmont,406,68,338,8,330,1,REC,33,7.825,31.7
2017,ISERE,Belmont,406,68,338,8,330,1,RES,12,7.825,31.7
2017,ISERE,La Chapelle-du-Bard,408,78,330,6,324,1,EELV,20,7.825,31.7
2017,ISERE,La Chapelle-du-Bard,408,78,330,6,324,1,FN,61,7.825,31.7
2017,ISERE,La Chapelle-du-Bard,408,78,330,6,324,1,LFI,91,7.825,31.7
2017,ISERE,La Chapelle-du-Bard,408,78,330,6,324,1,LO,4,7.825,31.7
2017,ISERE,La Chapelle-du-Bard,408,78,330,6,324,1,LR,8,7.825,31.7
2017,ISERE,La Chapelle-du-Bard,408,78,330,6,324,1,LREM,72,7.825,31.7
2017,ISERE,La Chapelle-du-Bard,408,78,330,6,324,1,NPA,6,7.825,31.7
2017,ISERE,La Chapelle-du-Bard,408,78,330,6,324,1,PCF,9,7.825,31.7
2017,ISERE,La Chapelle-du-Bard,408,78,330,6,324,1,REC,18,7.825,31.7
2017,ISERE,La Chapelle-du-Bard,408,78,330,6,324,1,RES,13,7.825,31.7
2017,ISERE,Merlas,411,84,327,9,318,1,EELV,14,7.825,31.7
2017,ISERE,Merlas,411,84,327,9,318,1,FN,94,7.825,31.7
2017,ISERE,Merlas,411,84,327,9,318,1,LFI,56,7.825,31.7
2017,ISERE,Merlas,411,84,327,9,318,1,LO,0,7.825,31.7
2017,ISERE,Merlas,411,84,327,9,318,1,LR,12,7.825,31.7
2017,ISERE,Merlas,411,84,327,9,318,1,LREM,77,7.825,31.7
2017,ISERE,Merlas,411,84,327,9,318,1,NPA,4,7.825,31.7
2017,ISERE,Merlas,411,84,327,9,318,1,PCF,9,7.825,31.7
2017,ISERE,Merlas,411,84,327,9,318,1,REC,32,7.825,31.7
2017,ISERE,Merlas,411,84,327,9,318,1,RES,11,7.825,31.7
2017,ISERE,Nantes-en-Ratier,415,45,370,11,359,1,EELV,20,7.825,31.7
2017,ISERE,Nantes-en-Ratier,415,45,370,11,359,1,FN,61,7.825,31.7
2017,ISERE,Nantes-en-Ratier,415,45,370,11,359,1,LFI,97,7.825,31.7
2017,ISERE,Nantes-en-Ratier,415,45,370,11,359,1,LO,1,7.825,31.7
2017,ISERE,Nantes-en-Ratier,415,45,370,11,359,1,LR,15,7.825,31.7
2017,ISERE,Nantes-en-Ratier,415,45,370,11,359,1,LREM,97,7.825,31.7
2017,ISERE,Nantes-en-Ratier,415,45,370,11,359,1,NPA,2,7.825,31.7
2017,ISERE,Nantes-en-Ratier,415,45,370,11,359,1,PCF,11,7.825,31.7
2017,ISERE,Nantes-en-Ratier,415,45,370,11,359,1,REC,26,7.825,31.7
2017,ISERE,Nantes-en-Ratier,415,45,370,11,359,1,RES,21,7.825,31.7
2017,ISERE,Beaufort,423,80,343,8,335,1,EELV,10,7.825,31.7
2017,ISERE,Beaufort,423,80,343,8,335,1,FN,121,7.825,31.7
2017,ISERE,Beaufort,423,80,343,8,335,1,LFI,44,7.825,31.7
2017,ISERE,Beaufort,423,80,343,8,335,1,LO,2,7.825,31.7
2017,ISERE,Beaufort,423,80,343,8,335,1,LR,28,7.825,31.7
2017,ISERE,Beaufort,423,80,343,8,335,1,LREM,88,7.825,31.7
2017,ISERE,Beaufort,423,80,343,8,335,1,NPA,1,7.825,31.7
2017,ISERE,Beaufort,423,80,343,8,335,1,PCF,6,7.825,31.7
2017,ISERE,Beaufort,423,80,343,8,335,1,REC,17,7.825,31.7
2017,ISERE,Beaufort,423,80,343,8,335,1,RES,10,7.825,31.7
2017,ISERE,Velanne,428,90,338,11,327,1,EELV,26,7.825,31.7
2017,ISERE,Velanne,428,90,338,11,327,1,FN,96,7.825,31.7
2017,ISERE,Velanne,428,90,338,11,327,1,LFI,65,7.825,31.7
2017,ISERE,Velanne,428,90,338,11,327,1,LO,1,7.825,31.7
2017,ISERE,Velanne,428,90,338,11,327,1,LR,12,7.825,31.7
2017,ISERE,Velanne,428,90,338,11,327,1,LREM,76,7.825,31.7
2017,ISERE,Velanne,428,90,338,11,327,1,NPA,2,7.825,31.7
2017,ISERE,Velanne,428,90,338,11,327,1,PCF,6,7.825,31.7
2017,ISERE,Velanne,428,90,338,11,327,1,REC,17,7.825,31.7
2017,ISERE,Velanne,428,90,338,11,327,1,RES,9,7.825,31.7
2017,ISERE,La Sône,435,90,345,7,338,1,EELV,9,7.825,31.7
2017,ISERE,La Sône,435,90,345,7,338,1,FN,93,7.825,31.7
2017,ISERE,La Sône,435,90,345,7,338,1,LFI,69,7.825,31.7
2017,ISERE,La Sône,435,90,345,7,338,1,LO,1,7.825,31.7
2017,ISERE,La Sône,435,90,345,7,338,1,LR,9,7.825,31.7
2017,ISERE,La Sône,435,90,345,7,338,1,LREM,86,7.825,31.7
2017,ISERE,La Sône,435,90,345,7,338,1,NPA,5,7.825,31.7
2017,ISERE,La Sône,435,90,345,7,338,1,PCF,12,7.825,31.7
2017,ISERE,La Sône,435,90,345,7,338,1,REC,27,7.825,31.7
2017,ISERE,La Sône,435,90,345,7,338,1,RES,13,7.825,31.7
2017,ISERE,Montcarra,436,64,372,10,362,1,EELV,26,7.825,31.7
2017,ISERE,Montcarra,436,64,372,10,362,1,FN,105,7.825,31.7
2017,ISERE,Montcarra,436,64,372,10,362,1,LFI,47,7.825,31.7
2017,ISERE,Montcarra,436,64,372,10,362,1,LO,0,7.825,31.7
2017,ISERE,Montcarra,436,64,372,10,362,1,LR,17,7.825,31.7
2017,ISERE,Montcarra,436,64,372,10,362,1,LREM,87,7.825,31.7
2017,ISERE,Montcarra,436,64,372,10,362,1,NPA,3,7.825,31.7
2017,ISERE,Montcarra,436,64,372,10,362,1,PCF,14,7.825,31.7
2017,ISERE,Montcarra,436,64,372,10,362,1,REC,35,7.825,31.7
2017,ISERE,Montcarra,436,64,372,10,362,1,RES,10,7.825,31.7
2017,ISERE,Saint-Pierre-de-Chérennes,438,80,358,10,348,1,EELV,28,7.825,31.7
2017,ISERE,Saint-Pierre-de-Chérennes,438,80,358,10,348,1,FN,82,7.825,31.7
2017,ISERE,Saint-Pierre-de-Chérennes,438,80,358,10,348,1,LFI,77,7.825,31.7
2017,ISERE,Saint-Pierre-de-Chérennes,438,80,358,10,348,1,LO,2,7.825,31.7
2017,ISERE,Saint-Pierre-de-Chérennes,438,80,358,10,348,1,LR,12,7.825,31.7
2017,ISERE,Saint-Pierre-de-Chérennes,438,80,358,10,348,1,LREM,80,7.825,31.7
2017,ISERE,Saint-Pierre-de-Chérennes,438,80,358,10,348,1,NPA,0,7.825,31.7
2017,ISERE,Saint-Pierre-de-Chérennes,438,80,358,10,348,1,PCF,4,7.825,31.7
2017,ISERE,Saint-Pierre-de-Chérennes,438,80,358,10,348,1,REC,26,7.825,31.7
2017,ISERE,Saint-Pierre-de-Chérennes,438,80,358,10,348,1,RES,22,7.825,31.7
2017,ISERE,Longechenal,438,85,353,7,346,1,EELV,19,7.825,31.7
2017,ISERE,Longechenal,438,85,353,7,346,1,FN,96,7.825,31.7
2017,ISERE,Longechenal,438,85,353,7,346,1,LFI,67,7.825,31.7
2017,ISERE,Longechenal,438,85,353,7,346,1,LO,3,7.825,31.7
2017,ISERE,Longechenal,438,85,353,7,346,1,LR,19,7.825,31.7
2017,ISERE,Longechenal,438,85,353,7,346,1,LREM,87,7.825,31.7
2017,ISERE,Longechenal,438,85,353,7,346,1,NPA,2,7.825,31.7
2017,ISERE,Longechenal,438,85,353,7,346,1,PCF,10,7.825,31.7
2017,ISERE,Longechenal,438,85,353,7,346,1,REC,16,7.825,31.7
2017,ISERE,Longechenal,438,85,353,7,346,1,RES,14,7.825,31.7
2017,ISERE,Crachier,439,58,381,16,365,1,EELV,18,7.825,31.7
2017,ISERE,Crachier,439,58,381,16,365,1,FN,123,7.825,31.7
2017,ISERE,Crachier,439,58,381,16,365,1,LFI,59,7.825,31.7
2017,ISERE,Crachier,439,58,381,16,365,1,LO,4,7.825,31.7
2017,ISERE,Crachier,439,58,381,16,365,1,LR,12,7.825,31.7
2017,ISERE,Crachier,439,58,381,16,365,1,LREM,80,7.825,31.7
2017,ISERE,Crachier,439,58,381,16,365,1,NPA,1,7.825,31.7
2017,ISERE,Crachier,439,58,381,16,365,1,PCF,4,7.825,31.7
2017,ISERE,Crachier,439,58,381,16,365,1,REC,31,7.825,31.7
2017,ISERE,Crachier,439,58,381,16,365,1,RES,15,7.825,31.7
2017,ISERE,Barraux,441,71,370,12,358,1,EELV,21,7.825,31.7
2017,ISERE,Barraux,441,71,370,12,358,1,FN,87,7.825,31.7
2017,ISERE,Barraux,441,71,370,12,358,1,LFI,56,7.825,31.7
2017,ISERE,Barraux,441,71,370,12,358,1,LO,1,7.825,31.7
2017,ISERE,Barraux,441,71,370,12,358,1,LR,14,7.825,31.7
2017,ISERE,Barraux,441,71,370,12,358,1,LREM,116,7.825,31.7
2017,ISERE,Barraux,441,71,370,12,358,1,NPA,3,7.825,31.7
2017,ISERE,Barraux,441,71,370,12,358,1,PCF,8,7.825,31.7
2017,ISERE,Barraux,441,71,370,12,358,1,REC,25,7.825,31.7
2017,ISERE,Barraux,441,71,370,12,358,1,RES,11,7.825,31.7
2017,ISERE,Flachères,441,78,363,9,354,1,EELV,9,7.825,31.7
2017,ISERE,Flachères,441,78,363,9,354,1,FN,127,7.825,31.7
2017,ISERE,Flachères,441,78,363,9,354,1,LFI,50,7.825,31.7
2017,ISERE,Flachères,441,78,363,9,354,1,LO,5,7.825,31.7
2017,ISERE,Flachères,441,78,363,9,354,1,LR,20,7.825,31.7
2017,ISERE,Flachères,441,78,363,9,354,1,LREM,91,7.825,31.7
2017,ISERE,Flachères,441,78,363,9,354,1,NPA,3,7.825,31.7
2017,ISERE,Flachères,441,78,363,9,354,1,PCF,5,7.825,31.7
2017,ISERE,Flachères,441,78,363,9,354,1,REC,25,7.825,31.7
2017,ISERE,Flachères,441,78,363,9,354,1,RES,6,7.825,31.7
2017,ISERE,Saint-Théoffrey,443,69,374,4,370,1,EELV,21,7.825,31.7
2017,ISERE,Saint-Théoffrey,443,69,374,4,370,1,FN,77,7.825,31.7
2017,ISERE,Saint-Théoffrey,443,69,374,4,370,1,LFI,82,7.825,31.7
2017,ISERE,Saint-Théoffrey,443,69,374,4,370,1,LO,6,7.825,31.7
2017,ISERE,Saint-Théoffrey,443,69,374,4,370,1,LR,14,7.825,31.7
2017,ISERE,Saint-Théoffrey,443,69,374,4,370,1,LREM,97,7.825,31.7
2017,ISERE,Saint-Théoffrey,443,69,374,4,370,1,NPA,5,7.825,31.7
2017,ISERE,Saint-Théoffrey,443,69,374,4,370,1,PCF,13,7.825,31.7
2017,ISERE,Saint-Théoffrey,443,69,374,4,370,1,REC,21,7.825,31.7
2017,ISERE,Saint-Théoffrey,443,69,374,4,370,1,RES,17,7.825,31.7
2017,ISERE,Montaud,444,65,379,14,365,1,EELV,45,7.825,31.7
2017,ISERE,Montaud,444,65,379,14,365,1,FN,52,7.825,31.7
2017,ISERE,Montaud,444,65,379,14,365,1,LFI,79,7.825,31.7
2017,ISERE,Montaud,444,65,379,14,365,1,LO,1,7.825,31.7
2017,ISERE,Montaud,444,65,379,14,365,1,LR,12,7.825,31.7
2017,ISERE,Montaud,444,65,379,14,365,1,LREM,124,7.825,31.7
2017,ISERE,Montaud,444,65,379,14,365,1,NPA,8,7.825,31.7
2017,ISERE,Montaud,444,65,379,14,365,1,PCF,6,7.825,31.7
2017,ISERE,Montaud,444,65,379,14,365,1,REC,8,7.825,31.7
2017,ISERE,Montaud,444,65,379,14,365,1,RES,12,7.825,31.7
2017,ISERE,Creys-Mépieu,448,83,365,7,358,1,EELV,8,7.825,31.7
2017,ISERE,Creys-Mépieu,448,83,365,7,358,1,FN,137,7.825,31.7
2017,ISERE,Creys-Mépieu,448,83,365,7,358,1,LFI,64,7.825,31.7
2017,ISERE,Creys-Mépieu,448,83,365,7,358,1,LO,4,7.825,31.7
2017,ISERE,Creys-Mépieu,448,83,365,7,358,1,LR,6,7.825,31.7
2017,ISERE,Creys-Mépieu,448,83,365,7,358,1,LREM,66,7.825,31.7
2017,ISERE,Creys-Mépieu,448,83,365,7,358,1,NPA,1,7.825,31.7
2017,ISERE,Creys-Mépieu,448,83,365,7,358,1,PCF,11,7.825,31.7
2017,ISERE,Creys-Mépieu,448,83,365,7,358,1,REC,38,7.825,31.7
2017,ISERE,Creys-Mépieu,448,83,365,7,358,1,RES,12,7.825,31.7
2017,ISERE,Pisieu,452,84,368,8,360,1,EELV,14,7.825,31.7
2017,ISERE,Pisieu,452,84,368,8,360,1,FN,113,7.825,31.7
2017,ISERE,Pisieu,452,84,368,8,360,1,LFI,68,7.825,31.7
2017,ISERE,Pisieu,452,84,368,8,360,1,LO,4,7.825,31.7
2017,ISERE,Pisieu,452,84,368,8,360,1,LR,14,7.825,31.7
2017,ISERE,Pisieu,452,84,368,8,360,1,LREM,85,7.825,31.7
2017,ISERE,Pisieu,452,84,368,8,360,1,NPA,3,7.825,31.7
2017,ISERE,Pisieu,452,84,368,8,360,1,PCF,4,7.825,31.7
2017,ISERE,Pisieu,452,84,368,8,360,1,REC,24,7.825,31.7
2017,ISERE,Pisieu,452,84,368,8,360,1,RES,15,7.825,31.7
2017,ISERE,Chèzeneuve,455,58,397,10,387,1,EELV,26,7.825,31.7
2017,ISERE,Chèzeneuve,455,58,397,10,387,1,FN,127,7.825,31.7
2017,ISERE,Chèzeneuve,455,58,397,10,387,1,LFI,40,7.825,31.7
2017,ISERE,Chèzeneuve,455,58,397,10,387,1,LO,0,7.825,31.7
2017,ISERE,Chèzeneuve,455,58,397,10,387,1,LR,21,7.825,31.7
2017,ISERE,Chèzeneuve,455,58,397,10,387,1,LREM,108,7.825,31.7
2017,ISERE,Chèzeneuve,455,58,397,10,387,1,NPA,2,7.825,31.7
2017,ISERE,Chèzeneuve,455,58,397,10,387,1,PCF,7,7.825,31.7
2017,ISERE,Chèzeneuve,455,58,397,10,387,1,REC,25,7.825,31.7
2017,ISERE,Chèzeneuve,455,58,397,10,387,1,RES,14,7.825,31.7
2017,ISERE,Siccieu-Saint-Julien-et-Carisieu,456,74,382,9,373,1,EELV,16,7.825,31.7
2017,ISERE,Siccieu-Saint-Julien-et-Carisieu,456,74,382,9,373,1,FN,94,7.825,31.7
2017,ISERE,Siccieu-Saint-Julien-et-Carisieu,456,74,382,9,373,1,LFI,67,7.825,31.7
2017,ISERE,Siccieu-Saint-Julien-et-Carisieu,456,74,382,9,373,1,LO,1,7.825,31.7
2017,ISERE,Siccieu-Saint-Julien-et-Carisieu,456,74,382,9,373,1,LR,30,7.825,31.7
2017,ISERE,Siccieu-Saint-Julien-et-Carisieu,456,74,382,9,373,1,LREM,102,7.825,31.7
2017,ISERE,Siccieu-Saint-Julien-et-Carisieu,456,74,382,9,373,1,NPA,5,7.825,31.7
2017,ISERE,Siccieu-Saint-Julien-et-Carisieu,456,74,382,9,373,1,PCF,6,7.825,31.7
2017,ISERE,Siccieu-Saint-Julien-et-Carisieu,456,74,382,9,373,1,REC,33,7.825,31.7
2017,ISERE,Siccieu-Saint-Julien-et-Carisieu,456,74,382,9,373,1,RES,7,7.825,31.7
2017,ISERE,Têche,459,96,363,15,348,1,EELV,9,7.825,31.7
2017,ISERE,Têche,459,96,363,15,348,1,FN,114,7.825,31.7
2017,ISERE,Têche,459,96,363,15,348,1,LFI,56,7.825,31.7
2017,ISERE,Têche,459,96,363,15,348,1,LO,4,7.825,31.7
2017,ISERE,Têche,459,96,363,15,348,1,LR,21,7.825,31.7
2017,ISERE,Têche,459,96,363,15,348,1,LREM,73,7.825,31.7
2017,ISERE,Têche,459,96,363,15,348,1,NPA,9,7.825,31.7
2017,ISERE,Têche,459,96,363,15,348,1,PCF,6,7.825,31.7
2017,ISERE,Têche,459,96,363,15,348,1,REC,26,7.825,31.7
2017,ISERE,Têche,459,96,363,15,348,1,RES,17,7.825,31.7
2017,ISERE,Saint-Ondras,460,81,379,10,369,1,EELV,8,7.825,31.7
2017,ISERE,Saint-Ondras,460,81,379,10,369,1,FN,113,7.825,31.7
2017,ISERE,Saint-Ondras,460,81,379,10,369,1,LFI,57,7.825,31.7
2017,ISERE,Saint-Ondras,460,81,379,10,369,1,LO,3,7.825,31.7
2017,ISERE,Saint-Ondras,460,81,379,10,369,1,LR,16,7.825,31.7
2017,ISERE,Saint-Ondras,460,81,379,10,369,1,LREM,96,7.825,31.7
2017,ISERE,Saint-Ondras,460,81,379,10,369,1,NPA,5,7.825,31.7
2017,ISERE,Saint-Ondras,460,81,379,10,369,1,PCF,11,7.825,31.7
2017,ISERE,Saint-Ondras,460,81,379,10,369,1,REC,22,7.825,31.7
2017,ISERE,Saint-Ondras,460,81,379,10,369,1,RES,17,7.825,31.7
2017,ISERE,Saint-Sorlin-de-Morestel,460,101,359,4,355,1,EELV,15,7.825,31.7
2017,ISERE,Saint-Sorlin-de-Morestel,460,101,359,4,355,1,FN,120,7.825,31.7
2017,ISERE,Saint-Sorlin-de-Morestel,460,101,359,4,355,1,LFI,52,7.825,31.7
2017,ISERE,Saint-Sorlin-de-Morestel,460,101,359,4,355,1,LO,2,7.825,31.7
2017,ISERE,Saint-Sorlin-de-Morestel,460,101,359,4,355,1,LR,19,7.825,31.7
2017,ISERE,Saint-Sorlin-de-Morestel,460,101,359,4,355,1,LREM,74,7.825,31.7
2017,ISERE,Saint-Sorlin-de-Morestel,460,101,359,4,355,1,NPA,2,7.825,31.7
2017,ISERE,Saint-Sorlin-de-Morestel,460,101,359,4,355,1,PCF,4,7.825,31.7
2017,ISERE,Saint-Sorlin-de-Morestel,460,101,359,4,355,1,REC,39,7.825,31.7
2017,ISERE,Saint-Sorlin-de-Morestel,460,101,359,4,355,1,RES,8,7.825,31.7
2017,ISERE,Le Bouchage,461,79,382,6,376,1,EELV,11,7.825,31.7
2017,ISERE,Le Bouchage,461,79,382,6,376,1,FN,166,7.825,31.7
2017,ISERE,Le Bouchage,461,79,382,6,376,1,LFI,44,7.825,31.7
2017,ISERE,Le Bouchage,461,79,382,6,376,1,LO,4,7.825,31.7
2017,ISERE,Le Bouchage,461,79,382,6,376,1,LR,16,7.825,31.7
2017,ISERE,Le Bouchage,461,79,382,6,376,1,LREM,73,7.825,31.7
2017,ISERE,Le Bouchage,461,79,382,6,376,1,NPA,2,7.825,31.7
2017,ISERE,Le Bouchage,461,79,382,6,376,1,PCF,6,7.825,31.7
2017,ISERE,Le Bouchage,461,79,382,6,376,1,REC,33,7.825,31.7
2017,ISERE,Le Bouchage,461,79,382,6,376,1,RES,10,7.825,31.7
2017,ISERE,Brangues,461,82,379,10,369,1,EELV,16,7.825,31.7
2017,ISERE,Brangues,461,82,379,10,369,1,FN,128,7.825,31.7
2017,ISERE,Brangues,461,82,379,10,369,1,LFI,61,7.825,31.7
2017,ISERE,Brangues,461,82,379,10,369,1,LO,3,7.825,31.7
2017,ISERE,Brangues,461,82,379,10,369,1,LR,8,7.825,31.7
2017,ISERE,Brangues,461,82,379,10,369,1,LREM,79,7.825,31.7
2017,ISERE,Brangues,461,82,379,10,369,1,NPA,9,7.825,31.7
2017,ISERE,Brangues,461,82,379,10,369,1,PCF,11,7.825,31.7
2017,ISERE,Brangues,461,82,379,10,369,1,REC,17,7.825,31.7
2017,ISERE,Brangues,461,82,379,10,369,1,RES,15,7.825,31.7
2017,ISERE,Clelles,467,93,374,9,365,1,EELV,23,7.825,31.7
2017,ISERE,Clelles,467,93,374,9,365,1,FN,77,7.825,31.7
2017,ISERE,Clelles,467,93,374,9,365,1,LFI,113,7.825,31.7
2017,ISERE,Clelles,467,93,374,9,365,1,LO,1,7.825,31.7
2017,ISERE,Clelles,467,93,374,9,365,1,LR,28,7.825,31.7
2017,ISERE,Clelles,467,93,374,9,365,1,LREM,68,7.825,31.7
2017,ISERE,Clelles,467,93,374,9,365,1,NPA,8,7.825,31.7
2017,ISERE,Clelles,467,93,374,9,365,1,PCF,9,7.825,31.7
2017,ISERE,Clelles,467,93,374,9,365,1,REC,18,7.825,31.7
2017,ISERE,Clelles,467,93,374,9,365,1,RES,13,7.825,31.7
2017,ISERE,La Pierre,468,65,403,20,383,1,EELV,33,7.825,31.7
2017,ISERE,La Pierre,468,65,403,20,383,1,FN,100,7.825,31.7
2017,ISERE,La Pierre,468,65,403,20,383,1,LFI,70,7.825,31.7
2017,ISERE,La Pierre,468,65,403,20,383,1,LO,1,7.825,31.7
2017,ISERE,La Pierre,468,65,403,20,383,1,LR,16,7.825,31.7
2017,ISERE,La Pierre,468,65,403,20,383,1,LREM,112,7.825,31.7
2017,ISERE,La Pierre,468,65,403,20,383,1,NPA,3,7.825,31.7
2017,ISERE,La Pierre,468,65,403,20,383,1,PCF,9,7.825,31.7
2017,ISERE,La Pierre,468,65,403,20,383,1,REC,19,7.825,31.7
2017,ISERE,La Pierre,468,65,403,20,383,1,RES,6,7.825,31.7
2017,ISERE,Moras,469,84,385,10,375,1,EELV,19,7.825,31.7
2017,ISERE,Moras,469,84,385,10,375,1,FN,116,7.825,31.7
2017,ISERE,Moras,469,84,385,10,375,1,LFI,43,7.825,31.7
2017,ISERE,Moras,469,84,385,10,375,1,LO,4,7.825,31.7
2017,ISERE,Moras,469,84,385,10,375,1,LR,13,7.825,31.7
2017,ISERE,Moras,469,84,385,10,375,1,LREM,106,7.825,31.7
2017,ISERE,Moras,469,84,385,10,375,1,NPA,2,7.825,31.7
2017,ISERE,Moras,469,84,385,10,375,1,PCF,10,7.825,31.7
2017,ISERE,Moras,469,84,385,10,375,1,REC,25,7.825,31.7
2017,ISERE,Moras,469,84,385,10,375,1,RES,17,7.825,31.7
2017,ISERE,Arandon-Passins,469,114,355,9,346,1,EELV,19,7.825,31.7
2017,ISERE,Arandon-Passins,469,114,355,9,346,1,FN,153,7.825,31.7
2017,ISERE,Arandon-Passins,469,114,355,9,346,1,LFI,46,7.825,31.7
2017,ISERE,Arandon-Passins,469,114,355,9,346,1,LO,1,7.825,31.7
2017,ISERE,Arandon-Passins,469,114,355,9,346,1,LR,12,7.825,31.7
2017,ISERE,Arandon-Passins,469,114,355,9,346,1,LREM,70,7.825,31.7
2017,ISERE,Arandon-Passins,469,114,355,9,346,1,NPA,3,7.825,31.7
2017,ISERE,Arandon-Passins,469,114,355,9,346,1,PCF,1,7.825,31.7
2017,ISERE,Arandon-Passins,469,114,355,9,346,1,REC,20,7.825,31.7
2017,ISERE,Arandon-Passins,469,114,355,9,346,1,RES,8,7.825,31.7
2017,ISERE,Saint-Jean-de-Vaulx,472,89,383,9,374,1,EELV,32,7.825,31.7
2017,ISERE,Saint-Jean-de-Vaulx,472,89,383,9,374,1,FN,68,7.825,31.7
2017,ISERE,Saint-Jean-de-Vaulx,472,89,383,9,374,1,LFI,89,7.825,31.7
2017,ISERE,Saint-Jean-de-Vaulx,472,89,383,9,374,1,LO,4,7.825,31.7
2017,ISERE,Saint-Jean-de-Vaulx,472,89,383,9,374,1,LR,12,7.825,31.7
2017,ISERE,Saint-Jean-de-Vaulx,472,89,383,9,374,1,LREM,82,7.825,31.7
2017,ISERE,Saint-Jean-de-Vaulx,472,89,383,9,374,1,NPA,5,7.825,31.7
2017,ISERE,Saint-Jean-de-Vaulx,472,89,383,9,374,1,PCF,17,7.825,31.7
2017,ISERE,Saint-Jean-de-Vaulx,472,89,383,9,374,1,REC,22,7.825,31.7
2017,ISERE,Saint-Jean-de-Vaulx,472,89,383,9,374,1,RES,21,7.825,31.7
2017,ISERE,Sainte-Agnès,473,57,416,6,410,1,EELV,40,7.825,31.7
2017,ISERE,Sainte-Agnès,473,57,416,6,410,1,FN,53,7.825,31.7
2017,ISERE,Sainte-Agnès,473,57,416,6,410,1,LFI,113,7.825,31.7
2017,ISERE,Sainte-Agnès,473,57,416,6,410,1,LO,0,7.825,31.7
2017,ISERE,Sainte-Agnès,473,57,416,6,410,1,LR,24,7.825,31.7
2017,ISERE,Sainte-Agnès,473,57,416,6,410,1,LREM,109,7.825,31.7
2017,ISERE,Sainte-Agnès,473,57,416,6,410,1,NPA,4,7.825,31.7
2017,ISERE,Sainte-Agnès,473,57,416,6,410,1,PCF,12,7.825,31.7
2017,ISERE,Sainte-Agnès,473,57,416,6,410,1,REC,19,7.825,31.7
2017,ISERE,Sainte-Agnès,473,57,416,6,410,1,RES,17,7.825,31.7
2017,ISERE,Chamrousse,474,94,380,10,370,1,EELV,17,7.825,31.7
2017,ISERE,Chamrousse,474,94,380,10,370,1,FN,57,7.825,31.7
2017,ISERE,Chamrousse,474,94,380,10,370,1,LFI,60,7.825,31.7
2017,ISERE,Chamrousse,474,94,380,10,370,1,LO,3,7.825,31.7
2017,ISERE,Chamrousse,474,94,380,10,370,1,LR,22,7.825,31.7
2017,ISERE,Chamrousse,474,94,380,10,370,1,LREM,124,7.825,31.7
2017,ISERE,Chamrousse,474,94,380,10,370,1,NPA,7,7.825,31.7
2017,ISERE,Chamrousse,474,94,380,10,370,1,PCF,3,7.825,31.7
2017,ISERE,Chamrousse,474,94,380,10,370,1,REC,36,7.825,31.7
2017,ISERE,Chamrousse,474,94,380,10,370,1,RES,22,7.825,31.7
2017,ISERE,Valbonnais,479,102,377,6,371,1,EELV,18,7.825,31.7
2017,ISERE,Valbonnais,479,102,377,6,371,1,FN,80,7.825,31.7
2017,ISERE,Valbonnais,479,102,377,6,371,1,LFI,68,7.825,31.7
2017,ISERE,Valbonnais,479,102,377,6,371,1,LO,2,7.825,31.7
2017,ISERE,Valbonnais,479,102,377,6,371,1,LR,19,7.825,31.7
2017,ISERE,Valbonnais,479,102,377,6,371,1,LREM,106,7.825,31.7
2017,ISERE,Valbonnais,479,102,377,6,371,1,NPA,1,7.825,31.7
2017,ISERE,Valbonnais,479,102,377,6,371,1,PCF,16,7.825,31.7
2017,ISERE,Valbonnais,479,102,377,6,371,1,REC,16,7.825,31.7
2017,ISERE,Valbonnais,479,102,377,6,371,1,RES,28,7.825,31.7
2017,ISERE,Jarrie,480,74,406,9,397,1,EELV,34,7.825,31.7
2017,ISERE,Jarrie,480,74,406,9,397,1,FN,70,7.825,31.7
2017,ISERE,Jarrie,480,74,406,9,397,1,LFI,69,7.825,31.7
2017,ISERE,Jarrie,480,74,406,9,397,1,LO,1,7.825,31.7
2017,ISERE,Jarrie,480,74,406,9,397,1,LR,15,7.825,31.7
2017,ISERE,Jarrie,480,74,406,9,397,1,LREM,147,7.825,31.7
2017,ISERE,Jarrie,480,74,406,9,397,1,NPA,1,7.825,31.7
2017,ISERE,Jarrie,480,74,406,9,397,1,PCF,6,7.825,31.7
2017,ISERE,Jarrie,480,74,406,9,397,1,REC,21,7.825,31.7
2017,ISERE,Jarrie,480,74,406,9,397,1,RES,10,7.825,31.7
2017,ISERE,Saint-Geoire-en-Valdaine,480,97,383,8,375,1,EELV,26,7.825,31.7
2017,ISERE,Saint-Geoire-en-Valdaine,480,97,383,8,375,1,FN,82,7.825,31.7
2017,ISERE,Saint-Geoire-en-Valdaine,480,97,383,8,375,1,LFI,86,7.825,31.7
2017,ISERE,Saint-Geoire-en-Valdaine,480,97,383,8,375,1,LO,1,7.825,31.7
2017,ISERE,Saint-Geoire-en-Valdaine,480,97,383,8,375,1,LR,13,7.825,31.7
2017,ISERE,Saint-Geoire-en-Valdaine,480,97,383,8,375,1,LREM,102,7.825,31.7
2017,ISERE,Saint-Geoire-en-Valdaine,480,97,383,8,375,1,NPA,1,7.825,31.7
2017,ISERE,Saint-Geoire-en-Valdaine,480,97,383,8,375,1,PCF,4,7.825,31.7
2017,ISERE,Saint-Geoire-en-Valdaine,480,97,383,8,375,1,REC,33,7.825,31.7
2017,ISERE,Saint-Geoire-en-Valdaine,480,97,383,8,375,1,RES,14,7.825,31.7
2017,ISERE,Vertrieu,481,83,398,6,392,1,EELV,8,7.825,31.7
2017,ISERE,Vertrieu,481,83,398,6,392,1,FN,137,7.825,31.7
2017,ISERE,Vertrieu,481,83,398,6,392,1,LFI,78,7.825,31.7
2017,ISERE,Vertrieu,481,83,398,6,392,1,LO,3,7.825,31.7
2017,ISERE,Vertrieu,481,83,398,6,392,1,LR,19,7.825,31.7
2017,ISERE,Vertrieu,481,83,398,6,392,1,LREM,88,7.825,31.7
2017,ISERE,Vertrieu,481,83,398,6,392,1,NPA,4,7.825,31.7
2017,ISERE,Vertrieu,481,83,398,6,392,1,PCF,5,7.825,31.7
2017,ISERE,Vertrieu,481,83,398,6,392,1,REC,29,7.825,31.7
2017,ISERE,Vertrieu,481,83,398,6,392,1,RES,10,7.825,31.7
2017,ISERE,Notre-Dame-de-Vaulx,485,85,400,9,391,1,EELV,25,7.825,31.7
2017,ISERE,Notre-Dame-de-Vaulx,485,85,400,9,391,1,FN,86,7.825,31.7
2017,ISERE,Notre-Dame-de-Vaulx,485,85,400,9,391,1,LFI,101,7.825,31.7
2017,ISERE,Notre-Dame-de-Vaulx,485,85,400,9,391,1,LO,2,7.825,31.7
2017,ISERE,Notre-Dame-de-Vaulx,485,85,400,9,391,1,LR,10,7.825,31.7
2017,ISERE,Notre-Dame-de-Vaulx,485,85,400,9,391,1,LREM,95,7.825,31.7
2017,ISERE,Notre-Dame-de-Vaulx,485,85,400,9,391,1,NPA,6,7.825,31.7
2017,ISERE,Notre-Dame-de-Vaulx,485,85,400,9,391,1,PCF,19,7.825,31.7
2017,ISERE,Notre-Dame-de-Vaulx,485,85,400,9,391,1,REC,23,7.825,31.7
2017,ISERE,Notre-Dame-de-Vaulx,485,85,400,9,391,1,RES,8,7.825,31.7
2017,ISERE,Saint-Bueil,485,94,391,12,379,1,EELV,16,7.825,31.7
2017,ISERE,Saint-Bueil,485,94,391,12,379,1,FN,106,7.825,31.7
2017,ISERE,Saint-Bueil,485,94,391,12,379,1,LFI,96,7.825,31.7
2017,ISERE,Saint-Bueil,485,94,391,12,379,1,LO,2,7.825,31.7
2017,ISERE,Saint-Bueil,485,94,391,12,379,1,LR,9,7.825,31.7
2017,ISERE,Saint-Bueil,485,94,391,12,379,1,LREM,82,7.825,31.7
2017,ISERE,Saint-Bueil,485,94,391,12,379,1,NPA,2,7.825,31.7
2017,ISERE,Saint-Bueil,485,94,391,12,379,1,PCF,8,7.825,31.7
2017,ISERE,Saint-Bueil,485,94,391,12,379,1,REC,19,7.825,31.7
2017,ISERE,Saint-Bueil,485,94,391,12,379,1,RES,25,7.825,31.7
2017,ISERE,Cognin-les-Gorges,486,88,398,18,380,1,EELV,13,7.825,31.7
2017,ISERE,Cognin-les-Gorges,486,88,398,18,380,1,FN,76,7.825,31.7
2017,ISERE,Cognin-les-Gorges,486,88,398,18,380,1,LFI,96,7.825,31.7
2017,ISERE,Cognin-les-Gorges,486,88,398,18,380,1,LO,2,7.825,31.7
2017,ISERE,Cognin-les-Gorges,486,88,398,18,380,1,LR,12,7.825,31.7
2017,ISERE,Cognin-les-Gorges,486,88,398,18,380,1,LREM,112,7.825,31.7
2017,ISERE,Cognin-les-Gorges,486,88,398,18,380,1,NPA,6,7.825,31.7
2017,ISERE,Cognin-les-Gorges,486,88,398,18,380,1,PCF,7,7.825,31.7
2017,ISERE,Cognin-les-Gorges,486,88,398,18,380,1,REC,16,7.825,31.7
2017,ISERE,Cognin-les-Gorges,486,88,398,18,380,1,RES,20,7.825,31.7
2017,ISERE,Saint-Hilaire-de-Brens,494,83,411,14,397,1,EELV,25,7.825,31.7
2017,ISERE,Saint-Hilaire-de-Brens,494,83,411,14,397,1,FN,103,7.825,31.7
2017,ISERE,Saint-Hilaire-de-Brens,494,83,411,14,397,1,LFI,62,7.825,31.7
2017,ISERE,Saint-Hilaire-de-Brens,494,83,411,14,397,1,LO,1,7.825,31.7
2017,ISERE,Saint-Hilaire-de-Brens,494,83,411,14,397,1,LR,24,7.825,31.7
2017,ISERE,Saint-Hilaire-de-Brens,494,83,411,14,397,1,LREM,94,7.825,31.7
2017,ISERE,Saint-Hilaire-de-Brens,494,83,411,14,397,1,NPA,4,7.825,31.7
2017,ISERE,Saint-Hilaire-de-Brens,494,83,411,14,397,1,PCF,5,7.825,31.7
2017,ISERE,Saint-Hilaire-de-Brens,494,83,411,14,397,1,REC,33,7.825,31.7
2017,ISERE,Saint-Hilaire-de-Brens,494,83,411,14,397,1,RES,17,7.825,31.7
2017,ISERE,Vienne,502,152,350,8,342,1,EELV,8,7.825,31.7
2017,ISERE,Vienne,502,152,350,8,342,1,FN,66,7.825,31.7
2017,ISERE,Vienne,502,152,350,8,342,1,LFI,136,7.825,31.7
2017,ISERE,Vienne,502,152,350,8,342,1,LO,2,7.825,31.7
2017,ISERE,Vienne,502,152,350,8,342,1,LR,15,7.825,31.7
2017,ISERE,Vienne,502,152,350,8,342,1,LREM,56,7.825,31.7
2017,ISERE,Vienne,502,152,350,8,342,1,NPA,1,7.825,31.7
2017,ISERE,Vienne,502,152,350,8,342,1,PCF,4,7.825,31.7
2017,ISERE,Vienne,502,152,350,8,342,1,REC,28,7.825,31.7
2017,ISERE,Vienne,502,152,350,8,342,1,RES,4,7.825,31.7
2017,ISERE,La Sure en Chartreuse,506,87,419,16,403,1,EELV,35,7.825,31.7
2017,ISERE,La Sure en Chartreuse,506,87,419,16,403,1,FN,70,7.825,31.7
2017,ISERE,La Sure en Chartreuse,506,87,419,16,403,1,LFI,100,7.825,31.7
2017,ISERE,La Sure en Chartreuse,506,87,419,16,403,1,LO,1,7.825,31.7
2017,ISERE,La Sure en Chartreuse,506,87,419,16,403,1,LR,27,7.825,31.7
2017,ISERE,La Sure en Chartreuse,506,87,419,16,403,1,LREM,109,7.825,31.7
2017,ISERE,La Sure en Chartreuse,506,87,419,16,403,1,NPA,1,7.825,31.7
2017,ISERE,La Sure en Chartreuse,506,87,419,16,403,1,PCF,8,7.825,31.7
2017,ISERE,La Sure en Chartreuse,506,87,419,16,403,1,REC,20,7.825,31.7
2017,ISERE,La Sure en Chartreuse,506,87,419,16,403,1,RES,14,7.825,31.7
2017,ISERE,Rovon,507,98,409,8,401,1,EELV,12,7.825,31.7
2017,ISERE,Rovon,507,98,409,8,401,1,FN,141,7.825,31.7
2017,ISERE,Rovon,507,98,409,8,401,1,LFI,95,7.825,31.7
2017,ISERE,Rovon,507,98,409,8,401,1,LO,2,7.825,31.7
2017,ISERE,Rovon,507,98,409,8,401,1,LR,2,7.825,31.7
2017,ISERE,Rovon,507,98,409,8,401,1,LREM,93,7.825,31.7
2017,ISERE,Rovon,507,98,409,8,401,1,NPA,2,7.825,31.7
2017,ISERE,Rovon,507,98,409,8,401,1,PCF,6,7.825,31.7
2017,ISERE,Rovon,507,98,409,8,401,1,REC,26,7.825,31.7
2017,ISERE,Rovon,507,98,409,8,401,1,RES,9,7.825,31.7
2017,ISERE,Eclose-Badinières,509,87,422,13,409,1,EELV,15,7.825,31.7
2017,ISERE,Eclose-Badinières,509,87,422,13,409,1,FN,126,7.825,31.7
2017,ISERE,Eclose-Badinières,509,87,422,13,409,1,LFI,57,7.825,31.7
2017,ISERE,Eclose-Badinières,509,87,422,13,409,1,LO,0,7.825,31.7
2017,ISERE,Eclose-Badinières,509,87,422,13,409,1,LR,14,7.825,31.7
2017,ISERE,Eclose-Badinières,509,87,422,13,409,1,LREM,105,7.825,31.7
2017,ISERE,Eclose-Badinières,509,87,422,13,409,1,NPA,6,7.825,31.7
2017,ISERE,Eclose-Badinières,509,87,422,13,409,1,PCF,7,7.825,31.7
2017,ISERE,Eclose-Badinières,509,87,422,13,409,1,REC,41,7.825,31.7
2017,ISERE,Eclose-Badinières,509,87,422,13,409,1,RES,14,7.825,31.7
2017,ISERE,Saint-Pierre-d'Entremont,512,115,397,6,391,1,EELV,27,7.825,31.7
2017,ISERE,Saint-Pierre-d'Entremont,512,115,397,6,391,1,FN,77,7.825,31.7
2017,ISERE,Saint-Pierre-d'Entremont,512,115,397,6,391,1,LFI,104,7.825,31.7
2017,ISERE,Saint-Pierre-d'Entremont,512,115,397,6,391,1,LO,5,7.825,31.7
2017,ISERE,Saint-Pierre-d'Entremont,512,115,397,6,391,1,LR,20,7.825,31.7
2017,ISERE,Saint-Pierre-d'Entremont,512,115,397,6,391,1,LREM,89,7.825,31.7
2017,ISERE,Saint-Pierre-d'Entremont,512,115,397,6,391,1,NPA,0,7.825,31.7
2017,ISERE,Saint-Pierre-d'Entremont,512,115,397,6,391,1,PCF,6,7.825,31.7
2017,ISERE,Saint-Pierre-d'Entremont,512,115,397,6,391,1,REC,27,7.825,31.7
2017,ISERE,Saint-Pierre-d'Entremont,512,115,397,6,391,1,RES,20,7.825,31.7
2017,ISERE,Estrablin,515,87,428,10,418,1,EELV,21,7.825,31.7
2017,ISERE,Estrablin,515,87,428,10,418,1,FN,122,7.825,31.7
2017,ISERE,Estrablin,515,87,428,10,418,1,LFI,57,7.825,31.7
2017,ISERE,Estrablin,515,87,428,10,418,1,LO,6,7.825,31.7
2017,ISERE,Estrablin,515,87,428,10,418,1,LR,17,7.825,31.7
2017,ISERE,Estrablin,515,87,428,10,418,1,LREM,106,7.825,31.7
2017,ISERE,Estrablin,515,87,428,10,418,1,NPA,2,7.825,31.7
2017,ISERE,Estrablin,515,87,428,10,418,1,PCF,16,7.825,31.7
2017,ISERE,Estrablin,515,87,428,10,418,1,REC,41,7.825,31.7
2017,ISERE,Estrablin,515,87,428,10,418,1,RES,13,7.825,31.7
2017,ISERE,Marcollin,515,133,382,9,373,1,EELV,8,7.825,31.7
2017,ISERE,Marcollin,515,133,382,9,373,1,FN,126,7.825,31.7
2017,ISERE,Marcollin,515,133,382,9,373,1,LFI,78,7.825,31.7
2017,ISERE,Marcollin,515,133,382,9,373,1,LO,3,7.825,31.7
2017,ISERE,Marcollin,515,133,382,9,373,1,LR,10,7.825,31.7
2017,ISERE,Marcollin,515,133,382,9,373,1,LREM,86,7.825,31.7
2017,ISERE,Marcollin,515,133,382,9,373,1,NPA,1,7.825,31.7
2017,ISERE,Marcollin,515,133,382,9,373,1,PCF,12,7.825,31.7
2017,ISERE,Marcollin,515,133,382,9,373,1,REC,25,7.825,31.7
2017,ISERE,Marcollin,515,133,382,9,373,1,RES,11,7.825,31.7
2017,ISERE,La Chapelle-de-Surieu,518,91,427,9,418,1,EELV,16,7.825,31.7
2017,ISERE,La Chapelle-de-Surieu,518,91,427,9,418,1,FN,145,7.825,31.7
2017,ISERE,La Chapelle-de-Surieu,518,91,427,9,418,1,LFI,70,7.825,31.7
2017,ISERE,La Chapelle-de-Surieu,518,91,427,9,418,1,LO,1,7.825,31.7
2017,ISERE,La Chapelle-de-Surieu,518,91,427,9,418,1,LR,12,7.825,31.7
2017,ISERE,La Chapelle-de-Surieu,518,91,427,9,418,1,LREM,91,7.825,31.7
2017,ISERE,La Chapelle-de-Surieu,518,91,427,9,418,1,NPA,4,7.825,31.7
2017,ISERE,La Chapelle-de-Surieu,518,91,427,9,418,1,PCF,7,7.825,31.7
2017,ISERE,La Chapelle-de-Surieu,518,91,427,9,418,1,REC,40,7.825,31.7
2017,ISERE,La Chapelle-de-Surieu,518,91,427,9,418,1,RES,10,7.825,31.7
2017,ISERE,Beaulieu,522,80,442,15,427,1,EELV,28,7.825,31.7
2017,ISERE,Beaulieu,522,80,442,15,427,1,FN,117,7.825,31.7
2017,ISERE,Beaulieu,522,80,442,15,427,1,LFI,69,7.825,31.7
2017,ISERE,Beaulieu,522,80,442,15,427,1,LO,5,7.825,31.7
2017,ISERE,Beaulieu,522,80,442,15,427,1,LR,22,7.825,31.7
2017,ISERE,Beaulieu,522,80,442,15,427,1,LREM,109,7.825,31.7
2017,ISERE,Beaulieu,522,80,442,15,427,1,NPA,1,7.825,31.7
2017,ISERE,Beaulieu,522,80,442,15,427,1,PCF,10,7.825,31.7
2017,ISERE,Beaulieu,522,80,442,15,427,1,REC,21,7.825,31.7
2017,ISERE,Beaulieu,522,80,442,15,427,1,RES,18,7.825,31.7
2017,ISERE,Le Péage-de-Roussillon,522,180,342,3,339,1,EELV,5,7.825,31.7
2017,ISERE,Le Péage-de-Roussillon,522,180,342,3,339,1,FN,78,7.825,31.7
2017,ISERE,Le Péage-de-Roussillon,522,180,342,3,339,1,LFI,109,7.825,31.7
2017,ISERE,Le Péage-de-Roussillon,522,180,342,3,339,1,LO,1,7.825,31.7
2017,ISERE,Le Péage-de-Roussillon,522,180,342,3,339,1,LR,12,7.825,31.7
2017,ISERE,Le Péage-de-Roussillon,522,180,342,3,339,1,LREM,87,7.825,31.7
2017,ISERE,Le Péage-de-Roussillon,522,180,342,3,339,1,NPA,1,7.825,31.7
2017,ISERE,Le Péage-de-Roussillon,522,180,342,3,339,1,PCF,13,7.825,31.7
2017,ISERE,Le Péage-de-Roussillon,522,180,342,3,339,1,REC,20,7.825,31.7
2017,ISERE,Le Péage-de-Roussillon,522,180,342,3,339,1,RES,5,7.825,31.7
2017,ISERE,Annoisin-Chatelans,525,80,445,12,433,1,EELV,25,7.825,31.7
2017,ISERE,Annoisin-Chatelans,525,80,445,12,433,1,FN,127,7.825,31.7
2017,ISERE,Annoisin-Chatelans,525,80,445,12,433,1,LFI,67,7.825,31.7
2017,ISERE,Annoisin-Chatelans,525,80,445,12,433,1,LO,0,7.825,31.7
2017,ISERE,Annoisin-Chatelans,525,80,445,12,433,1,LR,13,7.825,31.7
2017,ISERE,Annoisin-Chatelans,525,80,445,12,433,1,LREM,116,7.825,31.7
2017,ISERE,Annoisin-Chatelans,525,80,445,12,433,1,NPA,9,7.825,31.7
2017,ISERE,Annoisin-Chatelans,525,80,445,12,433,1,PCF,7,7.825,31.7
2017,ISERE,Annoisin-Chatelans,525,80,445,12,433,1,REC,42,7.825,31.7
2017,ISERE,Annoisin-Chatelans,525,80,445,12,433,1,RES,12,7.825,31.7
2017,ISERE,La Buissière,526,95,431,16,415,1,EELV,44,7.825,31.7
2017,ISERE,La Buissière,526,95,431,16,415,1,FN,100,7.825,31.7
2017,ISERE,La Buissière,526,95,431,16,415,1,LFI,62,7.825,31.7
2017,ISERE,La Buissière,526,95,431,16,415,1,LO,1,7.825,31.7
2017,ISERE,La Buissière,526,95,431,16,415,1,LR,20,7.825,31.7
2017,ISERE,La Buissière,526,95,431,16,415,1,LREM,123,7.825,31.7
2017,ISERE,La Buissière,526,95,431,16,415,1,NPA,3,7.825,31.7
2017,ISERE,La Buissière,526,95,431,16,415,1,PCF,7,7.825,31.7
2017,ISERE,La Buissière,526,95,431,16,415,1,REC,24,7.825,31.7
2017,ISERE,La Buissière,526,95,431,16,415,1,RES,12,7.825,31.7
2017,ISERE,Plateau des Petites Roches,527,82,445,4,441,1,EELV,53,7.825,31.7
2017,ISERE,Plateau des Petites Roches,527,82,445,4,441,1,FN,30,7.825,31.7
2017,ISERE,Plateau des Petites Roches,527,82,445,4,441,1,LFI,204,7.825,31.7
2017,ISERE,Plateau des Petites Roches,527,82,445,4,441,1,LO,6,7.825,31.7
2017,ISERE,Plateau des Petites Roches,527,82,445,4,441,1,LR,6,7.825,31.7
2017,ISERE,Plateau des Petites Roches,527,82,445,4,441,1,LREM,73,7.825,31.7
2017,ISERE,Plateau des Petites Roches,527,82,445,4,441,1,NPA,4,7.825,31.7
2017,ISERE,Plateau des Petites Roches,527,82,445,4,441,1,PCF,10,7.825,31.7
2017,ISERE,Plateau des Petites Roches,527,82,445,4,441,1,REC,30,7.825,31.7
2017,ISERE,Plateau des Petites Roches,527,82,445,4,441,1,RES,10,7.825,31.7
2017,ISERE,Sinard,533,83,450,10,440,1,EELV,39,7.825,31.7
2017,ISERE,Sinard,533,83,450,10,440,1,FN,77,7.825,31.7
2017,ISERE,Sinard,533,83,450,10,440,1,LFI,113,7.825,31.7
2017,ISERE,Sinard,533,83,450,10,440,1,LO,3,7.825,31.7
2017,ISERE,Sinard,533,83,450,10,440,1,LR,20,7.825,31.7
2017,ISERE,Sinard,533,83,450,10,440,1,LREM,103,7.825,31.7
2017,ISERE,Sinard,533,83,450,10,440,1,NPA,4,7.825,31.7
2017,ISERE,Sinard,533,83,450,10,440,1,PCF,18,7.825,31.7
2017,ISERE,Sinard,533,83,450,10,440,1,REC,24,7.825,31.7
2017,ISERE,Sinard,533,83,450,10,440,1,RES,17,7.825,31.7
2017,ISERE,Valencogne,535,118,417,14,403,1,EELV,24,7.825,31.7
2017,ISERE,Valencogne,535,118,417,14,403,1,FN,116,7.825,31.7
2017,ISERE,Valencogne,535,118,417,14,403,1,LFI,46,7.825,31.7
2017,ISERE,Valencogne,535,118,417,14,403,1,LO,3,7.825,31.7
2017,ISERE,Valencogne,535,118,417,14,403,1,LR,20,7.825,31.7
2017,ISERE,Valencogne,535,118,417,14,403,1,LREM,128,7.825,31.7
2017,ISERE,Valencogne,535,118,417,14,403,1,NPA,2,7.825,31.7
2017,ISERE,Valencogne,535,118,417,14,403,1,PCF,8,7.825,31.7
2017,ISERE,Valencogne,535,118,417,14,403,1,REC,20,7.825,31.7
2017,ISERE,Valencogne,535,118,417,14,403,1,RES,20,7.825,31.7
2017,ISERE,Parmilieu,537,99,438,9,429,1,EELV,14,7.825,31.7
2017,ISERE,Parmilieu,537,99,438,9,429,1,FN,149,7.825,31.7
2017,ISERE,Parmilieu,537,99,438,9,429,1,LFI,65,7.825,31.7
2017,ISERE,Parmilieu,537,99,438,9,429,1,LO,4,7.825,31.7
2017,ISERE,Parmilieu,537,99,438,9,429,1,LR,18,7.825,31.7
2017,ISERE,Parmilieu,537,99,438,9,429,1,LREM,98,7.825,31.7
2017,ISERE,Parmilieu,537,99,438,9,429,1,NPA,4,7.825,31.7
2017,ISERE,Parmilieu,537,99,438,9,429,1,PCF,13,7.825,31.7
2017,ISERE,Parmilieu,537,99,438,9,429,1,REC,30,7.825,31.7
2017,ISERE,Parmilieu,537,99,438,9,429,1,RES,12,7.825,31.7
2017,ISERE,Panossas,540,81,459,9,450,1,EELV,18,7.825,31.7
2017,ISERE,Panossas,540,81,459,9,450,1,FN,124,7.825,31.7
2017,ISERE,Panossas,540,81,459,9,450,1,LFI,69,7.825,31.7
2017,ISERE,Panossas,540,81,459,9,450,1,LO,2,7.825,31.7
2017,ISERE,Panossas,540,81,459,9,450,1,LR,27,7.825,31.7
2017,ISERE,Panossas,540,81,459,9,450,1,LREM,128,7.825,31.7
2017,ISERE,Panossas,540,81,459,9,450,1,NPA,3,7.825,31.7
2017,ISERE,Panossas,540,81,459,9,450,1,PCF,8,7.825,31.7
2017,ISERE,Panossas,540,81,459,9,450,1,REC,46,7.825,31.7
2017,ISERE,Panossas,540,81,459,9,450,1,RES,13,7.825,31.7
2017,ISERE,Biol,540,93,447,18,429,1,EELV,16,7.825,31.7
2017,ISERE,Biol,540,93,447,18,429,1,FN,148,7.825,31.7
2017,ISERE,Biol,540,93,447,18,429,1,LFI,54,7.825,31.7
2017,ISERE,Biol,540,93,447,18,429,1,LO,0,7.825,31.7
2017,ISERE,Biol,540,93,447,18,429,1,LR,21,7.825,31.7
2017,ISERE,Biol,540,93,447,18,429,1,LREM,94,7.825,31.7
2017,ISERE,Biol,540,93,447,18,429,1,NPA,1,7.825,31.7
2017,ISERE,Biol,540,93,447,18,429,1,PCF,8,7.825,31.7
2017,ISERE,Biol,540,93,447,18,429,1,REC,42,7.825,31.7
2017,ISERE,Biol,540,93,447,18,429,1,RES,22,7.825,31.7
2017,ISERE,Meyssiez,542,101,441,12,429,1,EELV,12,7.825,31.7
2017,ISERE,Meyssiez,542,101,441,12,429,1,FN,152,7.825,31.7
2017,ISERE,Meyssiez,542,101,441,12,429,1,LFI,40,7.825,31.7
2017,ISERE,Meyssiez,542,101,441,12,429,1,LO,3,7.825,31.7
2017,ISERE,Meyssiez,542,101,441,12,429,1,LR,31,7.825,31.7
2017,ISERE,Meyssiez,542,101,441,12,429,1,LREM,82,7.825,31.7
2017,ISERE,Meyssiez,542,101,441,12,429,1,NPA,5,7.825,31.7
2017,ISERE,Meyssiez,542,101,441,12,429,1,PCF,19,7.825,31.7
2017,ISERE,Meyssiez,542,101,441,12,429,1,REC,53,7.825,31.7
2017,ISERE,Meyssiez,542,101,441,12,429,1,RES,13,7.825,31.7
2017,ISERE,Saint-Martin-d'Hères,545,169,376,6,370,1,EELV,13,7.825,31.7
2017,ISERE,Saint-Martin-d'Hères,545,169,376,6,370,1,FN,91,7.825,31.7
2017,ISERE,Saint-Martin-d'Hères,545,169,376,6,370,1,LFI,93,7.825,31.7
2017,ISERE,Saint-Martin-d'Hères,545,169,376,6,370,1,LO,1,7.825,31.7
2017,ISERE,Saint-Martin-d'Hères,545,169,376,6,370,1,LR,10,7.825,31.7
2017,ISERE,Saint-Martin-d'Hères,545,169,376,6,370,1,LREM,101,7.825,31.7
2017,ISERE,Saint-Martin-d'Hères,545,169,376,6,370,1,NPA,4,7.825,31.7
2017,ISERE,Saint-Martin-d'Hères,545,169,376,6,370,1,PCF,8,7.825,31.7
2017,ISERE,Saint-Martin-d'Hères,545,169,376,6,370,1,REC,20,7.825,31.7
2017,ISERE,Saint-Martin-d'Hères,545,169,376,6,370,1,RES,12,7.825,31.7
2017,ISERE,Saint-Martin-de-la-Cluze,546,87,459,6,453,1,EELV,34,7.825,31.7
2017,ISERE,Saint-Martin-de-la-Cluze,546,87,459,6,453,1,FN,96,7.825,31.7
2017,ISERE,Saint-Martin-de-la-Cluze,546,87,459,6,453,1,LFI,120,7.825,31.7
2017,ISERE,Saint-Martin-de-la-Cluze,546,87,459,6,453,1,LO,0,7.825,31.7
2017,ISERE,Saint-Martin-de-la-Cluze,546,87,459,6,453,1,LR,7,7.825,31.7
2017,ISERE,Saint-Martin-de-la-Cluze,546,87,459,6,453,1,LREM,102,7.825,31.7
2017,ISERE,Saint-Martin-de-la-Cluze,546,87,459,6,453,1,NPA,5,7.825,31.7
2017,ISERE,Saint-Martin-de-la-Cluze,546,87,459,6,453,1,PCF,8,7.825,31.7
2017,ISERE,Saint-Martin-de-la-Cluze,546,87,459,6,453,1,REC,49,7.825,31.7
2017,ISERE,Saint-Martin-de-la-Cluze,546,87,459,6,453,1,RES,9,7.825,31.7
2017,ISERE,Saint-Lattier,547,107,440,7,433,1,EELV,17,7.825,31.7
2017,ISERE,Saint-Lattier,547,107,440,7,433,1,FN,150,7.825,31.7
2017,ISERE,Saint-Lattier,547,107,440,7,433,1,LFI,52,7.825,31.7
2017,ISERE,Saint-Lattier,547,107,440,7,433,1,LO,6,7.825,31.7
2017,ISERE,Saint-Lattier,547,107,440,7,433,1,LR,21,7.825,31.7
2017,ISERE,Saint-Lattier,547,107,440,7,433,1,LREM,110,7.825,31.7
2017,ISERE,Saint-Lattier,547,107,440,7,433,1,NPA,3,7.825,31.7
2017,ISERE,Saint-Lattier,547,107,440,7,433,1,PCF,6,7.825,31.7
2017,ISERE,Saint-Lattier,547,107,440,7,433,1,REC,30,7.825,31.7
2017,ISERE,Saint-Lattier,547,107,440,7,433,1,RES,15,7.825,31.7
2017,ISERE,Estrablin,553,86,467,15,452,1,EELV,15,7.825,31.7
2017,ISERE,Estrablin,553,86,467,15,452,1,FN,123,7.825,31.7
2017,ISERE,Estrablin,553,86,467,15,452,1,LFI,64,7.825,31.7
2017,ISERE,Estrablin,553,86,467,15,452,1,LO,5,7.825,31.7
2017,ISERE,Estrablin,553,86,467,15,452,1,LR,27,7.825,31.7
2017,ISERE,Estrablin,553,86,467,15,452,1,LREM,142,7.825,31.7
2017,ISERE,Estrablin,553,86,467,15,452,1,NPA,2,7.825,31.7
2017,ISERE,Estrablin,553,86,467,15,452,1,PCF,11,7.825,31.7
2017,ISERE,Estrablin,553,86,467,15,452,1,REC,25,7.825,31.7
2017,ISERE,Estrablin,553,86,467,15,452,1,RES,12,7.825,31.7
2017,ISERE,Saint-Maximin,553,90,463,9,454,1,EELV,28,7.825,31.7
2017,ISERE,Saint-Maximin,553,90,463,9,454,1,FN,113,7.825,31.7
2017,ISERE,Saint-Maximin,553,90,463,9,454,1,LFI,100,7.825,31.7
2017,ISERE,Saint-Maximin,553,90,463,9,454,1,LO,3,7.825,31.7
2017,ISERE,Saint-Maximin,553,90,463,9,454,1,LR,7,7.825,31.7
2017,ISERE,Saint-Maximin,553,90,463,9,454,1,LREM,107,7.825,31.7
2017,ISERE,Saint-Maximin,553,90,463,9,454,1,NPA,5,7.825,31.7
2017,ISERE,Saint-Maximin,553,90,463,9,454,1,PCF,12,7.825,31.7
2017,ISERE,Saint-Maximin,553,90,463,9,454,1,REC,33,7.825,31.7
2017,ISERE,Saint-Maximin,553,90,463,9,454,1,RES,21,7.825,31.7
2017,ISERE,La Rivière,555,113,442,8,434,1,EELV,23,7.825,31.7
2017,ISERE,La Rivière,555,113,442,8,434,1,FN,143,7.825,31.7
2017,ISERE,La Rivière,555,113,442,8,434,1,LFI,82,7.825,31.7
2017,ISERE,La Rivière,555,113,442,8,434,1,LO,3,7.825,31.7
2017,ISERE,La Rivière,555,113,442,8,434,1,LR,8,7.825,31.7
2017,ISERE,La Rivière,555,113,442,8,434,1,LREM,98,7.825,31.7
2017,ISERE,La Rivière,555,113,442,8,434,1,NPA,3,7.825,31.7
2017,ISERE,La Rivière,555,113,442,8,434,1,PCF,7,7.825,31.7
2017,ISERE,La Rivière,555,113,442,8,434,1,REC,26,7.825,31.7
2017,ISERE,La Rivière,555,113,442,8,434,1,RES,20,7.825,31.7
2017,ISERE,Chevrières,556,100,456,10,446,1,EELV,18,7.825,31.7
2017,ISERE,Chevrières,556,100,456,10,446,1,FN,95,7.825,31.7
2017,ISERE,Chevrières,556,100,456,10,446,1,LFI,106,7.825,31.7
2017,ISERE,Chevrières,556,100,456,10,446,1,LO,2,7.825,31.7
2017,ISERE,Chevrières,556,100,456,10,446,1,LR,31,7.825,31.7
2017,ISERE,Chevrières,556,100,456,10,446,1,LREM,113,7.825,31.7
2017,ISERE,Chevrières,556,100,456,10,446,1,NPA,4,7.825,31.7
2017,ISERE,Chevrières,556,100,456,10,446,1,PCF,13,7.825,31.7
2017,ISERE,Chevrières,556,100,456,10,446,1,REC,28,7.825,31.7
2017,ISERE,Chevrières,556,100,456,10,446,1,RES,16,7.825,31.7
2017,ISERE,Sainte-Anne-sur-Gervonde,557,104,453,13,440,1,EELV,22,7.825,31.7
2017,ISERE,Sainte-Anne-sur-Gervonde,557,104,453,13,440,1,FN,151,7.825,31.7
2017,ISERE,Sainte-Anne-sur-Gervonde,557,104,453,13,440,1,LFI,65,7.825,31.7
2017,ISERE,Sainte-Anne-sur-Gervonde,557,104,453,13,440,1,LO,2,7.825,31.7
2017,ISERE,Sainte-Anne-sur-Gervonde,557,104,453,13,440,1,LR,20,7.825,31.7
2017,ISERE,Sainte-Anne-sur-Gervonde,557,104,453,13,440,1,LREM,96,7.825,31.7
2017,ISERE,Sainte-Anne-sur-Gervonde,557,104,453,13,440,1,NPA,4,7.825,31.7
2017,ISERE,Sainte-Anne-sur-Gervonde,557,104,453,13,440,1,PCF,14,7.825,31.7
2017,ISERE,Sainte-Anne-sur-Gervonde,557,104,453,13,440,1,REC,29,7.825,31.7
2017,ISERE,Sainte-Anne-sur-Gervonde,557,104,453,13,440,1,RES,14,7.825,31.7
2017,ISERE,Saint-Quentin-Fallavier,557,164,393,3,390,1,EELV,9,7.825,31.7
2017,ISERE,Saint-Quentin-Fallavier,557,164,393,3,390,1,FN,96,7.825,31.7
2017,ISERE,Saint-Quentin-Fallavier,557,164,393,3,390,1,LFI,166,7.825,31.7
2017,ISERE,Saint-Quentin-Fallavier,557,164,393,3,390,1,LO,1,7.825,31.7
2017,ISERE,Saint-Quentin-Fallavier,557,164,393,3,390,1,LR,5,7.825,31.7
2017,ISERE,Saint-Quentin-Fallavier,557,164,393,3,390,1,LREM,65,7.825,31.7
2017,ISERE,Saint-Quentin-Fallavier,557,164,393,3,390,1,NPA,5,7.825,31.7
2017,ISERE,Saint-Quentin-Fallavier,557,164,393,3,390,1,PCF,6,7.825,31.7
2017,ISERE,Saint-Quentin-Fallavier,557,164,393,3,390,1,REC,14,7.825,31.7
2017,ISERE,Saint-Quentin-Fallavier,557,164,393,3,390,1,RES,8,7.825,31.7
2017,ISERE,Tramolé,558,88,470,8,462,1,EELV,38,7.825,31.7
2017,ISERE,Tramolé,558,88,470,8,462,1,FN,116,7.825,31.7
2017,ISERE,Tramolé,558,88,470,8,462,1,LFI,59,7.825,31.7
2017,ISERE,Tramolé,558,88,470,8,462,1,LO,3,7.825,31.7
2017,ISERE,Tramolé,558,88,470,8,462,1,LR,23,7.825,31.7
2017,ISERE,Tramolé,558,88,470,8,462,1,LREM,151,7.825,31.7
2017,ISERE,Tramolé,558,88,470,8,462,1,NPA,0,7.825,31.7
2017,ISERE,Tramolé,558,88,470,8,462,1,PCF,12,7.825,31.7
2017,ISERE,Tramolé,558,88,470,8,462,1,REC,22,7.825,31.7
2017,ISERE,Tramolé,558,88,470,8,462,1,RES,16,7.825,31.7
2017,ISERE,Saint-Lattier,563,126,437,13,424,1,EELV,20,7.825,31.7
2017,ISERE,Saint-Lattier,563,126,437,13,424,1,FN,128,7.825,31.7
2017,ISERE,Saint-Lattier,563,126,437,13,424,1,LFI,83,7.825,31.7
2017,ISERE,Saint-Lattier,563,126,437,13,424,1,LO,6,7.825,31.7
2017,ISERE,Saint-Lattier,563,126,437,13,424,1,LR,17,7.825,31.7
2017,ISERE,Saint-Lattier,563,126,437,13,424,1,LREM,98,7.825,31.7
2017,ISERE,Saint-Lattier,563,126,437,13,424,1,NPA,4,7.825,31.7
2017,ISERE,Saint-Lattier,563,126,437,13,424,1,PCF,5,7.825,31.7
2017,ISERE,Saint-Lattier,563,126,437,13,424,1,REC,37,7.825,31.7
2017,ISERE,Saint-Lattier,563,126,437,13,424,1,RES,8,7.825,31.7
2017,ISERE,Eclose-Badinières,570,96,474,11,463,1,EELV,20,7.825,31.7
2017,ISERE,Eclose-Badinières,570,96,474,11,463,1,FN,142,7.825,31.7
2017,ISERE,Eclose-Badinières,570,96,474,11,463,1,LFI,64,7.825,31.7
2017,ISERE,Eclose-Badinières,570,96,474,11,463,1,LO,6,7.825,31.7
2017,ISERE,Eclose-Badinières,570,96,474,11,463,1,LR,12,7.825,31.7
2017,ISERE,Eclose-Badinières,570,96,474,11,463,1,LREM,115,7.825,31.7
2017,ISERE,Eclose-Badinières,570,96,474,11,463,1,NPA,5,7.825,31.7
2017,ISERE,Eclose-Badinières,570,96,474,11,463,1,PCF,7,7.825,31.7
2017,ISERE,Eclose-Badinières,570,96,474,11,463,1,REC,50,7.825,31.7
2017,ISERE,Eclose-Badinières,570,96,474,11,463,1,RES,13,7.825,31.7
2017,ISERE,Grenoble,571,137,434,6,428,1,EELV,48,7.825,31.7
2017,ISERE,Grenoble,571,137,434,6,428,1,FN,28,7.825,31.7
2017,ISERE,Grenoble,571,137,434,6,428,1,LFI,198,7.825,31.7
2017,ISERE,Grenoble,571,137,434,6,428,1,LO,3,7.825,31.7
2017,ISERE,Grenoble,571,137,434,6,428,1,LR,8,7.825,31.7
2017,ISERE,Grenoble,571,137,434,6,428,1,LREM,91,7.825,31.7
2017,ISERE,Grenoble,571,137,434,6,428,1,NPA,5,7.825,31.7
2017,ISERE,Grenoble,571,137,434,6,428,1,PCF,4,7.825,31.7
2017,ISERE,Grenoble,571,137,434,6,428,1,REC,13,7.825,31.7
2017,ISERE,Grenoble,571,137,434,6,428,1,RES,13,7.825,31.7
2017,ISERE,Saint-Bonnet-de-Chavagne,572,116,456,6,450,1,EELV,15,7.825,31.7
2017,ISERE,Saint-Bonnet-de-Chavagne,572,116,456,6,450,1,FN,128,7.825,31.7
2017,ISERE,Saint-Bonnet-de-Chavagne,572,116,456,6,450,1,LFI,79,7.825,31.7
2017,ISERE,Saint-Bonnet-de-Chavagne,572,116,456,6,450,1,LO,7,7.825,31.7
2017,ISERE,Saint-Bonnet-de-Chavagne,572,116,456,6,450,1,LR,31,7.825,31.7
2017,ISERE,Saint-Bonnet-de-Chavagne,572,116,456,6,450,1,LREM,104,7.825,31.7
2017,ISERE,Saint-Bonnet-de-Chavagne,572,116,456,6,450,1,NPA,3,7.825,31.7
2017,ISERE,Saint-Bonnet-de-Chavagne,572,116,456,6,450,1,PCF,9,7.825,31.7
2017,ISERE,Saint-Bonnet-de-Chavagne,572,116,456,6,450,1,REC,39,7.825,31.7
2017,ISERE,Saint-Bonnet-de-Chavagne,572,116,456,6,450,1,RES,16,7.825,31.7
2017,ISERE,Torchefelon,573,73,500,22,478,1,EELV,26,7.825,31.7
2017,ISERE,Torchefelon,573,73,500,22,478,1,FN,146,7.825,31.7
2017,ISERE,Torchefelon,573,73,500,22,478,1,LFI,82,7.825,31.7
2017,ISERE,Torchefelon,573,73,500,22,478,1,LO,1,7.825,31.7
2017,ISERE,Torchefelon,573,73,500,22,478,1,LR,14,7.825,31.7
2017,ISERE,Torchefelon,573,73,500,22,478,1,LREM,127,7.825,31.7
2017,ISERE,Torchefelon,573,73,500,22,478,1,NPA,4,7.825,31.7
2017,ISERE,Torchefelon,573,73,500,22,478,1,PCF,8,7.825,31.7
2017,ISERE,Torchefelon,573,73,500,22,478,1,REC,20,7.825,31.7
2017,ISERE,Torchefelon,573,73,500,22,478,1,RES,23,7.825,31.7
2017,ISERE,Moissieu-sur-Dolon,575,115,460,7,453,1,EELV,13,7.825,31.7
2017,ISERE,Moissieu-sur-Dolon,575,115,460,7,453,1,FN,142,7.825,31.7
2017,ISERE,Moissieu-sur-Dolon,575,115,460,7,453,1,LFI,89,7.825,31.7
2017,ISERE,Moissieu-sur-Dolon,575,115,460,7,453,1,LO,5,7.825,31.7
2017,ISERE,Moissieu-sur-Dolon,575,115,460,7,453,1,LR,11,7.825,31.7
2017,ISERE,Moissieu-sur-Dolon,575,115,460,7,453,1,LREM,119,7.825,31.7
2017,ISERE,Moissieu-sur-Dolon,575,115,460,7,453,1,NPA,1,7.825,31.7
2017,ISERE,Moissieu-sur-Dolon,575,115,460,7,453,1,PCF,12,7.825,31.7
2017,ISERE,Moissieu-sur-Dolon,575,115,460,7,453,1,REC,29,7.825,31.7
2017,ISERE,Moissieu-sur-Dolon,575,115,460,7,453,1,RES,14,7.825,31.7
2017,ISERE,Sermérieu,576,110,466,7,459,1,EELV,18,7.825,31.7
2017,ISERE,Sermérieu,576,110,466,7,459,1,FN,132,7.825,31.7
2017,ISERE,Sermérieu,576,110,466,7,459,1,LFI,80,7.825,31.7
2017,ISERE,Sermérieu,576,110,466,7,459,1,LO,3,7.825,31.7
2017,ISERE,Sermérieu,576,110,466,7,459,1,LR,20,7.825,31.7
2017,ISERE,Sermérieu,576,110,466,7,459,1,LREM,105,7.825,31.7
2017,ISERE,Sermérieu,576,110,466,7,459,1,NPA,3,7.825,31.7
2017,ISERE,Sermérieu,576,110,466,7,459,1,PCF,12,7.825,31.7
2017,ISERE,Sermérieu,576,110,466,7,459,1,REC,47,7.825,31.7
2017,ISERE,Sermérieu,576,110,466,7,459,1,RES,15,7.825,31.7
2017,ISERE,La Combe-de-Lancey,577,77,500,15,485,1,EELV,49,7.825,31.7
2017,ISERE,La Combe-de-Lancey,577,77,500,15,485,1,FN,93,7.825,31.7
2017,ISERE,La Combe-de-Lancey,577,77,500,15,485,1,LFI,102,7.825,31.7
2017,ISERE,La Combe-de-Lancey,577,77,500,15,485,1,LO,0,7.825,31.7
2017,ISERE,La Combe-de-Lancey,577,77,500,15,485,1,LR,25,7.825,31.7
2017,ISERE,La Combe-de-Lancey,577,77,500,15,485,1,LREM,134,7.825,31.7
2017,ISERE,La Combe-de-Lancey,577,77,500,15,485,1,NPA,6,7.825,31.7
2017,ISERE,La Combe-de-Lancey,577,77,500,15,485,1,PCF,10,7.825,31.7
2017,ISERE,La Combe-de-Lancey,577,77,500,15,485,1,REC,25,7.825,31.7
2017,ISERE,La Combe-de-Lancey,577,77,500,15,485,1,RES,16,7.825,31.7
2017,ISERE,Succieu,577,92,485,8,477,1,EELV,20,7.825,31.7
2017,ISERE,Succieu,577,92,485,8,477,1,FN,162,7.825,31.7
2017,ISERE,Succieu,577,92,485,8,477,1,LFI,88,7.825,31.7
2017,ISERE,Succieu,577,92,485,8,477,1,LO,2,7.825,31.7
2017,ISERE,Succieu,577,92,485,8,477,1,LR,20,7.825,31.7
2017,ISERE,Succieu,577,92,485,8,477,1,LREM,101,7.825,31.7
2017,ISERE,Succieu,577,92,485,8,477,1,NPA,1,7.825,31.7
2017,ISERE,Succieu,577,92,485,8,477,1,PCF,6,7.825,31.7
2017,ISERE,Succieu,577,92,485,8,477,1,REC,32,7.825,31.7
2017,ISERE,Succieu,577,92,485,8,477,1,RES,16,7.825,31.7
2017,ISERE,Thodure,579,87,492,10,482,1,EELV,18,7.825,31.7
2017,ISERE,Thodure,579,87,492,10,482,1,FN,137,7.825,31.7
2017,ISERE,Thodure,579,87,492,10,482,1,LFI,83,7.825,31.7
2017,ISERE,Thodure,579,87,492,10,482,1,LO,1,7.825,31.7
2017,ISERE,Thodure,579,87,492,10,482,1,LR,20,7.825,31.7
2017,ISERE,Thodure,579,87,492,10,482,1,LREM,125,7.825,31.7
2017,ISERE,Thodure,579,87,492,10,482,1,NPA,2,7.825,31.7
2017,ISERE,Thodure,579,87,492,10,482,1,PCF,17,7.825,31.7
2017,ISERE,Thodure,579,87,492,10,482,1,REC,32,7.825,31.7
2017,ISERE,Thodure,579,87,492,10,482,1,RES,33,7.825,31.7
2017,ISERE,Saint-Martin-d'Hères,588,171,417,9,408,1,EELV,45,7.825,31.7
2017,ISERE,Saint-Martin-d'Hères,588,171,417,9,408,1,FN,61,7.825,31.7
2017,ISERE,Saint-Martin-d'Hères,588,171,417,9,408,1,LFI,147,7.825,31.7
2017,ISERE,Saint-Martin-d'Hères,588,171,417,9,408,1,LO,6,7.825,31.7
2017,ISERE,Saint-Martin-d'Hères,588,171,417,9,408,1,LR,12,7.825,31.7
2017,ISERE,Saint-Martin-d'Hères,588,171,417,9,408,1,LREM,94,7.825,31.7
2017,ISERE,Saint-Martin-d'Hères,588,171,417,9,408,1,NPA,2,7.825,31.7
2017,ISERE,Saint-Martin-d'Hères,588,171,417,9,408,1,PCF,10,7.825,31.7
2017,ISERE,Saint-Martin-d'Hères,588,171,417,9,408,1,REC,17,7.825,31.7
2017,ISERE,Saint-Martin-d'Hères,588,171,417,9,408,1,RES,1,7.825,31.7
2017,ISERE,Monsteroux-Milieu,591,99,492,9,483,1,EELV,15,7.825,31.7
2017,ISERE,Monsteroux-Milieu,591,99,492,9,483,1,FN,163,7.825,31.7
2017,ISERE,Monsteroux-Milieu,591,99,492,9,483,1,LFI,64,7.825,31.7
2017,ISERE,Monsteroux-Milieu,591,99,492,9,483,1,LO,4,7.825,31.7
2017,ISERE,Monsteroux-Milieu,591,99,492,9,483,1,LR,21,7.825,31.7
2017,ISERE,Monsteroux-Milieu,591,99,492,9,483,1,LREM,109,7.825,31.7
2017,ISERE,Monsteroux-Milieu,591,99,492,9,483,1,NPA,4,7.825,31.7
2017,ISERE,Monsteroux-Milieu,591,99,492,9,483,1,PCF,16,7.825,31.7
2017,ISERE,Monsteroux-Milieu,591,99,492,9,483,1,REC,41,7.825,31.7
2017,ISERE,Monsteroux-Milieu,591,99,492,9,483,1,RES,15,7.825,31.7
2017,ISERE,Primarette,593,135,458,8,450,1,EELV,15,7.825,31.7
2017,ISERE,Primarette,593,135,458,8,450,1,FN,159,7.825,31.7
2017,ISERE,Primarette,593,135,458,8,450,1,LFI,84,7.825,31.7
2017,ISERE,Primarette,593,135,458,8,450,1,LO,4,7.825,31.7
2017,ISERE,Primarette,593,135,458,8,450,1,LR,20,7.825,31.7
2017,ISERE,Primarette,593,135,458,8,450,1,LREM,102,7.825,31.7
2017,ISERE,Primarette,593,135,458,8,450,1,NPA,1,7.825,31.7
2017,ISERE,Primarette,593,135,458,8,450,1,PCF,12,7.825,31.7
2017,ISERE,Primarette,593,135,458,8,450,1,REC,25,7.825,31.7
2017,ISERE,Primarette,593,135,458,8,450,1,RES,13,7.825,31.7
2017,ISERE,Voreppe,594,142,452,13,439,1,EELV,26,7.825,31.7
2017,ISERE,Voreppe,594,142,452,13,439,1,FN,72,7.825,31.7
2017,ISERE,Voreppe,594,142,452,13,439,1,LFI,132,7.825,31.7
2017,ISERE,Voreppe,594,142,452,13,439,1,LO,2,7.825,31.7
2017,ISERE,Voreppe,594,142,452,13,439,1,LR,16,7.825,31.7
2017,ISERE,Voreppe,594,142,452,13,439,1,LREM,122,7.825,31.7
2017,ISERE,Voreppe,594,142,452,13,439,1,NPA,4,7.825,31.7
2017,ISERE,Voreppe,594,142,452,13,439,1,PCF,8,7.825,31.7
2017,ISERE,Voreppe,594,142,452,13,439,1,REC,24,7.825,31.7
2017,ISERE,Voreppe,594,142,452,13,439,1,RES,14,7.825,31.7
2017,ISERE,Saint-Pierre-de-Mésage,598,103,495,8,487,1,EELV,27,7.825,31.7
2017,ISERE,Saint-Pierre-de-Mésage,598,103,495,8,487,1,FN,136,7.825,31.7
2017,ISERE,Saint-Pierre-de-Mésage,598,103,495,8,487,1,LFI,100,7.825,31.7
2017,ISERE,Saint-Pierre-de-Mésage,598,103,495,8,487,1,LO,2,7.825,31.7
2017,ISERE,Saint-Pierre-de-Mésage,598,103,495,8,487,1,LR,14,7.825,31.7
2017,ISERE,Saint-Pierre-de-Mésage,598,103,495,8,487,1,LREM,119,7.825,31.7
2017,ISERE,Saint-Pierre-de-Mésage,598,103,495,8,487,1,NPA,6,7.825,31.7
2017,ISERE,Saint-Pierre-de-Mésage,598,103,495,8,487,1,PCF,10,7.825,31.7
2017,ISERE,Saint-Pierre-de-Mésage,598,103,495,8,487,1,REC,36,7.825,31.7
2017,ISERE,Saint-Pierre-de-Mésage,598,103,495,8,487,1,RES,10,7.825,31.7
2017,ISERE,Saint-Pierre-de-Bressieux,599,119,480,18,462,1,EELV,21,7.825,31.7
2017,ISERE,Saint-Pierre-de-Bressieux,599,119,480,18,462,1,FN,88,7.825,31.7
2017,ISERE,Saint-Pierre-de-Bressieux,599,119,480,18,462,1,LFI,53,7.825,31.7
2017,ISERE,Saint-Pierre-de-Bressieux,599,119,480,18,462,1,LO,1,7.825,31.7
2017,ISERE,Saint-Pierre-de-Bressieux,599,119,480,18,462,1,LR,40,7.825,31.7
2017,ISERE,Saint-Pierre-de-Bressieux,599,119,480,18,462,1,LREM,164,7.825,31.7
2017,ISERE,Saint-Pierre-de-Bressieux,599,119,480,18,462,1,NPA,1,7.825,31.7
2017,ISERE,Saint-Pierre-de-Bressieux,599,119,480,18,462,1,PCF,12,7.825,31.7
2017,ISERE,Saint-Pierre-de-Bressieux,599,119,480,18,462,1,REC,47,7.825,31.7
2017,ISERE,Saint-Pierre-de-Bressieux,599,119,480,18,462,1,RES,29,7.825,31.7
2017,ISERE,Culin,600,105,495,14,481,1,EELV,17,7.825,31.7
2017,ISERE,Culin,600,105,495,14,481,1,FN,166,7.825,31.7
2017,ISERE,Culin,600,105,495,14,481,1,LFI,80,7.825,31.7
2017,ISERE,Culin,600,105,495,14,481,1,LO,2,7.825,31.7
2017,ISERE,Culin,600,105,495,14,481,1,LR,13,7.825,31.7
2017,ISERE,Culin,600,105,495,14,481,1,LREM,127,7.825,31.7
2017,ISERE,Culin,600,105,495,14,481,1,NPA,6,7.825,31.7
2017,ISERE,Culin,600,105,495,14,481,1,PCF,8,7.825,31.7
2017,ISERE,Culin,600,105,495,14,481,1,REC,29,7.825,31.7
2017,ISERE,Culin,600,105,495,14,481,1,RES,9,7.825,31.7
2017,ISERE,Saint-Pierre-de-Chartreuse,603,109,494,9,485,1,EELV,36,7.825,31.7
2017,ISERE,Saint-Pierre-de-Chartreuse,603,109,494,9,485,1,FN,69,7.825,31.7
2017,ISERE,Saint-Pierre-de-Chartreuse,603,109,494,9,485,1,LFI,160,7.825,31.7
2017,ISERE,Saint-Pierre-de-Chartreuse,603,109,494,9,485,1,LO,2,7.825,31.7
2017,ISERE,Saint-Pierre-de-Chartreuse,603,109,494,9,485,1,LR,35,7.825,31.7
2017,ISERE,Saint-Pierre-de-Chartreuse,603,109,494,9,485,1,LREM,113,7.825,31.7
2017,ISERE,Saint-Pierre-de-Chartreuse,603,109,494,9,485,1,NPA,7,7.825,31.7
2017,ISERE,Saint-Pierre-de-Chartreuse,603,109,494,9,485,1,PCF,9,7.825,31.7
2017,ISERE,Saint-Pierre-de-Chartreuse,603,109,494,9,485,1,REC,30,7.825,31.7
2017,ISERE,Saint-Pierre-de-Chartreuse,603,109,494,9,485,1,RES,10,7.825,31.7
2017,ISERE,Izeron,603,111,492,16,476,1,EELV,23,7.825,31.7
2017,ISERE,Izeron,603,111,492,16,476,1,FN,170,7.825,31.7
2017,ISERE,Izeron,603,111,492,16,476,1,LFI,89,7.825,31.7
2017,ISERE,Izeron,603,111,492,16,476,1,LO,6,7.825,31.7
2017,ISERE,Izeron,603,111,492,16,476,1,LR,16,7.825,31.7
2017,ISERE,Izeron,603,111,492,16,476,1,LREM,93,7.825,31.7
2017,ISERE,Izeron,603,111,492,16,476,1,NPA,7,7.825,31.7
2017,ISERE,Izeron,603,111,492,16,476,1,PCF,8,7.825,31.7
2017,ISERE,Izeron,603,111,492,16,476,1,REC,27,7.825,31.7
2017,ISERE,Izeron,603,111,492,16,476,1,RES,18,7.825,31.7
2017,ISERE,Massieu,603,153,450,12,438,1,EELV,16,7.825,31.7
2017,ISERE,Massieu,603,153,450,12,438,1,FN,101,7.825,31.7
2017,ISERE,Massieu,603,153,450,12,438,1,LFI,98,7.825,31.7
2017,ISERE,Massieu,603,153,450,12,438,1,LO,5,7.825,31.7
2017,ISERE,Massieu,603,153,450,12,438,1,LR,22,7.825,31.7
2017,ISERE,Massieu,603,153,450,12,438,1,LREM,122,7.825,31.7
2017,ISERE,Massieu,603,153,450,12,438,1,NPA,3,7.825,31.7
2017,ISERE,Massieu,603,153,450,12,438,1,PCF,12,7.825,31.7
2017,ISERE,Massieu,603,153,450,12,438,1,REC,28,7.825,31.7
2017,ISERE,Massieu,603,153,450,12,438,1,RES,19,7.825,31.7
2017,ISERE,Biol,604,101,503,10,493,1,EELV,25,7.825,31.7
2017,ISERE,Biol,604,101,503,10,493,1,FN,171,7.825,31.7
2017,ISERE,Biol,604,101,503,10,493,1,LFI,65,7.825,31.7
2017,ISERE,Biol,604,101,503,10,493,1,LO,2,7.825,31.7
2017,ISERE,Biol,604,101,503,10,493,1,LR,39,7.825,31.7
2017,ISERE,Biol,604,101,503,10,493,1,LREM,114,7.825,31.7
2017,ISERE,Biol,604,101,503,10,493,1,NPA,2,7.825,31.7
2017,ISERE,Biol,604,101,503,10,493,1,PCF,3,7.825,31.7
2017,ISERE,Biol,604,101,503,10,493,1,REC,41,7.825,31.7
2017,ISERE,Biol,604,101,503,10,493,1,RES,11,7.825,31.7
2017,ISERE,Mottier,604,137,467,10,457,1,EELV,16,7.825,31.7
2017,ISERE,Mottier,604,137,467,10,457,1,FN,146,7.825,31.7
2017,ISERE,Mottier,604,137,467,10,457,1,LFI,56,7.825,31.7
2017,ISERE,Mottier,604,137,467,10,457,1,LO,3,7.825,31.7
2017,ISERE,Mottier,604,137,467,10,457,1,LR,28,7.825,31.7
2017,ISERE,Mottier,604,137,467,10,457,1,LREM,118,7.825,31.7
2017,ISERE,Mottier,604,137,467,10,457,1,NPA,8,7.825,31.7
2017,ISERE,Mottier,604,137,467,10,457,1,PCF,6,7.825,31.7
2017,ISERE,Mottier,604,137,467,10,457,1,REC,33,7.825,31.7
2017,ISERE,Mottier,604,137,467,10,457,1,RES,27,7.825,31.7
2017,ISERE,Bresson,607,78,529,3,526,1,EELV,42,7.825,31.7
2017,ISERE,Bresson,607,78,529,3,526,1,FN,71,7.825,31.7
2017,ISERE,Bresson,607,78,529,3,526,1,LFI,71,7.825,31.7
2017,ISERE,Bresson,607,78,529,3,526,1,LO,1,7.825,31.7
2017,ISERE,Bresson,607,78,529,3,526,1,LR,54,7.825,31.7
2017,ISERE,Bresson,607,78,529,3,526,1,LREM,200,7.825,31.7
2017,ISERE,Bresson,607,78,529,3,526,1,NPA,1,7.825,31.7
2017,ISERE,Bresson,607,78,529,3,526,1,PCF,6,7.825,31.7
2017,ISERE,Bresson,607,78,529,3,526,1,REC,59,7.825,31.7
2017,ISERE,Bresson,607,78,529,3,526,1,RES,9,7.825,31.7
2017,ISERE,Janneyrias,607,109,498,14,484,1,EELV,20,7.825,31.7
2017,ISERE,Janneyrias,607,109,498,14,484,1,FN,178,7.825,31.7
2017,ISERE,Janneyrias,607,109,498,14,484,1,LFI,62,7.825,31.7
2017,ISERE,Janneyrias,607,109,498,14,484,1,LO,3,7.825,31.7
2017,ISERE,Janneyrias,607,109,498,14,484,1,LR,28,7.825,31.7
2017,ISERE,Janneyrias,607,109,498,14,484,1,LREM,107,7.825,31.7
2017,ISERE,Janneyrias,607,109,498,14,484,1,NPA,1,7.825,31.7
2017,ISERE,Janneyrias,607,109,498,14,484,1,PCF,6,7.825,31.7
2017,ISERE,Janneyrias,607,109,498,14,484,1,REC,51,7.825,31.7
2017,ISERE,Janneyrias,607,109,498,14,484,1,RES,9,7.825,31.7
2017,ISERE,Chélieu,611,121,490,8,482,1,EELV,31,7.825,31.7
2017,ISERE,Chélieu,611,121,490,8,482,1,FN,130,7.825,31.7
2017,ISERE,Chélieu,611,121,490,8,482,1,LFI,69,7.825,31.7
2017,ISERE,Chélieu,611,121,490,8,482,1,LO,5,7.825,31.7
2017,ISERE,Chélieu,611,121,490,8,482,1,LR,16,7.825,31.7
2017,ISERE,Chélieu,611,121,490,8,482,1,LREM,99,7.825,31.7
2017,ISERE,Chélieu,611,121,490,8,482,1,NPA,6,7.825,31.7
2017,ISERE,Chélieu,611,121,490,8,482,1,PCF,10,7.825,31.7
2017,ISERE,Chélieu,611,121,490,8,482,1,REC,62,7.825,31.7
2017,ISERE,Chélieu,611,121,490,8,482,1,RES,21,7.825,31.7
2017,ISERE,Saint-Hilaire-du-Rosier,611,134,477,10,467,1,EELV,27,7.825,31.7
2017,ISERE,Saint-Hilaire-du-Rosier,611,134,477,10,467,1,FN,135,7.825,31.7
2017,ISERE,Saint-Hilaire-du-Rosier,611,134,477,10,467,1,LFI,89,7.825,31.7
2017,ISERE,Saint-Hilaire-du-Rosier,611,134,477,10,467,1,LO,6,7.825,31.7
2017,ISERE,Saint-Hilaire-du-Rosier,611,134,477,10,467,1,LR,20,7.825,31.7
2017,ISERE,Saint-Hilaire-du-Rosier,611,134,477,10,467,1,LREM,106,7.825,31.7
2017,ISERE,Saint-Hilaire-du-Rosier,611,134,477,10,467,1,NPA,4,7.825,31.7
2017,ISERE,Saint-Hilaire-du-Rosier,611,134,477,10,467,1,PCF,4,7.825,31.7
2017,ISERE,Saint-Hilaire-du-Rosier,611,134,477,10,467,1,REC,33,7.825,31.7
2017,ISERE,Saint-Hilaire-du-Rosier,611,134,477,10,467,1,RES,23,7.825,31.7
2017,ISERE,Charvieu-Chavagneux,611,186,425,9,416,1,EELV,12,7.825,31.7
2017,ISERE,Charvieu-Chavagneux,611,186,425,9,416,1,FN,165,7.825,31.7
2017,ISERE,Charvieu-Chavagneux,611,186,425,9,416,1,LFI,71,7.825,31.7
2017,ISERE,Charvieu-Chavagneux,611,186,425,9,416,1,LO,4,7.825,31.7
2017,ISERE,Charvieu-Chavagneux,611,186,425,9,416,1,LR,4,7.825,31.7
2017,ISERE,Charvieu-Chavagneux,611,186,425,9,416,1,LREM,78,7.825,31.7
2017,ISERE,Charvieu-Chavagneux,611,186,425,9,416,1,NPA,2,7.825,31.7
2017,ISERE,Charvieu-Chavagneux,611,186,425,9,416,1,PCF,8,7.825,31.7
2017,ISERE,Charvieu-Chavagneux,611,186,425,9,416,1,REC,34,7.825,31.7
2017,ISERE,Charvieu-Chavagneux,611,186,425,9,416,1,RES,11,7.825,31.7
2017,ISERE,Pommier-de-Beaurepaire,612,144,468,17,451,1,EELV,19,7.825,31.7
2017,ISERE,Pommier-de-Beaurepaire,612,144,468,17,451,1,FN,145,7.825,31.7
2017,ISERE,Pommier-de-Beaurepaire,612,144,468,17,451,1,LFI,45,7.825,31.7
2017,ISERE,Pommier-de-Beaurepaire,612,144,468,17,451,1,LO,1,7.825,31.7
2017,ISERE,Pommier-de-Beaurepaire,612,144,468,17,451,1,LR,33,7.825,31.7
2017,ISERE,Pommier-de-Beaurepaire,612,144,468,17,451,1,LREM,112,7.825,31.7
2017,ISERE,Pommier-de-Beaurepaire,612,144,468,17,451,1,NPA,1,7.825,31.7
2017,ISERE,Pommier-de-Beaurepaire,612,144,468,17,451,1,PCF,15,7.825,31.7
2017,ISERE,Pommier-de-Beaurepaire,612,144,468,17,451,1,REC,41,7.825,31.7
2017,ISERE,Pommier-de-Beaurepaire,612,144,468,17,451,1,RES,19,7.825,31.7
2017,ISERE,Venon,613,68,545,10,535,1,EELV,53,7.825,31.7
2017,ISERE,Venon,613,68,545,10,535,1,FN,63,7.825,31.7
2017,ISERE,Venon,613,68,545,10,535,1,LFI,141,7.825,31.7
2017,ISERE,Venon,613,68,545,10,535,1,LO,1,7.825,31.7
2017,ISERE,Venon,613,68,545,10,535,1,LR,26,7.825,31.7
2017,ISERE,Venon,613,68,545,10,535,1,LREM,164,7.825,31.7
2017,ISERE,Venon,613,68,545,10,535,1,NPA,4,7.825,31.7
2017,ISERE,Venon,613,68,545,10,535,1,PCF,14,7.825,31.7
2017,ISERE,Venon,613,68,545,10,535,1,REC,34,7.825,31.7
2017,ISERE,Venon,613,68,545,10,535,1,RES,15,7.825,31.7
2017,ISERE,Vienne,615,153,462,12,450,1,EELV,27,7.825,31.7
2017,ISERE,Vienne,615,153,462,12,450,1,FN,63,7.825,31.7
2017,ISERE,Vienne,615,153,462,12,450,1,LFI,129,7.825,31.7
2017,ISERE,Vienne,615,153,462,12,450,1,LO,2,7.825,31.7
2017,ISERE,Vienne,615,153,462,12,450,1,LR,26,7.825,31.7
2017,ISERE,Vienne,615,153,462,12,450,1,LREM,118,7.825,31.7
2017,ISERE,Vienne,615,153,462,12,450,1,NPA,1,7.825,31.7
2017,ISERE,Vienne,615,153,462,12,450,1,PCF,17,7.825,31.7
2017,ISERE,Vienne,615,153,462,12,450,1,REC,40,7.825,31.7
2017,ISERE,Vienne,615,153,462,12,450,1,RES,9,7.825,31.7
2017,ISERE,Châteauvilain,616,125,491,10,481,1,EELV,32,7.825,31.7
2017,ISERE,Châteauvilain,616,125,491,10,481,1,FN,164,7.825,31.7
2017,ISERE,Châteauvilain,616,125,491,10,481,1,LFI,65,7.825,31.7
2017,ISERE,Châteauvilain,616,125,491,10,481,1,LO,2,7.825,31.7
2017,ISERE,Châteauvilain,616,125,491,10,481,1,LR,21,7.825,31.7
2017,ISERE,Châteauvilain,616,125,491,10,481,1,LREM,112,7.825,31.7
2017,ISERE,Châteauvilain,616,125,491,10,481,1,NPA,4,7.825,31.7
2017,ISERE,Châteauvilain,616,125,491,10,481,1,PCF,8,7.825,31.7
2017,ISERE,Châteauvilain,616,125,491,10,481,1,REC,31,7.825,31.7
2017,ISERE,Châteauvilain,616,125,491,10,481,1,RES,21,7.825,31.7
2017,ISERE,Septème,617,128,489,8,481,1,EELV,20,7.825,31.7
2017,ISERE,Septème,617,128,489,8,481,1,FN,193,7.825,31.7
2017,ISERE,Septème,617,128,489,8,481,1,LFI,46,7.825,31.7
2017,ISERE,Septème,617,128,489,8,481,1,LO,5,7.825,31.7
2017,ISERE,Septème,617,128,489,8,481,1,LR,14,7.825,31.7
2017,ISERE,Septème,617,128,489,8,481,1,LREM,124,7.825,31.7
2017,ISERE,Septème,617,128,489,8,481,1,NPA,2,7.825,31.7
2017,ISERE,Septème,617,128,489,8,481,1,PCF,6,7.825,31.7
2017,ISERE,Septème,617,128,489,8,481,1,REC,38,7.825,31.7
2017,ISERE,Septème,617,128,489,8,481,1,RES,10,7.825,31.7
2017,ISERE,Dizimieu,619,118,501,9,492,1,EELV,30,7.825,31.7
2017,ISERE,Dizimieu,619,118,501,9,492,1,FN,158,7.825,31.7
2017,ISERE,Dizimieu,619,118,501,9,492,1,LFI,82,7.825,31.7
2017,ISERE,Dizimieu,619,118,501,9,492,1,LO,0,7.825,31.7
2017,ISERE,Dizimieu,619,118,501,9,492,1,LR,17,7.825,31.7
2017,ISERE,Dizimieu,619,118,501,9,492,1,LREM,135,7.825,31.7
2017,ISERE,Dizimieu,619,118,501,9,492,1,NPA,2,7.825,31.7
2017,ISERE,Dizimieu,619,118,501,9,492,1,PCF,10,7.825,31.7
2017,ISERE,Dizimieu,619,118,501,9,492,1,REC,34,7.825,31.7
2017,ISERE,Dizimieu,619,118,501,9,492,1,RES,10,7.825,31.7
2017,ISERE,Vif,620,122,498,8,490,1,EELV,17,7.825,31.7
2017,ISERE,Vif,620,122,498,8,490,1,FN,144,7.825,31.7
2017,ISERE,Vif,620,122,498,8,490,1,LFI,90,7.825,31.7
2017,ISERE,Vif,620,122,498,8,490,1,LO,0,7.825,31.7
2017,ISERE,Vif,620,122,498,8,490,1,LR,8,7.825,31.7
2017,ISERE,Vif,620,122,498,8,490,1,LREM,135,7.825,31.7
2017,ISERE,Vif,620,122,498,8,490,1,NPA,8,7.825,31.7
2017,ISERE,Vif,620,122,498,8,490,1,PCF,18,7.825,31.7
2017,ISERE,Vif,620,122,498,8,490,1,REC,31,7.825,31.7
2017,ISERE,Vif,620,122,498,8,490,1,RES,25,7.825,31.7
2017,ISERE,Pont-en-Royans,620,152,468,8,460,1,EELV,28,7.825,31.7
2017,ISERE,Pont-en-Royans,620,152,468,8,460,1,FN,81,7.825,31.7
2017,ISERE,Pont-en-Royans,620,152,468,8,460,1,LFI,174,7.825,31.7
2017,ISERE,Pont-en-Royans,620,152,468,8,460,1,LO,5,7.825,31.7
2017,ISERE,Pont-en-Royans,620,152,468,8,460,1,LR,16,7.825,31.7
2017,ISERE,Pont-en-Royans,620,152,468,8,460,1,LREM,95,7.825,31.7
2017,ISERE,Pont-en-Royans,620,152,468,8,460,1,NPA,5,7.825,31.7
2017,ISERE,Pont-en-Royans,620,152,468,8,460,1,PCF,11,7.825,31.7
2017,ISERE,Pont-en-Royans,620,152,468,8,460,1,REC,18,7.825,31.7
2017,ISERE,Pont-en-Royans,620,152,468,8,460,1,RES,14,7.825,31.7
2017,ISERE,Vienne,620,190,430,10,420,1,EELV,17,7.825,31.7
2017,ISERE,Vienne,620,190,430,10,420,1,FN,85,7.825,31.7
2017,ISERE,Vienne,620,190,430,10,420,1,LFI,134,7.825,31.7
2017,ISERE,Vienne,620,190,430,10,420,1,LO,2,7.825,31.7
2017,ISERE,Vienne,620,190,430,10,420,1,LR,10,7.825,31.7
2017,ISERE,Vienne,620,190,430,10,420,1,LREM,96,7.825,31.7
2017,ISERE,Vienne,620,190,430,10,420,1,NPA,3,7.825,31.7
2017,ISERE,Vienne,620,190,430,10,420,1,PCF,10,7.825,31.7
2017,ISERE,Vienne,620,190,430,10,420,1,REC,33,7.825,31.7
2017,ISERE,Vienne,620,190,430,10,420,1,RES,11,7.825,31.7
2017,ISERE,Vénérieu,624,96,528,16,512,1,EELV,40,7.825,31.7
2017,ISERE,Vénérieu,624,96,528,16,512,1,FN,170,7.825,31.7
2017,ISERE,Vénérieu,624,96,528,16,512,1,LFI,47,7.825,31.7
2017,ISERE,Vénérieu,624,96,528,16,512,1,LO,2,7.825,31.7
2017,ISERE,Vénérieu,624,96,528,16,512,1,LR,19,7.825,31.7
2017,ISERE,Vénérieu,624,96,528,16,512,1,LREM,134,7.825,31.7
2017,ISERE,Vénérieu,624,96,528,16,512,1,NPA,1,7.825,31.7
2017,ISERE,Vénérieu,624,96,528,16,512,1,PCF,5,7.825,31.7
2017,ISERE,Vénérieu,624,96,528,16,512,1,REC,49,7.825,31.7
2017,ISERE,Vénérieu,624,96,528,16,512,1,RES,18,7.825,31.7
2017,ISERE,Voreppe,625,139,486,6,480,1,EELV,34,7.825,31.7
2017,ISERE,Voreppe,625,139,486,6,480,1,FN,84,7.825,31.7
2017,ISERE,Voreppe,625,139,486,6,480,1,LFI,101,7.825,31.7
2017,ISERE,Voreppe,625,139,486,6,480,1,LO,0,7.825,31.7
2017,ISERE,Voreppe,625,139,486,6,480,1,LR,26,7.825,31.7
2017,ISERE,Voreppe,625,139,486,6,480,1,LREM,170,7.825,31.7
2017,ISERE,Voreppe,625,139,486,6,480,1,NPA,1,7.825,31.7
2017,ISERE,Voreppe,625,139,486,6,480,1,PCF,9,7.825,31.7
2017,ISERE,Voreppe,625,139,486,6,480,1,REC,27,7.825,31.7
2017,ISERE,Voreppe,625,139,486,6,480,1,RES,9,7.825,31.7
2017,ISERE,Saint-Martin-d'Hères,627,148,479,8,471,1,EELV,21,7.825,31.7
2017,ISERE,Saint-Martin-d'Hères,627,148,479,8,471,1,FN,107,7.825,31.7
2017,ISERE,Saint-Martin-d'Hères,627,148,479,8,471,1,LFI,129,7.825,31.7
2017,ISERE,Saint-Martin-d'Hères,627,148,479,8,471,1,LO,2,7.825,31.7
2017,ISERE,Saint-Martin-d'Hères,627,148,479,8,471,1,LR,9,7.825,31.7
2017,ISERE,Saint-Martin-d'Hères,627,148,479,8,471,1,LREM,119,7.825,31.7
2017,ISERE,Saint-Martin-d'Hères,627,148,479,8,471,1,NPA,2,7.825,31.7
2017,ISERE,Saint-Martin-d'Hères,627,148,479,8,471,1,PCF,17,7.825,31.7
2017,ISERE,Saint-Martin-d'Hères,627,148,479,8,471,1,REC,39,7.825,31.7
2017,ISERE,Saint-Martin-d'Hères,627,148,479,8,471,1,RES,12,7.825,31.7
2017,ISERE,Vienne,628,273,355,6,349,1,EELV,5,7.825,31.7
2017,ISERE,Vienne,628,273,355,6,349,1,FN,58,7.825,31.7
2017,ISERE,Vienne,628,273,355,6,349,1,LFI,183,7.825,31.7
2017,ISERE,Vienne,628,273,355,6,349,1,LO,0,7.825,31.7
2017,ISERE,Vienne,628,273,355,6,349,1,LR,8,7.825,31.7
2017,ISERE,Vienne,628,273,355,6,349,1,LREM,65,7.825,31.7
2017,ISERE,Vienne,628,273,355,6,349,1,NPA,3,7.825,31.7
2017,ISERE,Vienne,628,273,355,6,349,1,PCF,4,7.825,31.7
2017,ISERE,Vienne,628,273,355,6,349,1,REC,13,7.825,31.7
2017,ISERE,Vienne,628,273,355,6,349,1,RES,1,7.825,31.7
2017,ISERE,Charvieu-Chavagneux,629,114,515,15,500,1,EELV,13,7.825,31.7
2017,ISERE,Charvieu-Chavagneux,629,114,515,15,500,1,FN,143,7.825,31.7
2017,ISERE,Charvieu-Chavagneux,629,114,515,15,500,1,LFI,151,7.825,31.7
2017,ISERE,Charvieu-Chavagneux,629,114,515,15,500,1,LO,1,7.825,31.7
2017,ISERE,Charvieu-Chavagneux,629,114,515,15,500,1,LR,16,7.825,31.7
2017,ISERE,Charvieu-Chavagneux,629,114,515,15,500,1,LREM,105,7.825,31.7
2017,ISERE,Charvieu-Chavagneux,629,114,515,15,500,1,NPA,1,7.825,31.7
2017,ISERE,Charvieu-Chavagneux,629,114,515,15,500,1,PCF,4,7.825,31.7
2017,ISERE,Charvieu-Chavagneux,629,114,515,15,500,1,REC,39,7.825,31.7
2017,ISERE,Charvieu-Chavagneux,629,114,515,15,500,1,RES,9,7.825,31.7
2017,ISERE,Villemoirieu,632,92,540,20,520,1,EELV,36,7.825,31.7
2017,ISERE,Villemoirieu,632,92,540,20,520,1,FN,99,7.825,31.7
2017,ISERE,Villemoirieu,632,92,540,20,520,1,LFI,97,7.825,31.7
2017,ISERE,Villemoirieu,632,92,540,20,520,1,LO,1,7.825,31.7
2017,ISERE,Villemoirieu,632,92,540,20,520,1,LR,24,7.825,31.7
2017,ISERE,Villemoirieu,632,92,540,20,520,1,LREM,167,7.825,31.7
2017,ISERE,Villemoirieu,632,92,540,20,520,1,NPA,2,7.825,31.7
2017,ISERE,Villemoirieu,632,92,540,20,520,1,PCF,14,7.825,31.7
2017,ISERE,Villemoirieu,632,92,540,20,520,1,REC,48,7.825,31.7
2017,ISERE,Villemoirieu,632,92,540,20,520,1,RES,16,7.825,31.7
2017,ISERE,Charvieu-Chavagneux,636,112,524,10,514,1,EELV,17,7.825,31.7
2017,ISERE,Charvieu-Chavagneux,636,112,524,10,514,1,FN,179,7.825,31.7
2017,ISERE,Charvieu-Chavagneux,636,112,524,10,514,1,LFI,62,7.825,31.7
2017,ISERE,Charvieu-Chavagneux,636,112,524,10,514,1,LO,2,7.825,31.7
2017,ISERE,Charvieu-Chavagneux,636,112,524,10,514,1,LR,21,7.825,31.7
2017,ISERE,Charvieu-Chavagneux,636,112,524,10,514,1,LREM,111,7.825,31.7
2017,ISERE,Charvieu-Chavagneux,636,112,524,10,514,1,NPA,4,7.825,31.7
2017,ISERE,Charvieu-Chavagneux,636,112,524,10,514,1,PCF,9,7.825,31.7
2017,ISERE,Charvieu-Chavagneux,636,112,524,10,514,1,REC,74,7.825,31.7
2017,ISERE,Charvieu-Chavagneux,636,112,524,10,514,1,RES,17,7.825,31.7
2017,ISERE,Saint-Egrève,637,120,517,7,510,1,EELV,56,7.825,31.7
2017,ISERE,Saint-Egrève,637,120,517,7,510,1,FN,38,7.825,31.7
2017,ISERE,Saint-Egrève,637,120,517,7,510,1,LFI,116,7.825,31.7
2017,ISERE,Saint-Egrève,637,120,517,7,510,1,LO,1,7.825,31.7
2017,ISERE,Saint-Egrève,637,120,517,7,510,1,LR,17,7.825,31.7
2017,ISERE,Saint-Egrève,637,120,517,7,510,1,LREM,201,7.825,31.7
2017,ISERE,Saint-Egrève,637,120,517,7,510,1,NPA,2,7.825,31.7
2017,ISERE,Saint-Egrève,637,120,517,7,510,1,PCF,12,7.825,31.7
2017,ISERE,Saint-Egrève,637,120,517,7,510,1,REC,34,7.825,31.7
2017,ISERE,Saint-Egrève,637,120,517,7,510,1,RES,6,7.825,31.7
2017,ISERE,Fontaine,637,153,484,7,477,1,EELV,30,7.825,31.7
2017,ISERE,Fontaine,637,153,484,7,477,1,FN,73,7.825,31.7
2017,ISERE,Fontaine,637,153,484,7,477,1,LFI,164,7.825,31.7
2017,ISERE,Fontaine,637,153,484,7,477,1,LO,2,7.825,31.7
2017,ISERE,Fontaine,637,153,484,7,477,1,LR,17,7.825,31.7
2017,ISERE,Fontaine,637,153,484,7,477,1,LREM,107,7.825,31.7
2017,ISERE,Fontaine,637,153,484,7,477,1,NPA,1,7.825,31.7
2017,ISERE,Fontaine,637,153,484,7,477,1,PCF,25,7.825,31.7
2017,ISERE,Fontaine,637,153,484,7,477,1,REC,31,7.825,31.7
2017,ISERE,Fontaine,637,153,484,7,477,1,RES,11,7.825,31.7
2017,ISERE,Grenoble,640,251,389,10,379,1,EELV,12,7.825,31.7
2017,ISERE,Grenoble,640,251,389,10,379,1,FN,36,7.825,31.7
2017,ISERE,Grenoble,640,251,389,10,379,1,LFI,182,7.825,31.7
2017,ISERE,Grenoble,640,251,389,10,379,1,LO,3,7.825,31.7
2017,ISERE,Grenoble,640,251,389,10,379,1,LR,4,7.825,31.7
2017,ISERE,Grenoble,640,251,389,10,379,1,LREM,101,7.825,31.7
2017,ISERE,Grenoble,640,251,389,10,379,1,NPA,0,7.825,31.7
2017,ISERE,Grenoble,640,251,389,10,379,1,PCF,13,7.825,31.7
2017,ISERE,Grenoble,640,251,389,10,379,1,REC,16,7.825,31.7
2017,ISERE,Grenoble,640,251,389,10,379,1,RES,3,7.825,31.7
2017,ISERE,Leyrieu,641,135,506,7,499,1,EELV,21,7.825,31.7
2017,ISERE,Leyrieu,641,135,506,7,499,1,FN,142,7.825,31.7
2017,ISERE,Leyrieu,641,135,506,7,499,1,LFI,91,7.825,31.7
2017,ISERE,Leyrieu,641,135,506,7,499,1,LO,1,7.825,31.7
2017,ISERE,Leyrieu,641,135,506,7,499,1,LR,18,7.825,31.7
2017,ISERE,Leyrieu,641,135,506,7,499,1,LREM,117,7.825,31.7
2017,ISERE,Leyrieu,641,135,506,7,499,1,NPA,5,7.825,31.7
2017,ISERE,Leyrieu,641,135,506,7,499,1,PCF,12,7.825,31.7
2017,ISERE,Leyrieu,641,135,506,7,499,1,REC,48,7.825,31.7
2017,ISERE,Leyrieu,641,135,506,7,499,1,RES,16,7.825,31.7
2017,ISERE,Pact,643,106,537,17,520,1,EELV,10,7.825,31.7
2017,ISERE,Pact,643,106,537,17,520,1,FN,205,7.825,31.7
2017,ISERE,Pact,643,106,537,17,520,1,LFI,86,7.825,31.7
2017,ISERE,Pact,643,106,537,17,520,1,LO,3,7.825,31.7
2017,ISERE,Pact,643,106,537,17,520,1,LR,16,7.825,31.7
2017,ISERE,Pact,643,106,537,17,520,1,LREM,107,7.825,31.7
2017,ISERE,Pact,643,106,537,17,520,1,NPA,5,7.825,31.7
2017,ISERE,Pact,643,106,537,17,520,1,PCF,7,7.825,31.7
2017,ISERE,Pact,643,106,537,17,520,1,REC,37,7.825,31.7
2017,ISERE,Pact,643,106,537,17,520,1,RES,17,7.825,31.7
2017,ISERE,Soleymieu,650,111,539,11,528,1,EELV,30,7.825,31.7
2017,ISERE,Soleymieu,650,111,539,11,528,1,FN,193,7.825,31.7
2017,ISERE,Soleymieu,650,111,539,11,528,1,LFI,56,7.825,31.7
2017,ISERE,Soleymieu,650,111,539,11,528,1,LO,5,7.825,31.7
2017,ISERE,Soleymieu,650,111,539,11,528,1,LR,27,7.825,31.7
2017,ISERE,Soleymieu,650,111,539,11,528,1,LREM,124,7.825,31.7
2017,ISERE,Soleymieu,650,111,539,11,528,1,NPA,6,7.825,31.7
2017,ISERE,Soleymieu,650,111,539,11,528,1,PCF,9,7.825,31.7
2017,ISERE,Soleymieu,650,111,539,11,528,1,REC,31,7.825,31.7
2017,ISERE,Soleymieu,650,111,539,11,528,1,RES,19,7.825,31.7
2017,ISERE,Artas,650,125,525,14,511,1,EELV,23,7.825,31.7
2017,ISERE,Artas,650,125,525,14,511,1,FN,197,7.825,31.7
2017,ISERE,Artas,650,125,525,14,511,1,LFI,57,7.825,31.7
2017,ISERE,Artas,650,125,525,14,511,1,LO,2,7.825,31.7
2017,ISERE,Artas,650,125,525,14,511,1,LR,19,7.825,31.7
2017,ISERE,Artas,650,125,525,14,511,1,LREM,121,7.825,31.7
2017,ISERE,Artas,650,125,525,14,511,1,NPA,4,7.825,31.7
2017,ISERE,Artas,650,125,525,14,511,1,PCF,7,7.825,31.7
2017,ISERE,Artas,650,125,525,14,511,1,REC,42,7.825,31.7
2017,ISERE,Artas,650,125,525,14,511,1,RES,16,7.825,31.7
2017,ISERE,Saint-Martin-d'Hères,650,165,485,5,480,1,EELV,30,7.825,31.7
2017,ISERE,Saint-Martin-d'Hères,650,165,485,5,480,1,FN,85,7.825,31.7
2017,ISERE,Saint-Martin-d'Hères,650,165,485,5,480,1,LFI,159,7.825,31.7
2017,ISERE,Saint-Martin-d'Hères,650,165,485,5,480,1,LO,1,7.825,31.7
2017,ISERE,Saint-Martin-d'Hères,650,165,485,5,480,1,LR,6,7.825,31.7
2017,ISERE,Saint-Martin-d'Hères,650,165,485,5,480,1,LREM,123,7.825,31.7
2017,ISERE,Saint-Martin-d'Hères,650,165,485,5,480,1,NPA,5,7.825,31.7
2017,ISERE,Saint-Martin-d'Hères,650,165,485,5,480,1,PCF,21,7.825,31.7
2017,ISERE,Saint-Martin-d'Hères,650,165,485,5,480,1,REC,30,7.825,31.7
2017,ISERE,Saint-Martin-d'Hères,650,165,485,5,480,1,RES,6,7.825,31.7
2017,ISERE,Charancieu,651,141,510,16,494,1,EELV,14,7.825,31.7
2017,ISERE,Charancieu,651,141,510,16,494,1,FN,164,7.825,31.7
2017,ISERE,Charancieu,651,141,510,16,494,1,LFI,88,7.825,31.7
2017,ISERE,Charancieu,651,141,510,16,494,1,LO,1,7.825,31.7
2017,ISERE,Charancieu,651,141,510,16,494,1,LR,25,7.825,31.7
2017,ISERE,Charancieu,651,141,510,16,494,1,LREM,115,7.825,31.7
2017,ISERE,Charancieu,651,141,510,16,494,1,NPA,3,7.825,31.7
2017,ISERE,Charancieu,651,141,510,16,494,1,PCF,3,7.825,31.7
2017,ISERE,Charancieu,651,141,510,16,494,1,REC,42,7.825,31.7
2017,ISERE,Charancieu,651,141,510,16,494,1,RES,14,7.825,31.7
2017,ISERE,Seyssinet-Pariset,651,141,510,16,494,1,EELV,35,7.825,31.7
2017,ISERE,Seyssinet-Pariset,651,141,510,16,494,1,FN,111,7.825,31.7
2017,ISERE,Seyssinet-Pariset,651,141,510,16,494,1,LFI,112,7.825,31.7
2017,ISERE,Seyssinet-Pariset,651,141,510,16,494,1,LO,2,7.825,31.7
2017,ISERE,Seyssinet-Pariset,651,141,510,16,494,1,LR,14,7.825,31.7
2017,ISERE,Seyssinet-Pariset,651,141,510,16,494,1,LREM,133,7.825,31.7
2017,ISERE,Seyssinet-Pariset,651,141,510,16,494,1,NPA,3,7.825,31.7
2017,ISERE,Seyssinet-Pariset,651,141,510,16,494,1,PCF,15,7.825,31.7
2017,ISERE,Seyssinet-Pariset,651,141,510,16,494,1,REC,30,7.825,31.7
2017,ISERE,Seyssinet-Pariset,651,141,510,16,494,1,RES,18,7.825,31.7
2017,ISERE,Grenoble,653,157,496,7,489,1,EELV,45,7.825,31.7
2017,ISERE,Grenoble,653,157,496,7,489,1,FN,46,7.825,31.7
2017,ISERE,Grenoble,653,157,496,7,489,1,LFI,238,7.825,31.7
2017,ISERE,Grenoble,653,157,496,7,489,1,LO,2,7.825,31.7
2017,ISERE,Grenoble,653,157,496,7,489,1,LR,13,7.825,31.7
2017,ISERE,Grenoble,653,157,496,7,489,1,LREM,95,7.825,31.7
2017,ISERE,Grenoble,653,157,496,7,489,1,NPA,3,7.825,31.7
2017,ISERE,Grenoble,653,157,496,7,489,1,PCF,11,7.825,31.7
2017,ISERE,Grenoble,653,157,496,7,489,1,REC,22,7.825,31.7
2017,ISERE,Grenoble,653,157,496,7,489,1,RES,6,7.825,31.7
2017,ISERE,Saint-Baudille-de-la-Tour,655,130,525,17,508,1,EELV,21,7.825,31.7
2017,ISERE,Saint-Baudille-de-la-Tour,655,130,525,17,508,1,FN,176,7.825,31.7
2017,ISERE,Saint-Baudille-de-la-Tour,655,130,525,17,508,1,LFI,75,7.825,31.7
2017,ISERE,Saint-Baudille-de-la-Tour,655,130,525,17,508,1,LO,3,7.825,31.7
2017,ISERE,Saint-Baudille-de-la-Tour,655,130,525,17,508,1,LR,23,7.825,31.7
2017,ISERE,Saint-Baudille-de-la-Tour,655,130,525,17,508,1,LREM,107,7.825,31.7
2017,ISERE,Saint-Baudille-de-la-Tour,655,130,525,17,508,1,NPA,1,7.825,31.7
2017,ISERE,Saint-Baudille-de-la-Tour,655,130,525,17,508,1,PCF,11,7.825,31.7
2017,ISERE,Saint-Baudille-de-la-Tour,655,130,525,17,508,1,REC,48,7.825,31.7
2017,ISERE,Saint-Baudille-de-la-Tour,655,130,525,17,508,1,RES,19,7.825,31.7
2017,ISERE,Saint-Egrève,657,185,472,13,459,1,EELV,18,7.825,31.7
2017,ISERE,Saint-Egrève,657,185,472,13,459,1,FN,101,7.825,31.7
2017,ISERE,Saint-Egrève,657,185,472,13,459,1,LFI,127,7.825,31.7
2017,ISERE,Saint-Egrève,657,185,472,13,459,1,LO,4,7.825,31.7
2017,ISERE,Saint-Egrève,657,185,472,13,459,1,LR,18,7.825,31.7
2017,ISERE,Saint-Egrève,657,185,472,13,459,1,LREM,116,7.825,31.7
2017,ISERE,Saint-Egrève,657,185,472,13,459,1,NPA,3,7.825,31.7
2017,ISERE,Saint-Egrève,657,185,472,13,459,1,PCF,20,7.825,31.7
2017,ISERE,Saint-Egrève,657,185,472,13,459,1,REC,31,7.825,31.7
2017,ISERE,Saint-Egrève,657,185,472,13,459,1,RES,6,7.825,31.7
2017,ISERE,Janneyrias,658,106,552,8,544,1,EELV,32,7.825,31.7
2017,ISERE,Janneyrias,658,106,552,8,544,1,FN,184,7.825,31.7
2017,ISERE,Janneyrias,658,106,552,8,544,1,LFI,87,7.825,31.7
2017,ISERE,Janneyrias,658,106,552,8,544,1,LO,2,7.825,31.7
2017,ISERE,Janneyrias,658,106,552,8,544,1,LR,28,7.825,31.7
2017,ISERE,Janneyrias,658,106,552,8,544,1,LREM,127,7.825,31.7
2017,ISERE,Janneyrias,658,106,552,8,544,1,NPA,1,7.825,31.7
2017,ISERE,Janneyrias,658,106,552,8,544,1,PCF,2,7.825,31.7
2017,ISERE,Janneyrias,658,106,552,8,544,1,REC,50,7.825,31.7
2017,ISERE,Janneyrias,658,106,552,8,544,1,RES,10,7.825,31.7
2017,ISERE,Saint-Honoré,659,109,550,21,529,1,EELV,32,7.825,31.7
2017,ISERE,Saint-Honoré,659,109,550,21,529,1,FN,139,7.825,31.7
2017,ISERE,Saint-Honoré,659,109,550,21,529,1,LFI,121,7.825,31.7
2017,ISERE,Saint-Honoré,659,109,550,21,529,1,LO,7,7.825,31.7
2017,ISERE,Saint-Honoré,659,109,550,21,529,1,LR,17,7.825,31.7
2017,ISERE,Saint-Honoré,659,109,550,21,529,1,LREM,123,7.825,31.7
2017,ISERE,Saint-Honoré,659,109,550,21,529,1,NPA,10,7.825,31.7
2017,ISERE,Saint-Honoré,659,109,550,21,529,1,PCF,11,7.825,31.7
2017,ISERE,Saint-Honoré,659,109,550,21,529,1,REC,23,7.825,31.7
2017,ISERE,Saint-Honoré,659,109,550,21,529,1,RES,22,7.825,31.7
2017,ISERE,Montbonnot-Saint-Martin,660,79,581,4,577,1,EELV,54,7.825,31.7
2017,ISERE,Montbonnot-Saint-Martin,660,79,581,4,577,1,FN,84,7.825,31.7
2017,ISERE,Montbonnot-Saint-Martin,660,79,581,4,577,1,LFI,71,7.825,31.7
2017,ISERE,Montbonnot-Saint-Martin,660,79,581,4,577,1,LO,3,7.825,31.7
2017,ISERE,Montbonnot-Saint-Martin,660,79,581,4,577,1,LR,36,7.825,31.7
2017,ISERE,Montbonnot-Saint-Martin,660,79,581,4,577,1,LREM,257,7.825,31.7
2017,ISERE,Montbonnot-Saint-Martin,660,79,581,4,577,1,NPA,2,7.825,31.7
2017,ISERE,Montbonnot-Saint-Martin,660,79,581,4,577,1,PCF,2,7.825,31.7
2017,ISERE,Montbonnot-Saint-Martin,660,79,581,4,577,1,REC,41,7.825,31.7
2017,ISERE,Montbonnot-Saint-Martin,660,79,581,4,577,1,RES,5,7.825,31.7
2017,ISERE,Saint-Christophe-sur-Guiers,661,102,559,11,548,1,EELV,30,7.825,31.7
2017,ISERE,Saint-Christophe-sur-Guiers,661,102,559,11,548,1,FN,143,7.825,31.7
2017,ISERE,Saint-Christophe-sur-Guiers,661,102,559,11,548,1,LFI,120,7.825,31.7
2017,ISERE,Saint-Christophe-sur-Guiers,661,102,559,11,548,1,LO,3,7.825,31.7
2017,ISERE,Saint-Christophe-sur-Guiers,661,102,559,11,548,1,LR,21,7.825,31.7
2017,ISERE,Saint-Christophe-sur-Guiers,661,102,559,11,548,1,LREM,123,7.825,31.7
2017,ISERE,Saint-Christophe-sur-Guiers,661,102,559,11,548,1,NPA,7,7.825,31.7
2017,ISERE,Saint-Christophe-sur-Guiers,661,102,559,11,548,1,PCF,15,7.825,31.7
2017,ISERE,Saint-Christophe-sur-Guiers,661,102,559,11,548,1,REC,41,7.825,31.7
2017,ISERE,Saint-Christophe-sur-Guiers,661,102,559,11,548,1,RES,20,7.825,31.7
2017,ISERE,Doissin,663,109,554,15,539,1,EELV,18,7.825,31.7
2017,ISERE,Doissin,663,109,554,15,539,1,FN,163,7.825,31.7
2017,ISERE,Doissin,663,109,554,15,539,1,LFI,71,7.825,31.7
2017,ISERE,Doissin,663,109,554,15,539,1,LO,4,7.825,31.7
2017,ISERE,Doissin,663,109,554,15,539,1,LR,30,7.825,31.7
2017,ISERE,Doissin,663,109,554,15,539,1,LREM,133,7.825,31.7
2017,ISERE,Doissin,663,109,554,15,539,1,NPA,4,7.825,31.7
2017,ISERE,Doissin,663,109,554,15,539,1,PCF,16,7.825,31.7
2017,ISERE,Doissin,663,109,554,15,539,1,REC,47,7.825,31.7
2017,ISERE,Doissin,663,109,554,15,539,1,RES,25,7.825,31.7
2017,ISERE,Murianette,664,102,562,14,548,1,EELV,23,7.825,31.7
2017,ISERE,Murianette,664,102,562,14,548,1,FN,130,7.825,31.7
2017,ISERE,Murianette,664,102,562,14,548,1,LFI,103,7.825,31.7
2017,ISERE,Murianette,664,102,562,14,548,1,LO,2,7.825,31.7
2017,ISERE,Murianette,664,102,562,14,548,1,LR,25,7.825,31.7
2017,ISERE,Murianette,664,102,562,14,548,1,LREM,158,7.825,31.7
2017,ISERE,Murianette,664,102,562,14,548,1,NPA,1,7.825,31.7
2017,ISERE,Murianette,664,102,562,14,548,1,PCF,10,7.825,31.7
2017,ISERE,Murianette,664,102,562,14,548,1,REC,55,7.825,31.7
2017,ISERE,Murianette,664,102,562,14,548,1,RES,15,7.825,31.7
2017,ISERE,Optevoz,664,125,539,15,524,1,EELV,19,7.825,31.7
2017,ISERE,Optevoz,664,125,539,15,524,1,FN,189,7.825,31.7
2017,ISERE,Optevoz,664,125,539,15,524,1,LFI,84,7.825,31.7
2017,ISERE,Optevoz,664,125,539,15,524,1,LO,1,7.825,31.7
2017,ISERE,Optevoz,664,125,539,15,524,1,LR,23,7.825,31.7
2017,ISERE,Optevoz,664,125,539,15,524,1,LREM,103,7.825,31.7
2017,ISERE,Optevoz,664,125,539,15,524,1,NPA,3,7.825,31.7
2017,ISERE,Optevoz,664,125,539,15,524,1,PCF,17,7.825,31.7
2017,ISERE,Optevoz,664,125,539,15,524,1,REC,52,7.825,31.7
2017,ISERE,Optevoz,664,125,539,15,524,1,RES,9,7.825,31.7
2017,ISERE,Vienne,665,169,496,11,485,1,EELV,30,7.825,31.7
2017,ISERE,Vienne,665,169,496,11,485,1,FN,78,7.825,31.7
2017,ISERE,Vienne,665,169,496,11,485,1,LFI,117,7.825,31.7
2017,ISERE,Vienne,665,169,496,11,485,1,LO,2,7.825,31.7
2017,ISERE,Vienne,665,169,496,11,485,1,LR,25,7.825,31.7
2017,ISERE,Vienne,665,169,496,11,485,1,LREM,150,7.825,31.7
2017,ISERE,Vienne,665,169,496,11,485,1,NPA,0,7.825,31.7
2017,ISERE,Vienne,665,169,496,11,485,1,PCF,6,7.825,31.7
2017,ISERE,Vienne,665,169,496,11,485,1,REC,47,7.825,31.7
2017,ISERE,Vienne,665,169,496,11,485,1,RES,9,7.825,31.7
2017,ISERE,Les Abrets en Dauphiné,666,134,532,14,518,1,EELV,18,7.825,31.7
2017,ISERE,Les Abrets en Dauphiné,666,134,532,14,518,1,FN,160,7.825,31.7
2017,ISERE,Les Abrets en Dauphiné,666,134,532,14,518,1,LFI,112,7.825,31.7
2017,ISERE,Les Abrets en Dauphiné,666,134,532,14,518,1,LO,3,7.825,31.7
2017,ISERE,Les Abrets en Dauphiné,666,134,532,14,518,1,LR,21,7.825,31.7
2017,ISERE,Les Abrets en Dauphiné,666,134,532,14,518,1,LREM,104,7.825,31.7
2017,ISERE,Les Abrets en Dauphiné,666,134,532,14,518,1,NPA,2,7.825,31.7
2017,ISERE,Les Abrets en Dauphiné,666,134,532,14,518,1,PCF,16,7.825,31.7
2017,ISERE,Les Abrets en Dauphiné,666,134,532,14,518,1,REC,29,7.825,31.7
2017,ISERE,Les Abrets en Dauphiné,666,134,532,14,518,1,RES,25,7.825,31.7
2017,ISERE,Salaise-sur-Sanne,667,189,478,8,470,1,EELV,13,7.825,31.7
2017,ISERE,Salaise-sur-Sanne,667,189,478,8,470,1,FN,136,7.825,31.7
2017,ISERE,Salaise-sur-Sanne,667,189,478,8,470,1,LFI,107,7.825,31.7
2017,ISERE,Salaise-sur-Sanne,667,189,478,8,470,1,LO,3,7.825,31.7
2017,ISERE,Salaise-sur-Sanne,667,189,478,8,470,1,LR,8,7.825,31.7
2017,ISERE,Salaise-sur-Sanne,667,189,478,8,470,1,LREM,110,7.825,31.7
2017,ISERE,Salaise-sur-Sanne,667,189,478,8,470,1,NPA,3,7.825,31.7
2017,ISERE,Salaise-sur-Sanne,667,189,478,8,470,1,PCF,25,7.825,31.7
2017,ISERE,Salaise-sur-Sanne,667,189,478,8,470,1,REC,35,7.825,31.7
2017,ISERE,Salaise-sur-Sanne,667,189,478,8,470,1,RES,16,7.825,31.7
2017,ISERE,Saint-Quentin-Fallavier,671,127,544,12,532,1,EELV,15,7.825,31.7
2017,ISERE,Saint-Quentin-Fallavier,671,127,544,12,532,1,FN,173,7.825,31.7
2017,ISERE,Saint-Quentin-Fallavier,671,127,544,12,532,1,LFI,136,7.825,31.7
2017,ISERE,Saint-Quentin-Fallavier,671,127,544,12,532,1,LO,3,7.825,31.7
2017,ISERE,Saint-Quentin-Fallavier,671,127,544,12,532,1,LR,16,7.825,31.7
2017,ISERE,Saint-Quentin-Fallavier,671,127,544,12,532,1,LREM,92,7.825,31.7
2017,ISERE,Saint-Quentin-Fallavier,671,127,544,12,532,1,NPA,7,7.825,31.7
2017,ISERE,Saint-Quentin-Fallavier,671,127,544,12,532,1,PCF,18,7.825,31.7
2017,ISERE,Saint-Quentin-Fallavier,671,127,544,12,532,1,REC,29,7.825,31.7
2017,ISERE,Saint-Quentin-Fallavier,671,127,544,12,532,1,RES,11,7.825,31.7
2017,ISERE,Grenoble,672,162,510,5,505,1,EELV,44,7.825,31.7
2017,ISERE,Grenoble,672,162,510,5,505,1,FN,62,7.825,31.7
2017,ISERE,Grenoble,672,162,510,5,505,1,LFI,175,7.825,31.7
2017,ISERE,Grenoble,672,162,510,5,505,1,LO,0,7.825,31.7
2017,ISERE,Grenoble,672,162,510,5,505,1,LR,21,7.825,31.7
2017,ISERE,Grenoble,672,162,510,5,505,1,LREM,129,7.825,31.7
2017,ISERE,Grenoble,672,162,510,5,505,1,NPA,7,7.825,31.7
2017,ISERE,Grenoble,672,162,510,5,505,1,PCF,9,7.825,31.7
2017,ISERE,Grenoble,672,162,510,5,505,1,REC,32,7.825,31.7
2017,ISERE,Grenoble,672,162,510,5,505,1,RES,5,7.825,31.7
2017,ISERE,Montbonnot-Saint-Martin,675,109,566,9,557,1,EELV,41,7.825,31.7
2017,ISERE,Montbonnot-Saint-Martin,675,109,566,9,557,1,FN,57,7.825,31.7
2017,ISERE,Montbonnot-Saint-Martin,675,109,566,9,557,1,LFI,88,7.825,31.7
2017,ISERE,Montbonnot-Saint-Martin,675,109,566,9,557,1,LO,0,7.825,31.7
2017,ISERE,Montbonnot-Saint-Martin,675,109,566,9,557,1,LR,49,7.825,31.7
2017,ISERE,Montbonnot-Saint-Martin,675,109,566,9,557,1,LREM,232,7.825,31.7
2017,ISERE,Montbonnot-Saint-Martin,675,109,566,9,557,1,NPA,5,7.825,31.7
2017,ISERE,Montbonnot-Saint-Martin,675,109,566,9,557,1,PCF,5,7.825,31.7
2017,ISERE,Montbonnot-Saint-Martin,675,109,566,9,557,1,REC,50,7.825,31.7
2017,ISERE,Montbonnot-Saint-Martin,675,109,566,9,557,1,RES,13,7.825,31.7
2017,ISERE,Cour-et-Buis,675,136,539,9,530,1,EELV,27,7.825,31.7
2017,ISERE,Cour-et-Buis,675,136,539,9,530,1,FN,160,7.825,31.7
2017,ISERE,Cour-et-Buis,675,136,539,9,530,1,LFI,92,7.825,31.7
2017,ISERE,Cour-et-Buis,675,136,539,9,530,1,LO,3,7.825,31.7
2017,ISERE,Cour-et-Buis,675,136,539,9,530,1,LR,23,7.825,31.7
2017,ISERE,Cour-et-Buis,675,136,539,9,530,1,LREM,117,7.825,31.7
2017,ISERE,Cour-et-Buis,675,136,539,9,530,1,NPA,4,7.825,31.7
2017,ISERE,Cour-et-Buis,675,136,539,9,530,1,PCF,11,7.825,31.7
2017,ISERE,Cour-et-Buis,675,136,539,9,530,1,REC,49,7.825,31.7
2017,ISERE,Cour-et-Buis,675,136,539,9,530,1,RES,17,7.825,31.7
2017,ISERE,Saint-Barthélemy,675,154,521,12,509,1,EELV,15,7.825,31.7
2017,ISERE,Saint-Barthélemy,675,154,521,12,509,1,FN,166,7.825,31.7
2017,ISERE,Saint-Barthélemy,675,154,521,12,509,1,LFI,101,7.825,31.7
2017,ISERE,Saint-Barthélemy,675,154,521,12,509,1,LO,0,7.825,31.7
2017,ISERE,Saint-Barthélemy,675,154,521,12,509,1,LR,13,7.825,31.7
2017,ISERE,Saint-Barthélemy,675,154,521,12,509,1,LREM,111,7.825,31.7
2017,ISERE,Saint-Barthélemy,675,154,521,12,509,1,NPA,3,7.825,31.7
2017,ISERE,Saint-Barthélemy,675,154,521,12,509,1,PCF,13,7.825,31.7
2017,ISERE,Saint-Barthélemy,675,154,521,12,509,1,REC,48,7.825,31.7
2017,ISERE,Saint-Barthélemy,675,154,521,12,509,1,RES,15,7.825,31.7
2017,ISERE,Le Champ-près-Froges,678,167,511,12,499,1,EELV,25,7.825,31.7
2017,ISERE,Le Champ-près-Froges,678,167,511,12,499,1,FN,162,7.825,31.7
2017,ISERE,Le Champ-près-Froges,678,167,511,12,499,1,LFI,53,7.825,31.7
2017,ISERE,Le Champ-près-Froges,678,167,511,12,499,1,LO,2,7.825,31.7
2017,ISERE,Le Champ-près-Froges,678,167,511,12,499,1,LR,18,7.825,31.7
2017,ISERE,Le Champ-près-Froges,678,167,511,12,499,1,LREM,150,7.825,31.7
2017,ISERE,Le Champ-près-Froges,678,167,511,12,499,1,NPA,10,7.825,31.7
2017,ISERE,Le Champ-près-Froges,678,167,511,12,499,1,PCF,14,7.825,31.7
2017,ISERE,Le Champ-près-Froges,678,167,511,12,499,1,REC,29,7.825,31.7
2017,ISERE,Le Champ-près-Froges,678,167,511,12,499,1,RES,14,7.825,31.7
2017,ISERE,Vienne,679,304,375,8,367,1,EELV,16,7.825,31.7
2017,ISERE,Vienne,679,304,375,8,367,1,FN,49,7.825,31.7
2017,ISERE,Vienne,679,304,375,8,367,1,LFI,171,7.825,31.7
2017,ISERE,Vienne,679,304,375,8,367,1,LO,4,7.825,31.7
2017,ISERE,Vienne,679,304,375,8,367,1,LR,9,7.825,31.7
2017,ISERE,Vienne,679,304,375,8,367,1,LREM,76,7.825,31.7
2017,ISERE,Vienne,679,304,375,8,367,1,NPA,6,7.825,31.7
2017,ISERE,Vienne,679,304,375,8,367,1,PCF,0,7.825,31.7
2017,ISERE,Vienne,679,304,375,8,367,1,REC,22,7.825,31.7
2017,ISERE,Vienne,679,304,375,8,367,1,RES,9,7.825,31.7
2017,ISERE,Charantonnay,680,108,572,19,553,1,EELV,27,7.825,31.7
2017,ISERE,Charantonnay,680,108,572,19,553,1,FN,203,7.825,31.7
2017,ISERE,Charantonnay,680,108,572,19,553,1,LFI,62,7.825,31.7
2017,ISERE,Charantonnay,680,108,572,19,553,1,LO,3,7.825,31.7
2017,ISERE,Charantonnay,680,108,572,19,553,1,LR,26,7.825,31.7
2017,ISERE,Charantonnay,680,108,572,19,553,1,LREM,132,7.825,31.7
2017,ISERE,Charantonnay,680,108,572,19,553,1,NPA,7,7.825,31.7
2017,ISERE,Charantonnay,680,108,572,19,553,1,PCF,15,7.825,31.7
2017,ISERE,Charantonnay,680,108,572,19,553,1,REC,40,7.825,31.7
2017,ISERE,Charantonnay,680,108,572,19,553,1,RES,21,7.825,31.7
2017,ISERE,Artas,681,153,528,16,512,1,EELV,21,7.825,31.7
2017,ISERE,Artas,681,153,528,16,512,1,FN,150,7.825,31.7
2017,ISERE,Artas,681,153,528,16,512,1,LFI,74,7.825,31.7
2017,ISERE,Artas,681,153,528,16,512,1,LO,8,7.825,31.7
2017,ISERE,Artas,681,153,528,16,512,1,LR,17,7.825,31.7
2017,ISERE,Artas,681,153,528,16,512,1,LREM,142,7.825,31.7
2017,ISERE,Artas,681,153,528,16,512,1,NPA,8,7.825,31.7
2017,ISERE,Artas,681,153,528,16,512,1,PCF,12,7.825,31.7
2017,ISERE,Artas,681,153,528,16,512,1,REC,31,7.825,31.7
2017,ISERE,Artas,681,153,528,16,512,1,RES,20,7.825,31.7
2017,ISERE,Saint-Maurice-l'Exil,686,170,516,6,510,1,EELV,17,7.825,31.7
2017,ISERE,Saint-Maurice-l'Exil,686,170,516,6,510,1,FN,150,7.825,31.7
2017,ISERE,Saint-Maurice-l'Exil,686,170,516,6,510,1,LFI,130,7.825,31.7
2017,ISERE,Saint-Maurice-l'Exil,686,170,516,6,510,1,LO,2,7.825,31.7
2017,ISERE,Saint-Maurice-l'Exil,686,170,516,6,510,1,LR,13,7.825,31.7
2017,ISERE,Saint-Maurice-l'Exil,686,170,516,6,510,1,LREM,123,7.825,31.7
2017,ISERE,Saint-Maurice-l'Exil,686,170,516,6,510,1,NPA,4,7.825,31.7
2017,ISERE,Saint-Maurice-l'Exil,686,170,516,6,510,1,PCF,8,7.825,31.7
2017,ISERE,Saint-Maurice-l'Exil,686,170,516,6,510,1,REC,38,7.825,31.7
2017,ISERE,Saint-Maurice-l'Exil,686,170,516,6,510,1,RES,8,7.825,31.7
2017,ISERE,Saint-Quentin-Fallavier,688,128,560,13,547,1,EELV,19,7.825,31.7
2017,ISERE,Saint-Quentin-Fallavier,688,128,560,13,547,1,FN,161,7.825,31.7
2017,ISERE,Saint-Quentin-Fallavier,688,128,560,13,547,1,LFI,113,7.825,31.7
2017,ISERE,Saint-Quentin-Fallavier,688,128,560,13,547,1,LO,1,7.825,31.7
2017,ISERE,Saint-Quentin-Fallavier,688,128,560,13,547,1,LR,26,7.825,31.7
2017,ISERE,Saint-Quentin-Fallavier,688,128,560,13,547,1,LREM,128,7.825,31.7
2017,ISERE,Saint-Quentin-Fallavier,688,128,560,13,547,1,NPA,10,7.825,31.7
2017,ISERE,Saint-Quentin-Fallavier,688,128,560,13,547,1,PCF,9,7.825,31.7
2017,ISERE,Saint-Quentin-Fallavier,688,128,560,13,547,1,REC,34,7.825,31.7
2017,ISERE,Saint-Quentin-Fallavier,688,128,560,13,547,1,RES,16,7.825,31.7
2017,ISERE,Saint-Martin-d'Hères,689,177,512,4,508,1,EELV,46,7.825,31.7
2017,ISERE,Saint-Martin-d'Hères,689,177,512,4,508,1,FN,77,7.825,31.7
2017,ISERE,Saint-Martin-d'Hères,689,177,512,4,508,1,LFI,199,7.825,31.7
2017,ISERE,Saint-Martin-d'Hères,689,177,512,4,508,1,LO,1,7.825,31.7
2017,ISERE,Saint-Martin-d'Hères,689,177,512,4,508,1,LR,10,7.825,31.7
2017,ISERE,Saint-Martin-d'Hères,689,177,512,4,508,1,LREM,99,7.825,31.7
2017,ISERE,Saint-Martin-d'Hères,689,177,512,4,508,1,NPA,3,7.825,31.7
2017,ISERE,Saint-Martin-d'Hères,689,177,512,4,508,1,PCF,15,7.825,31.7
2017,ISERE,Saint-Martin-d'Hères,689,177,512,4,508,1,REC,29,7.825,31.7
2017,ISERE,Saint-Martin-d'Hères,689,177,512,4,508,1,RES,12,7.825,31.7
2017,ISERE,Vienne,689,185,504,10,494,1,EELV,35,7.825,31.7
2017,ISERE,Vienne,689,185,504,10,494,1,FN,76,7.825,31.7
2017,ISERE,Vienne,689,185,504,10,494,1,LFI,146,7.825,31.7
2017,ISERE,Vienne,689,185,504,10,494,1,LO,6,7.825,31.7
2017,ISERE,Vienne,689,185,504,10,494,1,LR,15,7.825,31.7
2017,ISERE,Vienne,689,185,504,10,494,1,LREM,149,7.825,31.7
2017,ISERE,Vienne,689,185,504,10,494,1,NPA,4,7.825,31.7
2017,ISERE,Vienne,689,185,504,10,494,1,PCF,9,7.825,31.7
2017,ISERE,Vienne,689,185,504,10,494,1,REC,28,7.825,31.7
2017,ISERE,Vienne,689,185,504,10,494,1,RES,10,7.825,31.7
2017,ISERE,Montseveroux,692,115,577,12,565,1,EELV,36,7.825,31.7
2017,ISERE,Montseveroux,692,115,577,12,565,1,FN,186,7.825,31.7
2017,ISERE,Montseveroux,692,115,577,12,565,1,LFI,88,7.825,31.7
2017,ISERE,Montseveroux,692,115,577,12,565,1,LO,5,7.825,31.7
2017,ISERE,Montseveroux,692,115,577,12,565,1,LR,15,7.825,31.7
2017,ISERE,Montseveroux,692,115,577,12,565,1,LREM,127,7.825,31.7
2017,ISERE,Montseveroux,692,115,577,12,565,1,NPA,3,7.825,31.7
2017,ISERE,Montseveroux,692,115,577,12,565,1,PCF,17,7.825,31.7
2017,ISERE,Montseveroux,692,115,577,12,565,1,REC,42,7.825,31.7
2017,ISERE,Montseveroux,692,115,577,12,565,1,RES,18,7.825,31.7
2017,ISERE,Le Péage-de-Roussillon,693,231,462,14,448,1,EELV,13,7.825,31.7
2017,ISERE,Le Péage-de-Roussillon,693,231,462,14,448,1,FN,134,7.825,31.7
2017,ISERE,Le Péage-de-Roussillon,693,231,462,14,448,1,LFI,116,7.825,31.7
2017,ISERE,Le Péage-de-Roussillon,693,231,462,14,448,1,LO,1,7.825,31.7
2017,ISERE,Le Péage-de-Roussillon,693,231,462,14,448,1,LR,13,7.825,31.7
2017,ISERE,Le Péage-de-Roussillon,693,231,462,14,448,1,LREM,109,7.825,31.7
2017,ISERE,Le Péage-de-Roussillon,693,231,462,14,448,1,NPA,4,7.825,31.7
2017,ISERE,Le Péage-de-Roussillon,693,231,462,14,448,1,PCF,8,7.825,31.7
2017,ISERE,Le Péage-de-Roussillon,693,231,462,14,448,1,REC,41,7.825,31.7
2017,ISERE,Le Péage-de-Roussillon,693,231,462,14,448,1,RES,3,7.825,31.7
2017,ISERE,Grenoble,694,251,443,7,436,1,EELV,10,7.825,31.7
2017,ISERE,Grenoble,694,251,443,7,436,1,FN,104,7.825,31.7
2017,ISERE,Grenoble,694,251,443,7,436,1,LFI,186,7.825,31.7
2017,ISERE,Grenoble,694,251,443,7,436,1,LO,2,7.825,31.7
2017,ISERE,Grenoble,694,251,443,7,436,1,LR,8,7.825,31.7
2017,ISERE,Grenoble,694,251,443,7,436,1,LREM,78,7.825,31.7
2017,ISERE,Grenoble,694,251,443,7,436,1,NPA,2,7.825,31.7
2017,ISERE,Grenoble,694,251,443,7,436,1,PCF,9,7.825,31.7
2017,ISERE,Grenoble,694,251,443,7,436,1,REC,20,7.825,31.7
2017,ISERE,Grenoble,694,251,443,7,436,1,RES,3,7.825,31.7
2017,ISERE,Grenoble,695,120,575,4,571,1,EELV,60,7.825,31.7
2017,ISERE,Grenoble,695,120,575,4,571,1,FN,64,7.825,31.7
2017,ISERE,Grenoble,695,120,575,4,571,1,LFI,212,7.825,31.7
2017,ISERE,Grenoble,695,120,575,4,571,1,LO,0,7.825,31.7
2017,ISERE,Grenoble,695,120,575,4,571,1,LR,15,7.825,31.7
2017,ISERE,Grenoble,695,120,575,4,571,1,LREM,144,7.825,31.7
2017,ISERE,Grenoble,695,120,575,4,571,1,NPA,1,7.825,31.7
2017,ISERE,Grenoble,695,120,575,4,571,1,PCF,15,7.825,31.7
2017,ISERE,Grenoble,695,120,575,4,571,1,REC,33,7.825,31.7
2017,ISERE,Grenoble,695,120,575,4,571,1,RES,9,7.825,31.7
2017,ISERE,Le Péage-de-Roussillon,696,212,484,12,472,1,EELV,8,7.825,31.7
2017,ISERE,Le Péage-de-Roussillon,696,212,484,12,472,1,FN,120,7.825,31.7
2017,ISERE,Le Péage-de-Roussillon,696,212,484,12,472,1,LFI,135,7.825,31.7
2017,ISERE,Le Péage-de-Roussillon,696,212,484,12,472,1,LO,4,7.825,31.7
2017,ISERE,Le Péage-de-Roussillon,696,212,484,12,472,1,LR,15,7.825,31.7
2017,ISERE,Le Péage-de-Roussillon,696,212,484,12,472,1,LREM,111,7.825,31.7
2017,ISERE,Le Péage-de-Roussillon,696,212,484,12,472,1,NPA,5,7.825,31.7
2017,ISERE,Le Péage-de-Roussillon,696,212,484,12,472,1,PCF,10,7.825,31.7
2017,ISERE,Le Péage-de-Roussillon,696,212,484,12,472,1,REC,30,7.825,31.7
2017,ISERE,Le Péage-de-Roussillon,696,212,484,12,472,1,RES,14,7.825,31.7
2017,ISERE,Seyssinet-Pariset,698,161,537,9,528,1,EELV,53,7.825,31.7
2017,ISERE,Seyssinet-Pariset,698,161,537,9,528,1,FN,59,7.825,31.7
2017,ISERE,Seyssinet-Pariset,698,161,537,9,528,1,LFI,162,7.825,31.7
2017,ISERE,Seyssinet-Pariset,698,161,537,9,528,1,LO,2,7.825,31.7
2017,ISERE,Seyssinet-Pariset,698,161,537,9,528,1,LR,5,7.825,31.7
2017,ISERE,Seyssinet-Pariset,698,161,537,9,528,1,LREM,158,7.825,31.7
2017,ISERE,Seyssinet-Pariset,698,161,537,9,528,1,NPA,5,7.825,31.7
2017,ISERE,Seyssinet-Pariset,698,161,537,9,528,1,PCF,12,7.825,31.7
2017,ISERE,Seyssinet-Pariset,698,161,537,9,528,1,REC,28,7.825,31.7
2017,ISERE,Seyssinet-Pariset,698,161,537,9,528,1,RES,17,7.825,31.7
2017,ISERE,Estrablin,699,130,569,14,555,1,EELV,23,7.825,31.7
2017,ISERE,Estrablin,699,130,569,14,555,1,FN,152,7.825,31.7
2017,ISERE,Estrablin,699,130,569,14,555,1,LFI,87,7.825,31.7
2017,ISERE,Estrablin,699,130,569,14,555,1,LO,5,7.825,31.7
2017,ISERE,Estrablin,699,130,569,14,555,1,LR,26,7.825,31.7
2017,ISERE,Estrablin,699,130,569,14,555,1,LREM,161,7.825,31.7
2017,ISERE,Estrablin,699,130,569,14,555,1,NPA,5,7.825,31.7
2017,ISERE,Estrablin,699,130,569,14,555,1,PCF,16,7.825,31.7
2017,ISERE,Estrablin,699,130,569,14,555,1,REC,39,7.825,31.7
2017,ISERE,Estrablin,699,130,569,14,555,1,RES,19,7.825,31.7
2017,ISERE,Vienne,699,163,536,13,523,1,EELV,29,7.825,31.7
2017,ISERE,Vienne,699,163,536,13,523,1,FN,125,7.825,31.7
2017,ISERE,Vienne,699,163,536,13,523,1,LFI,114,7.825,31.7
2017,ISERE,Vienne,699,163,536,13,523,1,LO,4,7.825,31.7
2017,ISERE,Vienne,699,163,536,13,523,1,LR,19,7.825,31.7
2017,ISERE,Vienne,699,163,536,13,523,1,LREM,139,7.825,31.7
2017,ISERE,Vienne,699,163,536,13,523,1,NPA,5,7.825,31.7
2017,ISERE,Vienne,699,163,536,13,523,1,PCF,3,7.825,31.7
2017,ISERE,Vienne,699,163,536,13,523,1,REC,41,7.825,31.7
2017,ISERE,Vienne,699,163,536,13,523,1,RES,18,7.825,31.7
2017,ISERE,Vienne,700,156,544,6,538,1,EELV,31,7.825,31.7
2017,ISERE,Vienne,700,156,544,6,538,1,FN,83,7.825,31.7
2017,ISERE,Vienne,700,156,544,6,538,1,LFI,106,7.825,31.7
2017,ISERE,Vienne,700,156,544,6,538,1,LO,2,7.825,31.7
2017,ISERE,Vienne,700,156,544,6,538,1,LR,45,7.825,31.7
2017,ISERE,Vienne,700,156,544,6,538,1,LREM,152,7.825,31.7
2017,ISERE,Vienne,700,156,544,6,538,1,NPA,0,7.825,31.7
2017,ISERE,Vienne,700,156,544,6,538,1,PCF,19,7.825,31.7
2017,ISERE,Vienne,700,156,544,6,538,1,REC,59,7.825,31.7
2017,ISERE,Vienne,700,156,544,6,538,1,RES,10,7.825,31.7
2017,ISERE,Le Passage,701,93,608,20,588,1,EELV,30,7.825,31.7
2017,ISERE,Le Passage,701,93,608,20,588,1,FN,155,7.825,31.7
2017,ISERE,Le Passage,701,93,608,20,588,1,LFI,95,7.825,31.7
2017,ISERE,Le Passage,701,93,608,20,588,1,LO,4,7.825,31.7
2017,ISERE,Le Passage,701,93,608,20,588,1,LR,31,7.825,31.7
2017,ISERE,Le Passage,701,93,608,20,588,1,LREM,165,7.825,31.7
2017,ISERE,Le Passage,701,93,608,20,588,1,NPA,2,7.825,31.7
2017,ISERE,Le Passage,701,93,608,20,588,1,PCF,5,7.825,31.7
2017,ISERE,Le Passage,701,93,608,20,588,1,REC,47,7.825,31.7
2017,ISERE,Le Passage,701,93,608,20,588,1,RES,26,7.825,31.7
2017,ISERE,Vienne,701,191,510,19,491,1,EELV,10,7.825,31.7
2017,ISERE,Vienne,701,191,510,19,491,1,FN,102,7.825,31.7
2017,ISERE,Vienne,701,191,510,19,491,1,LFI,154,7.825,31.7
2017,ISERE,Vienne,701,191,510,19,491,1,LO,5,7.825,31.7
2017,ISERE,Vienne,701,191,510,19,491,1,LR,15,7.825,31.7
2017,ISERE,Vienne,701,191,510,19,491,1,LREM,117,7.825,31.7
2017,ISERE,Vienne,701,191,510,19,491,1,NPA,5,7.825,31.7
2017,ISERE,Vienne,701,191,510,19,491,1,PCF,15,7.825,31.7
2017,ISERE,Vienne,701,191,510,19,491,1,REC,30,7.825,31.7
2017,ISERE,Vienne,701,191,510,19,491,1,RES,11,7.825,31.7
2017,ISERE,Saint-Martin-d'Hères,702,185,517,7,510,1,EELV,39,7.825,31.7
2017,ISERE,Saint-Martin-d'Hères,702,185,517,7,510,1,FN,84,7.825,31.7
2017,ISERE,Saint-Martin-d'Hères,702,185,517,7,510,1,LFI,185,7.825,31.7
2017,ISERE,Saint-Martin-d'Hères,702,185,517,7,510,1,LO,2,7.825,31.7
2017,ISERE,Saint-Martin-d'Hères,702,185,517,7,510,1,LR,18,7.825,31.7
2017,ISERE,Saint-Martin-d'Hères,702,185,517,7,510,1,LREM,106,7.825,31.7
2017,ISERE,Saint-Martin-d'Hères,702,185,517,7,510,1,NPA,10,7.825,31.7
2017,ISERE,Saint-Martin-d'Hères,702,185,517,7,510,1,PCF,21,7.825,31.7
2017,ISERE,Saint-Martin-d'Hères,702,185,517,7,510,1,REC,19,7.825,31.7
2017,ISERE,Saint-Martin-d'Hères,702,185,517,7,510,1,RES,7,7.825,31.7
2017,ISERE,Savas-Mépin,703,133,570,16,554,1,EELV,12,7.825,31.7
2017,ISERE,Savas-Mépin,703,133,570,16,554,1,FN,223,7.825,31.7
2017,ISERE,Savas-Mépin,703,133,570,16,554,1,LFI,68,7.825,31.7
2017,ISERE,Savas-Mépin,703,133,570,16,554,1,LO,3,7.825,31.7
2017,ISERE,Savas-Mépin,703,133,570,16,554,1,LR,29,7.825,31.7
2017,ISERE,Savas-Mépin,703,133,570,16,554,1,LREM,126,7.825,31.7
2017,ISERE,Savas-Mépin,703,133,570,16,554,1,NPA,3,7.825,31.7
2017,ISERE,Savas-Mépin,703,133,570,16,554,1,PCF,11,7.825,31.7
2017,ISERE,Savas-Mépin,703,133,570,16,554,1,REC,49,7.825,31.7
2017,ISERE,Savas-Mépin,703,133,570,16,554,1,RES,15,7.825,31.7
2017,ISERE,Vienne,703,190,513,12,501,1,EELV,23,7.825,31.7
2017,ISERE,Vienne,703,190,513,12,501,1,FN,99,7.825,31.7
2017,ISERE,Vienne,703,190,513,12,501,1,LFI,128,7.825,31.7
2017,ISERE,Vienne,703,190,513,12,501,1,LO,5,7.825,31.7
2017,ISERE,Vienne,703,190,513,12,501,1,LR,27,7.825,31.7
2017,ISERE,Vienne,703,190,513,12,501,1,LREM,139,7.825,31.7
2017,ISERE,Vienne,703,190,513,12,501,1,NPA,9,7.825,31.7
2017,ISERE,Vienne,703,190,513,12,501,1,PCF,8,7.825,31.7
2017,ISERE,Vienne,703,190,513,12,501,1,REC,34,7.825,31.7
2017,ISERE,Vienne,703,190,513,12,501,1,RES,9,7.825,31.7
2017,ISERE,Saint-Jean-d'Avelanne,704,138,566,6,560,1,EELV,22,7.825,31.7
2017,ISERE,Saint-Jean-d'Avelanne,704,138,566,6,560,1,FN,169,7.825,31.7
2017,ISERE,Saint-Jean-d'Avelanne,704,138,566,6,560,1,LFI,128,7.825,31.7
2017,ISERE,Saint-Jean-d'Avelanne,704,138,566,6,560,1,LO,1,7.825,31.7
2017,ISERE,Saint-Jean-d'Avelanne,704,138,566,6,560,1,LR,23,7.825,31.7
2017,ISERE,Saint-Jean-d'Avelanne,704,138,566,6,560,1,LREM,132,7.825,31.7
2017,ISERE,Saint-Jean-d'Avelanne,704,138,566,6,560,1,NPA,4,7.825,31.7
2017,ISERE,Saint-Jean-d'Avelanne,704,138,566,6,560,1,PCF,9,7.825,31.7
2017,ISERE,Saint-Jean-d'Avelanne,704,138,566,6,560,1,REC,39,7.825,31.7
2017,ISERE,Saint-Jean-d'Avelanne,704,138,566,6,560,1,RES,12,7.825,31.7
2017,ISERE,Saint-Martin-d'Hères,706,291,415,6,409,1,EELV,13,7.825,31.7
2017,ISERE,Saint-Martin-d'Hères,706,291,415,6,409,1,FN,79,7.825,31.7
2017,ISERE,Saint-Martin-d'Hères,706,291,415,6,409,1,LFI,176,7.825,31.7
2017,ISERE,Saint-Martin-d'Hères,706,291,415,6,409,1,LO,0,7.825,31.7
2017,ISERE,Saint-Martin-d'Hères,706,291,415,6,409,1,LR,5,7.825,31.7
2017,ISERE,Saint-Martin-d'Hères,706,291,415,6,409,1,LREM,63,7.825,31.7
2017,ISERE,Saint-Martin-d'Hères,706,291,415,6,409,1,NPA,8,7.825,31.7
2017,ISERE,Saint-Martin-d'Hères,706,291,415,6,409,1,PCF,26,7.825,31.7
2017,ISERE,Saint-Martin-d'Hères,706,291,415,6,409,1,REC,21,7.825,31.7
2017,ISERE,Saint-Martin-d'Hères,706,291,415,6,409,1,RES,7,7.825,31.7
2017,ISERE,Grenoble,707,204,503,11,492,1,EELV,35,7.825,31.7
2017,ISERE,Grenoble,707,204,503,11,492,1,FN,88,7.825,31.7
2017,ISERE,Grenoble,707,204,503,11,492,1,LFI,168,7.825,31.7
2017,ISERE,Grenoble,707,204,503,11,492,1,LO,3,7.825,31.7
2017,ISERE,Grenoble,707,204,503,11,492,1,LR,13,7.825,31.7
2017,ISERE,Grenoble,707,204,503,11,492,1,LREM,106,7.825,31.7
2017,ISERE,Grenoble,707,204,503,11,492,1,NPA,6,7.825,31.7
2017,ISERE,Grenoble,707,204,503,11,492,1,PCF,11,7.825,31.7
2017,ISERE,Grenoble,707,204,503,11,492,1,REC,39,7.825,31.7
2017,ISERE,Grenoble,707,204,503,11,492,1,RES,6,7.825,31.7
2017,ISERE,Porte-des-Bonnevaux,710,164,546,14,532,1,EELV,14,7.825,31.7
2017,ISERE,Porte-des-Bonnevaux,710,164,546,14,532,1,FN,192,7.825,31.7
2017,ISERE,Porte-des-Bonnevaux,710,164,546,14,532,1,LFI,68,7.825,31.7
2017,ISERE,Porte-des-Bonnevaux,710,164,546,14,532,1,LO,4,7.825,31.7
2017,ISERE,Porte-des-Bonnevaux,710,164,546,14,532,1,LR,25,7.825,31.7
2017,ISERE,Porte-des-Bonnevaux,710,164,546,14,532,1,LREM,130,7.825,31.7
2017,ISERE,Porte-des-Bonnevaux,710,164,546,14,532,1,NPA,1,7.825,31.7
2017,ISERE,Porte-des-Bonnevaux,710,164,546,14,532,1,PCF,8,7.825,31.7
2017,ISERE,Porte-des-Bonnevaux,710,164,546,14,532,1,REC,50,7.825,31.7
2017,ISERE,Porte-des-Bonnevaux,710,164,546,14,532,1,RES,16,7.825,31.7
2017,ISERE,Echirolles,710,171,539,7,532,1,EELV,24,7.825,31.7
2017,ISERE,Echirolles,710,171,539,7,532,1,FN,97,7.825,31.7
2017,ISERE,Echirolles,710,171,539,7,532,1,LFI,90,7.825,31.7
2017,ISERE,Echirolles,710,171,539,7,532,1,LO,3,7.825,31.7
2017,ISERE,Echirolles,710,171,539,7,532,1,LR,31,7.825,31.7
2017,ISERE,Echirolles,710,171,539,7,532,1,LREM,188,7.825,31.7
2017,ISERE,Echirolles,710,171,539,7,532,1,NPA,2,7.825,31.7
2017,ISERE,Echirolles,710,171,539,7,532,1,PCF,20,7.825,31.7
2017,ISERE,Echirolles,710,171,539,7,532,1,REC,53,7.825,31.7
2017,ISERE,Echirolles,710,171,539,7,532,1,RES,11,7.825,31.7
2017,ISERE,Voreppe,711,121,590,12,578,1,EELV,54,7.825,31.7
2017,ISERE,Voreppe,711,121,590,12,578,1,FN,108,7.825,31.7
2017,ISERE,Voreppe,711,121,590,12,578,1,LFI,118,7.825,31.7
2017,ISERE,Voreppe,711,121,590,12,578,1,LO,1,7.825,31.7
2017,ISERE,Voreppe,711,121,590,12,578,1,LR,29,7.825,31.7
2017,ISERE,Voreppe,711,121,590,12,578,1,LREM,160,7.825,31.7
2017,ISERE,Voreppe,711,121,590,12,578,1,NPA,7,7.825,31.7
2017,ISERE,Voreppe,711,121,590,12,578,1,PCF,21,7.825,31.7
2017,ISERE,Voreppe,711,121,590,12,578,1,REC,36,7.825,31.7
2017,ISERE,Voreppe,711,121,590,12,578,1,RES,17,7.825,31.7
2017,ISERE,Champ-sur-Drac,711,139,572,11,561,1,EELV,28,7.825,31.7
2017,ISERE,Champ-sur-Drac,711,139,572,11,561,1,FN,158,7.825,31.7
2017,ISERE,Champ-sur-Drac,711,139,572,11,561,1,LFI,122,7.825,31.7
2017,ISERE,Champ-sur-Drac,711,139,572,11,561,1,LO,1,7.825,31.7
2017,ISERE,Champ-sur-Drac,711,139,572,11,561,1,LR,15,7.825,31.7
2017,ISERE,Champ-sur-Drac,711,139,572,11,561,1,LREM,141,7.825,31.7
2017,ISERE,Champ-sur-Drac,711,139,572,11,561,1,NPA,5,7.825,31.7
2017,ISERE,Champ-sur-Drac,711,139,572,11,561,1,PCF,11,7.825,31.7
2017,ISERE,Champ-sur-Drac,711,139,572,11,561,1,REC,42,7.825,31.7
2017,ISERE,Champ-sur-Drac,711,139,572,11,561,1,RES,19,7.825,31.7
2017,ISERE,Le Pont-de-Claix,711,252,459,5,454,1,EELV,8,7.825,31.7
2017,ISERE,Le Pont-de-Claix,711,252,459,5,454,1,FN,119,7.825,31.7
2017,ISERE,Le Pont-de-Claix,711,252,459,5,454,1,LFI,173,7.825,31.7
2017,ISERE,Le Pont-de-Claix,711,252,459,5,454,1,LO,0,7.825,31.7
2017,ISERE,Le Pont-de-Claix,711,252,459,5,454,1,LR,8,7.825,31.7
2017,ISERE,Le Pont-de-Claix,711,252,459,5,454,1,LREM,71,7.825,31.7
2017,ISERE,Le Pont-de-Claix,711,252,459,5,454,1,NPA,1,7.825,31.7
2017,ISERE,Le Pont-de-Claix,711,252,459,5,454,1,PCF,12,7.825,31.7
2017,ISERE,Le Pont-de-Claix,711,252,459,5,454,1,REC,40,7.825,31.7
2017,ISERE,Le Pont-de-Claix,711,252,459,5,454,1,RES,9,7.825,31.7
2017,ISERE,Meyrieu-les-Etangs,718,109,609,15,594,1,EELV,17,7.825,31.7
2017,ISERE,Meyrieu-les-Etangs,718,109,609,15,594,1,FN,178,7.825,31.7
2017,ISERE,Meyrieu-les-Etangs,718,109,609,15,594,1,LFI,85,7.825,31.7
2017,ISERE,Meyrieu-les-Etangs,718,109,609,15,594,1,LO,6,7.825,31.7
2017,ISERE,Meyrieu-les-Etangs,718,109,609,15,594,1,LR,46,7.825,31.7
2017,ISERE,Meyrieu-les-Etangs,718,109,609,15,594,1,LREM,148,7.825,31.7
2017,ISERE,Meyrieu-les-Etangs,718,109,609,15,594,1,NPA,5,7.825,31.7
2017,ISERE,Meyrieu-les-Etangs,718,109,609,15,594,1,PCF,17,7.825,31.7
2017,ISERE,Meyrieu-les-Etangs,718,109,609,15,594,1,REC,48,7.825,31.7
2017,ISERE,Meyrieu-les-Etangs,718,109,609,15,594,1,RES,22,7.825,31.7
2017,ISERE,Maubec,718,137,581,7,574,1,EELV,31,7.825,31.7
2017,ISERE,Maubec,718,137,581,7,574,1,FN,125,7.825,31.7
2017,ISERE,Maubec,718,137,581,7,574,1,LFI,112,7.825,31.7
2017,ISERE,Maubec,718,137,581,7,574,1,LO,3,7.825,31.7
2017,ISERE,Maubec,718,137,581,7,574,1,LR,31,7.825,31.7
2017,ISERE,Maubec,718,137,581,7,574,1,LREM,171,7.825,31.7
2017,ISERE,Maubec,718,137,581,7,574,1,NPA,4,7.825,31.7
2017,ISERE,Maubec,718,137,581,7,574,1,PCF,12,7.825,31.7
2017,ISERE,Maubec,718,137,581,7,574,1,REC,44,7.825,31.7
2017,ISERE,Maubec,718,137,581,7,574,1,RES,10,7.825,31.7
2017,ISERE,Varacieux,718,145,573,21,552,1,EELV,40,7.825,31.7
2017,ISERE,Varacieux,718,145,573,21,552,1,FN,190,7.825,31.7
2017,ISERE,Varacieux,718,145,573,21,552,1,LFI,70,7.825,31.7
2017,ISERE,Varacieux,718,145,573,21,552,1,LO,2,7.825,31.7
2017,ISERE,Varacieux,718,145,573,21,552,1,LR,17,7.825,31.7
2017,ISERE,Varacieux,718,145,573,21,552,1,LREM,134,7.825,31.7
2017,ISERE,Varacieux,718,145,573,21,552,1,NPA,3,7.825,31.7
2017,ISERE,Varacieux,718,145,573,21,552,1,PCF,17,7.825,31.7
2017,ISERE,Varacieux,718,145,573,21,552,1,REC,38,7.825,31.7
2017,ISERE,Varacieux,718,145,573,21,552,1,RES,16,7.825,31.7
2017,ISERE,Vizille,718,170,548,10,538,1,EELV,19,7.825,31.7
2017,ISERE,Vizille,718,170,548,10,538,1,FN,187,7.825,31.7
2017,ISERE,Vizille,718,170,548,10,538,1,LFI,116,7.825,31.7
2017,ISERE,Vizille,718,170,548,10,538,1,LO,3,7.825,31.7
2017,ISERE,Vizille,718,170,548,10,538,1,LR,14,7.825,31.7
2017,ISERE,Vizille,718,170,548,10,538,1,LREM,117,7.825,31.7
2017,ISERE,Vizille,718,170,548,10,538,1,NPA,3,7.825,31.7
2017,ISERE,Vizille,718,170,548,10,538,1,PCF,17,7.825,31.7
2017,ISERE,Vizille,718,170,548,10,538,1,REC,32,7.825,31.7
2017,ISERE,Vizille,718,170,548,10,538,1,RES,15,7.825,31.7
2017,ISERE,Saint-Alban-du-Rhône,718,171,547,8,539,1,EELV,20,7.825,31.7
2017,ISERE,Saint-Alban-du-Rhône,718,171,547,8,539,1,FN,186,7.825,31.7
2017,ISERE,Saint-Alban-du-Rhône,718,171,547,8,539,1,LFI,86,7.825,31.7
2017,ISERE,Saint-Alban-du-Rhône,718,171,547,8,539,1,LO,4,7.825,31.7
2017,ISERE,Saint-Alban-du-Rhône,718,171,547,8,539,1,LR,9,7.825,31.7
2017,ISERE,Saint-Alban-du-Rhône,718,171,547,8,539,1,LREM,121,7.825,31.7
2017,ISERE,Saint-Alban-du-Rhône,718,171,547,8,539,1,NPA,4,7.825,31.7
2017,ISERE,Saint-Alban-du-Rhône,718,171,547,8,539,1,PCF,12,7.825,31.7
2017,ISERE,Saint-Alban-du-Rhône,718,171,547,8,539,1,REC,48,7.825,31.7
2017,ISERE,Saint-Alban-du-Rhône,718,171,547,8,539,1,RES,16,7.825,31.7
2017,ISERE,Vienne,719,209,510,13,497,1,EELV,18,7.825,31.7
2017,ISERE,Vienne,719,209,510,13,497,1,FN,117,7.825,31.7
2017,ISERE,Vienne,719,209,510,13,497,1,LFI,108,7.825,31.7
2017,ISERE,Vienne,719,209,510,13,497,1,LO,2,7.825,31.7
2017,ISERE,Vienne,719,209,510,13,497,1,LR,30,7.825,31.7
2017,ISERE,Vienne,719,209,510,13,497,1,LREM,131,7.825,31.7
2017,ISERE,Vienne,719,209,510,13,497,1,NPA,3,7.825,31.7
2017,ISERE,Vienne,719,209,510,13,497,1,PCF,4,7.825,31.7
2017,ISERE,Vienne,719,209,510,13,497,1,REC,40,7.825,31.7
2017,ISERE,Vienne,719,209,510,13,497,1,RES,14,7.825,31.7
2017,ISERE,Grenoble,719,332,387,9,378,1,EELV,4,7.825,31.7
2017,ISERE,Grenoble,719,332,387,9,378,1,FN,35,7.825,31.7
2017,ISERE,Grenoble,719,332,387,9,378,1,LFI,229,7.825,31.7
2017,ISERE,Grenoble,719,332,387,9,378,1,LO,2,7.825,31.7
2017,ISERE,Grenoble,719,332,387,9,378,1,LR,7,7.825,31.7
2017,ISERE,Grenoble,719,332,387,9,378,1,LREM,75,7.825,31.7
2017,ISERE,Grenoble,719,332,387,9,378,1,NPA,2,7.825,31.7
2017,ISERE,Grenoble,719,332,387,9,378,1,PCF,6,7.825,31.7
2017,ISERE,Grenoble,719,332,387,9,378,1,REC,10,7.825,31.7
2017,ISERE,Grenoble,719,332,387,9,378,1,RES,0,7.825,31.7
2017,ISERE,Meylan,720,165,555,17,538,1,EELV,43,7.825,31.7
2017,ISERE,Meylan,720,165,555,17,538,1,FN,63,7.825,31.7
2017,ISERE,Meylan,720,165,555,17,538,1,LFI,118,7.825,31.7
2017,ISERE,Meylan,720,165,555,17,538,1,LO,5,7.825,31.7
2017,ISERE,Meylan,720,165,555,17,538,1,LR,35,7.825,31.7
2017,ISERE,Meylan,720,165,555,17,538,1,LREM,188,7.825,31.7
2017,ISERE,Meylan,720,165,555,17,538,1,NPA,4,7.825,31.7
2017,ISERE,Meylan,720,165,555,17,538,1,PCF,8,7.825,31.7
2017,ISERE,Meylan,720,165,555,17,538,1,REC,33,7.825,31.7
2017,ISERE,Meylan,720,165,555,17,538,1,RES,12,7.825,31.7
2017,ISERE,Saint-Martin-d'Hères,721,177,544,8,536,1,EELV,39,7.825,31.7
2017,ISERE,Saint-Martin-d'Hères,721,177,544,8,536,1,FN,100,7.825,31.7
2017,ISERE,Saint-Martin-d'Hères,721,177,544,8,536,1,LFI,182,7.825,31.7
2017,ISERE,Saint-Martin-d'Hères,721,177,544,8,536,1,LO,1,7.825,31.7
2017,ISERE,Saint-Martin-d'Hères,721,177,544,8,536,1,LR,9,7.825,31.7
2017,ISERE,Saint-Martin-d'Hères,721,177,544,8,536,1,LREM,135,7.825,31.7
2017,ISERE,Saint-Martin-d'Hères,721,177,544,8,536,1,NPA,8,7.825,31.7
2017,ISERE,Saint-Martin-d'Hères,721,177,544,8,536,1,PCF,15,7.825,31.7
2017,ISERE,Saint-Martin-d'Hères,721,177,544,8,536,1,REC,21,7.825,31.7
2017,ISERE,Saint-Martin-d'Hères,721,177,544,8,536,1,RES,13,7.825,31.7
2017,ISERE,Ornacieux-Balbins,723,108,615,17,598,1,EELV,24,7.825,31.7
2017,ISERE,Ornacieux-Balbins,723,108,615,17,598,1,FN,153,7.825,31.7
2017,ISERE,Ornacieux-Balbins,723,108,615,17,598,1,LFI,97,7.825,31.7
2017,ISERE,Ornacieux-Balbins,723,108,615,17,598,1,LO,3,7.825,31.7
2017,ISERE,Ornacieux-Balbins,723,108,615,17,598,1,LR,37,7.825,31.7
2017,ISERE,Ornacieux-Balbins,723,108,615,17,598,1,LREM,171,7.825,31.7
2017,ISERE,Ornacieux-Balbins,723,108,615,17,598,1,NPA,1,7.825,31.7
2017,ISERE,Ornacieux-Balbins,723,108,615,17,598,1,PCF,10,7.825,31.7
2017,ISERE,Ornacieux-Balbins,723,108,615,17,598,1,REC,43,7.825,31.7
2017,ISERE,Ornacieux-Balbins,723,108,615,17,598,1,RES,26,7.825,31.7
2017,ISERE,Vézeronce-Curtin,723,182,541,8,533,1,EELV,17,7.825,31.7
2017,ISERE,Vézeronce-Curtin,723,182,541,8,533,1,FN,185,7.825,31.7
2017,ISERE,Vézeronce-Curtin,723,182,541,8,533,1,LFI,75,7.825,31.7
2017,ISERE,Vézeronce-Curtin,723,182,541,8,533,1,LO,1,7.825,31.7
2017,ISERE,Vézeronce-Curtin,723,182,541,8,533,1,LR,18,7.825,31.7
2017,ISERE,Vézeronce-Curtin,723,182,541,8,533,1,LREM,132,7.825,31.7
2017,ISERE,Vézeronce-Curtin,723,182,541,8,533,1,NPA,3,7.825,31.7
2017,ISERE,Vézeronce-Curtin,723,182,541,8,533,1,PCF,16,7.825,31.7
2017,ISERE,Vézeronce-Curtin,723,182,541,8,533,1,REC,55,7.825,31.7
2017,ISERE,Vézeronce-Curtin,723,182,541,8,533,1,RES,14,7.825,31.7
2017,ISERE,Moidieu-Détourbe,724,117,607,12,595,1,EELV,19,7.825,31.7
2017,ISERE,Moidieu-Détourbe,724,117,607,12,595,1,FN,188,7.825,31.7
2017,ISERE,Moidieu-Détourbe,724,117,607,12,595,1,LFI,89,7.825,31.7
2017,ISERE,Moidieu-Détourbe,724,117,607,12,595,1,LO,3,7.825,31.7
2017,ISERE,Moidieu-Détourbe,724,117,607,12,595,1,LR,25,7.825,31.7
2017,ISERE,Moidieu-Détourbe,724,117,607,12,595,1,LREM,160,7.825,31.7
2017,ISERE,Moidieu-Détourbe,724,117,607,12,595,1,NPA,5,7.825,31.7
2017,ISERE,Moidieu-Détourbe,724,117,607,12,595,1,PCF,11,7.825,31.7
2017,ISERE,Moidieu-Détourbe,724,117,607,12,595,1,REC,54,7.825,31.7
2017,ISERE,Moidieu-Détourbe,724,117,607,12,595,1,RES,20,7.825,31.7
2017,ISERE,Noyarey,724,133,591,11,580,1,EELV,45,7.825,31.7
2017,ISERE,Noyarey,724,133,591,11,580,1,FN,113,7.825,31.7
2017,ISERE,Noyarey,724,133,591,11,580,1,LFI,123,7.825,31.7
2017,ISERE,Noyarey,724,133,591,11,580,1,LO,3,7.825,31.7
2017,ISERE,Noyarey,724,133,591,11,580,1,LR,35,7.825,31.7
2017,ISERE,Noyarey,724,133,591,11,580,1,LREM,166,7.825,31.7
2017,ISERE,Noyarey,724,133,591,11,580,1,NPA,0,7.825,31.7
2017,ISERE,Noyarey,724,133,591,11,580,1,PCF,11,7.825,31.7
2017,ISERE,Noyarey,724,133,591,11,580,1,REC,44,7.825,31.7
2017,ISERE,Noyarey,724,133,591,11,580,1,RES,17,7.825,31.7
2017,ISERE,Vienne,724,218,506,12,494,1,EELV,7,7.825,31.7
2017,ISERE,Vienne,724,218,506,12,494,1,FN,126,7.825,31.7
2017,ISERE,Vienne,724,218,506,12,494,1,LFI,184,7.825,31.7
2017,ISERE,Vienne,724,218,506,12,494,1,LO,1,7.825,31.7
2017,ISERE,Vienne,724,218,506,12,494,1,LR,22,7.825,31.7
2017,ISERE,Vienne,724,218,506,12,494,1,LREM,92,7.825,31.7
2017,ISERE,Vienne,724,218,506,12,494,1,NPA,5,7.825,31.7
2017,ISERE,Vienne,724,218,506,12,494,1,PCF,6,7.825,31.7
2017,ISERE,Vienne,724,218,506,12,494,1,REC,31,7.825,31.7
2017,ISERE,Vienne,724,218,506,12,494,1,RES,6,7.825,31.7
2017,ISERE,Grenoble,725,245,480,8,472,1,EELV,35,7.825,31.7
2017,ISERE,Grenoble,725,245,480,8,472,1,FN,57,7.825,31.7
2017,ISERE,Grenoble,725,245,480,8,472,1,LFI,188,7.825,31.7
2017,ISERE,Grenoble,725,245,480,8,472,1,LO,0,7.825,31.7
2017,ISERE,Grenoble,725,245,480,8,472,1,LR,15,7.825,31.7
2017,ISERE,Grenoble,725,245,480,8,472,1,LREM,115,7.825,31.7
2017,ISERE,Grenoble,725,245,480,8,472,1,NPA,1,7.825,31.7
2017,ISERE,Grenoble,725,245,480,8,472,1,PCF,8,7.825,31.7
2017,ISERE,Grenoble,725,245,480,8,472,1,REC,29,7.825,31.7
2017,ISERE,Grenoble,725,245,480,8,472,1,RES,10,7.825,31.7
2017,ISERE,La Balme-les-Grottes,727,127,600,12,588,1,EELV,15,7.825,31.7
2017,ISERE,La Balme-les-Grottes,727,127,600,12,588,1,FN,215,7.825,31.7
2017,ISERE,La Balme-les-Grottes,727,127,600,12,588,1,LFI,78,7.825,31.7
2017,ISERE,La Balme-les-Grottes,727,127,600,12,588,1,LO,4,7.825,31.7
2017,ISERE,La Balme-les-Grottes,727,127,600,12,588,1,LR,18,7.825,31.7
2017,ISERE,La Balme-les-Grottes,727,127,600,12,588,1,LREM,123,7.825,31.7
2017,ISERE,La Balme-les-Grottes,727,127,600,12,588,1,NPA,4,7.825,31.7
2017,ISERE,La Balme-les-Grottes,727,127,600,12,588,1,PCF,17,7.825,31.7
2017,ISERE,La Balme-les-Grottes,727,127,600,12,588,1,REC,59,7.825,31.7
2017,ISERE,La Balme-les-Grottes,727,127,600,12,588,1,RES,21,7.825,31.7
2017,ISERE,Saint-Sorlin-de-Vienne,728,110,618,17,601,1,EELV,25,7.825,31.7
2017,ISERE,Saint-Sorlin-de-Vienne,728,110,618,17,601,1,FN,203,7.825,31.7
2017,ISERE,Saint-Sorlin-de-Vienne,728,110,618,17,601,1,LFI,75,7.825,31.7
2017,ISERE,Saint-Sorlin-de-Vienne,728,110,618,17,601,1,LO,2,7.825,31.7
2017,ISERE,Saint-Sorlin-de-Vienne,728,110,618,17,601,1,LR,37,7.825,31.7
2017,ISERE,Saint-Sorlin-de-Vienne,728,110,618,17,601,1,LREM,149,7.825,31.7
2017,ISERE,Saint-Sorlin-de-Vienne,728,110,618,17,601,1,NPA,2,7.825,31.7
2017,ISERE,Saint-Sorlin-de-Vienne,728,110,618,17,601,1,PCF,12,7.825,31.7
2017,ISERE,Saint-Sorlin-de-Vienne,728,110,618,17,601,1,REC,41,7.825,31.7
2017,ISERE,Saint-Sorlin-de-Vienne,728,110,618,17,601,1,RES,20,7.825,31.7
2017,ISERE,Le Péage-de-Roussillon,728,220,508,10,498,1,EELV,12,7.825,31.7
2017,ISERE,Le Péage-de-Roussillon,728,220,508,10,498,1,FN,116,7.825,31.7
2017,ISERE,Le Péage-de-Roussillon,728,220,508,10,498,1,LFI,176,7.825,31.7
2017,ISERE,Le Péage-de-Roussillon,728,220,508,10,498,1,LO,2,7.825,31.7
2017,ISERE,Le Péage-de-Roussillon,728,220,508,10,498,1,LR,11,7.825,31.7
2017,ISERE,Le Péage-de-Roussillon,728,220,508,10,498,1,LREM,99,7.825,31.7
2017,ISERE,Le Péage-de-Roussillon,728,220,508,10,498,1,NPA,0,7.825,31.7
2017,ISERE,Le Péage-de-Roussillon,728,220,508,10,498,1,PCF,16,7.825,31.7
2017,ISERE,Le Péage-de-Roussillon,728,220,508,10,498,1,REC,33,7.825,31.7
2017,ISERE,Le Péage-de-Roussillon,728,220,508,10,498,1,RES,14,7.825,31.7
2017,ISERE,Tignieu-Jameyzieu,729,218,511,13,498,1,EELV,17,7.825,31.7
2017,ISERE,Tignieu-Jameyzieu,729,218,511,13,498,1,FN,140,7.825,31.7
2017,ISERE,Tignieu-Jameyzieu,729,218,511,13,498,1,LFI,161,7.825,31.7
2017,ISERE,Tignieu-Jameyzieu,729,218,511,13,498,1,LO,3,7.825,31.7
2017,ISERE,Tignieu-Jameyzieu,729,218,511,13,498,1,LR,8,7.825,31.7
2017,ISERE,Tignieu-Jameyzieu,729,218,511,13,498,1,LREM,101,7.825,31.7
2017,ISERE,Tignieu-Jameyzieu,729,218,511,13,498,1,NPA,1,7.825,31.7
2017,ISERE,Tignieu-Jameyzieu,729,218,511,13,498,1,PCF,14,7.825,31.7
2017,ISERE,Tignieu-Jameyzieu,729,218,511,13,498,1,REC,28,7.825,31.7
2017,ISERE,Tignieu-Jameyzieu,729,218,511,13,498,1,RES,11,7.825,31.7
2017,ISERE,Froges,730,162,568,14,554,1,EELV,47,7.825,31.7
2017,ISERE,Froges,730,162,568,14,554,1,FN,127,7.825,31.7
2017,ISERE,Froges,730,162,568,14,554,1,LFI,97,7.825,31.7
2017,ISERE,Froges,730,162,568,14,554,1,LO,0,7.825,31.7
2017,ISERE,Froges,730,162,568,14,554,1,LR,19,7.825,31.7
2017,ISERE,Froges,730,162,568,14,554,1,LREM,185,7.825,31.7
2017,ISERE,Froges,730,162,568,14,554,1,NPA,2,7.825,31.7
2017,ISERE,Froges,730,162,568,14,554,1,PCF,14,7.825,31.7
2017,ISERE,Froges,730,162,568,14,554,1,REC,29,7.825,31.7
2017,ISERE,Froges,730,162,568,14,554,1,RES,11,7.825,31.7
2017,ISERE,Echirolles,730,282,448,6,442,1,EELV,14,7.825,31.7
2017,ISERE,Echirolles,730,282,448,6,442,1,FN,41,7.825,31.7
2017,ISERE,Echirolles,730,282,448,6,442,1,LFI,266,7.825,31.7
2017,ISERE,Echirolles,730,282,448,6,442,1,LO,1,7.825,31.7
2017,ISERE,Echirolles,730,282,448,6,442,1,LR,5,7.825,31.7
2017,ISERE,Echirolles,730,282,448,6,442,1,LREM,72,7.825,31.7
2017,ISERE,Echirolles,730,282,448,6,442,1,NPA,3,7.825,31.7
2017,ISERE,Echirolles,730,282,448,6,442,1,PCF,17,7.825,31.7
2017,ISERE,Echirolles,730,282,448,6,442,1,REC,10,7.825,31.7
2017,ISERE,Echirolles,730,282,448,6,442,1,RES,4,7.825,31.7
2017,ISERE,Jarrie,732,94,638,20,618,1,EELV,45,7.825,31.7
2017,ISERE,Jarrie,732,94,638,20,618,1,FN,97,7.825,31.7
2017,ISERE,Jarrie,732,94,638,20,618,1,LFI,102,7.825,31.7
2017,ISERE,Jarrie,732,94,638,20,618,1,LO,0,7.825,31.7
2017,ISERE,Jarrie,732,94,638,20,618,1,LR,53,7.825,31.7
2017,ISERE,Jarrie,732,94,638,20,618,1,LREM,219,7.825,31.7
2017,ISERE,Jarrie,732,94,638,20,618,1,NPA,1,7.825,31.7
2017,ISERE,Jarrie,732,94,638,20,618,1,PCF,16,7.825,31.7
2017,ISERE,Jarrie,732,94,638,20,618,1,REC,36,7.825,31.7
2017,ISERE,Jarrie,732,94,638,20,618,1,RES,20,7.825,31.7
2017,ISERE,Châbons,733,136,597,20,577,1,EELV,34,7.825,31.7
2017,ISERE,Châbons,733,136,597,20,577,1,FN,143,7.825,31.7
2017,ISERE,Châbons,733,136,597,20,577,1,LFI,115,7.825,31.7
2017,ISERE,Châbons,733,136,597,20,577,1,LO,7,7.825,31.7
2017,ISERE,Châbons,733,136,597,20,577,1,LR,22,7.825,31.7
2017,ISERE,Châbons,733,136,597,20,577,1,LREM,124,7.825,31.7
2017,ISERE,Châbons,733,136,597,20,577,1,NPA,3,7.825,31.7
2017,ISERE,Châbons,733,136,597,20,577,1,PCF,12,7.825,31.7
2017,ISERE,Châbons,733,136,597,20,577,1,REC,63,7.825,31.7
2017,ISERE,Châbons,733,136,597,20,577,1,RES,19,7.825,31.7
2017,ISERE,Grenoble,733,163,570,5,565,1,EELV,75,7.825,31.7
2017,ISERE,Grenoble,733,163,570,5,565,1,FN,47,7.825,31.7
2017,ISERE,Grenoble,733,163,570,5,565,1,LFI,238,7.825,31.7
2017,ISERE,Grenoble,733,163,570,5,565,1,LO,1,7.825,31.7
2017,ISERE,Grenoble,733,163,570,5,565,1,LR,8,7.825,31.7
2017,ISERE,Grenoble,733,163,570,5,565,1,LREM,132,7.825,31.7
2017,ISERE,Grenoble,733,163,570,5,565,1,NPA,4,7.825,31.7
2017,ISERE,Grenoble,733,163,570,5,565,1,PCF,10,7.825,31.7
2017,ISERE,Grenoble,733,163,570,5,565,1,REC,29,7.825,31.7
2017,ISERE,Grenoble,733,163,570,5,565,1,RES,5,7.825,31.7
2017,ISERE,Reventin-Vaugris,735,114,621,14,607,1,EELV,21,7.825,31.7
2017,ISERE,Reventin-Vaugris,735,114,621,14,607,1,FN,183,7.825,31.7
2017,ISERE,Reventin-Vaugris,735,114,621,14,607,1,LFI,96,7.825,31.7
2017,ISERE,Reventin-Vaugris,735,114,621,14,607,1,LO,1,7.825,31.7
2017,ISERE,Reventin-Vaugris,735,114,621,14,607,1,LR,34,7.825,31.7
2017,ISERE,Reventin-Vaugris,735,114,621,14,607,1,LREM,153,7.825,31.7
2017,ISERE,Reventin-Vaugris,735,114,621,14,607,1,NPA,7,7.825,31.7
2017,ISERE,Reventin-Vaugris,735,114,621,14,607,1,PCF,6,7.825,31.7
2017,ISERE,Reventin-Vaugris,735,114,621,14,607,1,REC,63,7.825,31.7
2017,ISERE,Reventin-Vaugris,735,114,621,14,607,1,RES,17,7.825,31.7
2017,ISERE,Trept,740,151,589,9,580,1,EELV,26,7.825,31.7
2017,ISERE,Trept,740,151,589,9,580,1,FN,170,7.825,31.7
2017,ISERE,Trept,740,151,589,9,580,1,LFI,92,7.825,31.7
2017,ISERE,Trept,740,151,589,9,580,1,LO,2,7.825,31.7
2017,ISERE,Trept,740,151,589,9,580,1,LR,24,7.825,31.7
2017,ISERE,Trept,740,151,589,9,580,1,LREM,142,7.825,31.7
2017,ISERE,Trept,740,151,589,9,580,1,NPA,7,7.825,31.7
2017,ISERE,Trept,740,151,589,9,580,1,PCF,7,7.825,31.7
2017,ISERE,Trept,740,151,589,9,580,1,REC,64,7.825,31.7
2017,ISERE,Trept,740,151,589,9,580,1,RES,20,7.825,31.7
2017,ISERE,Lumbin,742,122,620,8,612,1,EELV,51,7.825,31.7
2017,ISERE,Lumbin,742,122,620,8,612,1,FN,111,7.825,31.7
2017,ISERE,Lumbin,742,122,620,8,612,1,LFI,106,7.825,31.7
2017,ISERE,Lumbin,742,122,620,8,612,1,LO,2,7.825,31.7
2017,ISERE,Lumbin,742,122,620,8,612,1,LR,35,7.825,31.7
2017,ISERE,Lumbin,742,122,620,8,612,1,LREM,218,7.825,31.7
2017,ISERE,Lumbin,742,122,620,8,612,1,NPA,3,7.825,31.7
2017,ISERE,Lumbin,742,122,620,8,612,1,PCF,6,7.825,31.7
2017,ISERE,Lumbin,742,122,620,8,612,1,REC,51,7.825,31.7
2017,ISERE,Lumbin,742,122,620,8,612,1,RES,14,7.825,31.7
2017,ISERE,Bizonnes,743,137,606,18,588,1,EELV,23,7.825,31.7
2017,ISERE,Bizonnes,743,137,606,18,588,1,FN,246,7.825,31.7
2017,ISERE,Bizonnes,743,137,606,18,588,1,LFI,55,7.825,31.7
2017,ISERE,Bizonnes,743,137,606,18,588,1,LO,1,7.825,31.7
2017,ISERE,Bizonnes,743,137,606,18,588,1,LR,32,7.825,31.7
2017,ISERE,Bizonnes,743,137,606,18,588,1,LREM,133,7.825,31.7
2017,ISERE,Bizonnes,743,137,606,18,588,1,NPA,7,7.825,31.7
2017,ISERE,Bizonnes,743,137,606,18,588,1,PCF,13,7.825,31.7
2017,ISERE,Bizonnes,743,137,606,18,588,1,REC,43,7.825,31.7
2017,ISERE,Bizonnes,743,137,606,18,588,1,RES,12,7.825,31.7
2017,ISERE,Les Abrets en Dauphiné,743,151,592,14,578,1,EELV,28,7.825,31.7
2017,ISERE,Les Abrets en Dauphiné,743,151,592,14,578,1,FN,224,7.825,31.7
2017,ISERE,Les Abrets en Dauphiné,743,151,592,14,578,1,LFI,97,7.825,31.7
2017,ISERE,Les Abrets en Dauphiné,743,151,592,14,578,1,LO,6,7.825,31.7
2017,ISERE,Les Abrets en Dauphiné,743,151,592,14,578,1,LR,33,7.825,31.7
2017,ISERE,Les Abrets en Dauphiné,743,151,592,14,578,1,LREM,101,7.825,31.7
2017,ISERE,Les Abrets en Dauphiné,743,151,592,14,578,1,NPA,3,7.825,31.7
2017,ISERE,Les Abrets en Dauphiné,743,151,592,14,578,1,PCF,9,7.825,31.7
2017,ISERE,Les Abrets en Dauphiné,743,151,592,14,578,1,REC,39,7.825,31.7
2017,ISERE,Les Abrets en Dauphiné,743,151,592,14,578,1,RES,11,7.825,31.7
2017,ISERE,Saint-Quentin-Fallavier,743,172,571,13,558,1,EELV,20,7.825,31.7
2017,ISERE,Saint-Quentin-Fallavier,743,172,571,13,558,1,FN,169,7.825,31.7
2017,ISERE,Saint-Quentin-Fallavier,743,172,571,13,558,1,LFI,134,7.825,31.7
2017,ISERE,Saint-Quentin-Fallavier,743,172,571,13,558,1,LO,2,7.825,31.7
2017,ISERE,Saint-Quentin-Fallavier,743,172,571,13,558,1,LR,11,7.825,31.7
2017,ISERE,Saint-Quentin-Fallavier,743,172,571,13,558,1,LREM,135,7.825,31.7
2017,ISERE,Saint-Quentin-Fallavier,743,172,571,13,558,1,NPA,5,7.825,31.7
2017,ISERE,Saint-Quentin-Fallavier,743,172,571,13,558,1,PCF,12,7.825,31.7
2017,ISERE,Saint-Quentin-Fallavier,743,172,571,13,558,1,REC,41,7.825,31.7
2017,ISERE,Saint-Quentin-Fallavier,743,172,571,13,558,1,RES,13,7.825,31.7
2017,ISERE,Le Pont-de-Claix,744,261,483,9,474,1,EELV,12,7.825,31.7
2017,ISERE,Le Pont-de-Claix,744,261,483,9,474,1,FN,91,7.825,31.7
2017,ISERE,Le Pont-de-Claix,744,261,483,9,474,1,LFI,219,7.825,31.7
2017,ISERE,Le Pont-de-Claix,744,261,483,9,474,1,LO,1,7.825,31.7
2017,ISERE,Le Pont-de-Claix,744,261,483,9,474,1,LR,16,7.825,31.7
2017,ISERE,Le Pont-de-Claix,744,261,483,9,474,1,LREM,79,7.825,31.7
2017,ISERE,Le Pont-de-Claix,744,261,483,9,474,1,NPA,5,7.825,31.7
2017,ISERE,Le Pont-de-Claix,744,261,483,9,474,1,PCF,6,7.825,31.7
2017,ISERE,Le Pont-de-Claix,744,261,483,9,474,1,REC,25,7.825,31.7
2017,ISERE,Le Pont-de-Claix,744,261,483,9,474,1,RES,6,7.825,31.7
2017,ISERE,Seyssuel,745,155,590,10,580,1,EELV,27,7.825,31.7
2017,ISERE,Seyssuel,745,155,590,10,580,1,FN,135,7.825,31.7
2017,ISERE,Seyssuel,745,155,590,10,580,1,LFI,93,7.825,31.7
2017,ISERE,Seyssuel,745,155,590,10,580,1,LO,3,7.825,31.7
2017,ISERE,Seyssuel,745,155,590,10,580,1,LR,25,7.825,31.7
2017,ISERE,Seyssuel,745,155,590,10,580,1,LREM,177,7.825,31.7
2017,ISERE,Seyssuel,745,155,590,10,580,1,NPA,0,7.825,31.7
2017,ISERE,Seyssuel,745,155,590,10,580,1,PCF,17,7.825,31.7
2017,ISERE,Seyssuel,745,155,590,10,580,1,REC,60,7.825,31.7
2017,ISERE,Seyssuel,745,155,590,10,580,1,RES,18,7.825,31.7
2017,ISERE,Grenoble,745,173,572,7,565,1,EELV,55,7.825,31.7
2017,ISERE,Grenoble,745,173,572,7,565,1,FN,64,7.825,31.7
2017,ISERE,Grenoble,745,173,572,7,565,1,LFI,197,7.825,31.7
2017,ISERE,Grenoble,745,173,572,7,565,1,LO,4,7.825,31.7
2017,ISERE,Grenoble,745,173,572,7,565,1,LR,14,7.825,31.7
2017,ISERE,Grenoble,745,173,572,7,565,1,LREM,132,7.825,31.7
2017,ISERE,Grenoble,745,173,572,7,565,1,NPA,8,7.825,31.7
2017,ISERE,Grenoble,745,173,572,7,565,1,PCF,16,7.825,31.7
2017,ISERE,Grenoble,745,173,572,7,565,1,REC,43,7.825,31.7
2017,ISERE,Grenoble,745,173,572,7,565,1,RES,11,7.825,31.7
2017,ISERE,Vaulnaveys-le-Haut,746,123,623,15,608,1,EELV,75,7.825,31.7
2017,ISERE,Vaulnaveys-le-Haut,746,123,623,15,608,1,FN,90,7.825,31.7
2017,ISERE,Vaulnaveys-le-Haut,746,123,623,15,608,1,LFI,100,7.825,31.7
2017,ISERE,Vaulnaveys-le-Haut,746,123,623,15,608,1,LO,0,7.825,31.7
2017,ISERE,Vaulnaveys-le-Haut,746,123,623,15,608,1,LR,33,7.825,31.7
2017,ISERE,Vaulnaveys-le-Haut,746,123,623,15,608,1,LREM,217,7.825,31.7
2017,ISERE,Vaulnaveys-le-Haut,746,123,623,15,608,1,NPA,6,7.825,31.7
2017,ISERE,Vaulnaveys-le-Haut,746,123,623,15,608,1,PCF,10,7.825,31.7
2017,ISERE,Vaulnaveys-le-Haut,746,123,623,15,608,1,REC,41,7.825,31.7
2017,ISERE,Vaulnaveys-le-Haut,746,123,623,15,608,1,RES,18,7.825,31.7
2017,ISERE,Le Versoud,746,150,596,9,587,1,EELV,55,7.825,31.7
2017,ISERE,Le Versoud,746,150,596,9,587,1,FN,122,7.825,31.7
2017,ISERE,Le Versoud,746,150,596,9,587,1,LFI,126,7.825,31.7
2017,ISERE,Le Versoud,746,150,596,9,587,1,LO,2,7.825,31.7
2017,ISERE,Le Versoud,746,150,596,9,587,1,LR,20,7.825,31.7
2017,ISERE,Le Versoud,746,150,596,9,587,1,LREM,156,7.825,31.7
2017,ISERE,Le Versoud,746,150,596,9,587,1,NPA,3,7.825,31.7
2017,ISERE,Le Versoud,746,150,596,9,587,1,PCF,16,7.825,31.7
2017,ISERE,Le Versoud,746,150,596,9,587,1,REC,46,7.825,31.7
2017,ISERE,Le Versoud,746,150,596,9,587,1,RES,17,7.825,31.7
2017,ISERE,Reventin-Vaugris,747,137,610,15,595,1,EELV,22,7.825,31.7
2017,ISERE,Reventin-Vaugris,747,137,610,15,595,1,FN,174,7.825,31.7
2017,ISERE,Reventin-Vaugris,747,137,610,15,595,1,LFI,95,7.825,31.7
2017,ISERE,Reventin-Vaugris,747,137,610,15,595,1,LO,5,7.825,31.7
2017,ISERE,Reventin-Vaugris,747,137,610,15,595,1,LR,30,7.825,31.7
2017,ISERE,Reventin-Vaugris,747,137,610,15,595,1,LREM,178,7.825,31.7
2017,ISERE,Reventin-Vaugris,747,137,610,15,595,1,NPA,3,7.825,31.7
2017,ISERE,Reventin-Vaugris,747,137,610,15,595,1,PCF,8,7.825,31.7
2017,ISERE,Reventin-Vaugris,747,137,610,15,595,1,REC,49,7.825,31.7
2017,ISERE,Reventin-Vaugris,747,137,610,15,595,1,RES,10,7.825,31.7
2017,ISERE,Val-de-Virieu,747,175,572,9,563,1,EELV,25,7.825,31.7
2017,ISERE,Val-de-Virieu,747,175,572,9,563,1,FN,156,7.825,31.7
2017,ISERE,Val-de-Virieu,747,175,572,9,563,1,LFI,127,7.825,31.7
2017,ISERE,Val-de-Virieu,747,175,572,9,563,1,LO,2,7.825,31.7
2017,ISERE,Val-de-Virieu,747,175,572,9,563,1,LR,22,7.825,31.7
2017,ISERE,Val-de-Virieu,747,175,572,9,563,1,LREM,134,7.825,31.7
2017,ISERE,Val-de-Virieu,747,175,572,9,563,1,NPA,8,7.825,31.7
2017,ISERE,Val-de-Virieu,747,175,572,9,563,1,PCF,6,7.825,31.7
2017,ISERE,Val-de-Virieu,747,175,572,9,563,1,REC,36,7.825,31.7
2017,ISERE,Val-de-Virieu,747,175,572,9,563,1,RES,23,7.825,31.7
2017,ISERE,Izeaux,748,187,561,20,541,1,EELV,17,7.825,31.7
2017,ISERE,Izeaux,748,187,561,20,541,1,FN,160,7.825,31.7
2017,ISERE,Izeaux,748,187,561,20,541,1,LFI,90,7.825,31.7
2017,ISERE,Izeaux,748,187,561,20,541,1,LO,3,7.825,31.7
2017,ISERE,Izeaux,748,187,561,20,541,1,LR,32,7.825,31.7
2017,ISERE,Izeaux,748,187,561,20,541,1,LREM,126,7.825,31.7
2017,ISERE,Izeaux,748,187,561,20,541,1,NPA,6,7.825,31.7
2017,ISERE,Izeaux,748,187,561,20,541,1,PCF,16,7.825,31.7
2017,ISERE,Izeaux,748,187,561,20,541,1,REC,43,7.825,31.7
2017,ISERE,Izeaux,748,187,561,20,541,1,RES,15,7.825,31.7
2017,ISERE,Meylan,749,110,639,5,634,1,EELV,64,7.825,31.7
2017,ISERE,Meylan,749,110,639,5,634,1,FN,49,7.825,31.7
2017,ISERE,Meylan,749,110,639,5,634,1,LFI,82,7.825,31.7
2017,ISERE,Meylan,749,110,639,5,634,1,LO,0,7.825,31.7
2017,ISERE,Meylan,749,110,639,5,634,1,LR,51,7.825,31.7
2017,ISERE,Meylan,749,110,639,5,634,1,LREM,307,7.825,31.7
2017,ISERE,Meylan,749,110,639,5,634,1,NPA,5,7.825,31.7
2017,ISERE,Meylan,749,110,639,5,634,1,PCF,5,7.825,31.7
2017,ISERE,Meylan,749,110,639,5,634,1,REC,43,7.825,31.7
2017,ISERE,Meylan,749,110,639,5,634,1,RES,9,7.825,31.7
2017,ISERE,Satolas-et-Bonce,749,144,605,12,593,1,EELV,31,7.825,31.7
2017,ISERE,Satolas-et-Bonce,749,144,605,12,593,1,FN,172,7.825,31.7
2017,ISERE,Satolas-et-Bonce,749,144,605,12,593,1,LFI,87,7.825,31.7
2017,ISERE,Satolas-et-Bonce,749,144,605,12,593,1,LO,4,7.825,31.7
2017,ISERE,Satolas-et-Bonce,749,144,605,12,593,1,LR,28,7.825,31.7
2017,ISERE,Satolas-et-Bonce,749,144,605,12,593,1,LREM,178,7.825,31.7
2017,ISERE,Satolas-et-Bonce,749,144,605,12,593,1,NPA,0,7.825,31.7
2017,ISERE,Satolas-et-Bonce,749,144,605,12,593,1,PCF,8,7.825,31.7
2017,ISERE,Satolas-et-Bonce,749,144,605,12,593,1,REC,56,7.825,31.7
2017,ISERE,Satolas-et-Bonce,749,144,605,12,593,1,RES,12,7.825,31.7
2017,ISERE,Pajay,749,149,600,18,582,1,EELV,20,7.825,31.7
2017,ISERE,Pajay,749,149,600,18,582,1,FN,203,7.825,31.7
2017,ISERE,Pajay,749,149,600,18,582,1,LFI,83,7.825,31.7
2017,ISERE,Pajay,749,149,600,18,582,1,LO,2,7.825,31.7
2017,ISERE,Pajay,749,149,600,18,582,1,LR,36,7.825,31.7
2017,ISERE,Pajay,749,149,600,18,582,1,LREM,132,7.825,31.7
2017,ISERE,Pajay,749,149,600,18,582,1,NPA,4,7.825,31.7
2017,ISERE,Pajay,749,149,600,18,582,1,PCF,6,7.825,31.7
2017,ISERE,Pajay,749,149,600,18,582,1,REC,50,7.825,31.7
2017,ISERE,Pajay,749,149,600,18,582,1,RES,19,7.825,31.7
2017,ISERE,Marcilloles,749,180,569,9,560,1,EELV,23,7.825,31.7
2017,ISERE,Marcilloles,749,180,569,9,560,1,FN,191,7.825,31.7
2017,ISERE,Marcilloles,749,180,569,9,560,1,LFI,92,7.825,31.7
2017,ISERE,Marcilloles,749,180,569,9,560,1,LO,2,7.825,31.7
2017,ISERE,Marcilloles,749,180,569,9,560,1,LR,21,7.825,31.7
2017,ISERE,Marcilloles,749,180,569,9,560,1,LREM,126,7.825,31.7
2017,ISERE,Marcilloles,749,180,569,9,560,1,NPA,5,7.825,31.7
2017,ISERE,Marcilloles,749,180,569,9,560,1,PCF,15,7.825,31.7
2017,ISERE,Marcilloles,749,180,569,9,560,1,REC,35,7.825,31.7
2017,ISERE,Marcilloles,749,180,569,9,560,1,RES,23,7.825,31.7
2017,ISERE,Echirolles,749,394,355,10,345,1,EELV,5,7.825,31.7
2017,ISERE,Echirolles,749,394,355,10,345,1,FN,39,7.825,31.7
2017,ISERE,Echirolles,749,394,355,10,345,1,LFI,220,7.825,31.7
2017,ISERE,Echirolles,749,394,355,10,345,1,LO,4,7.825,31.7
2017,ISERE,Echirolles,749,394,355,10,345,1,LR,3,7.825,31.7
2017,ISERE,Echirolles,749,394,355,10,345,1,LREM,51,7.825,31.7
2017,ISERE,Echirolles,749,394,355,10,345,1,NPA,1,7.825,31.7
2017,ISERE,Echirolles,749,394,355,10,345,1,PCF,4,7.825,31.7
2017,ISERE,Echirolles,749,394,355,10,345,1,REC,8,7.825,31.7
2017,ISERE,Echirolles,749,394,355,10,345,1,RES,3,7.825,31.7
2017,ISERE,Les Eparres,750,168,582,16,566,1,EELV,38,7.825,31.7
2017,ISERE,Les Eparres,750,168,582,16,566,1,FN,178,7.825,31.7
2017,ISERE,Les Eparres,750,168,582,16,566,1,LFI,75,7.825,31.7
2017,ISERE,Les Eparres,750,168,582,16,566,1,LO,2,7.825,31.7
2017,ISERE,Les Eparres,750,168,582,16,566,1,LR,33,7.825,31.7
2017,ISERE,Les Eparres,750,168,582,16,566,1,LREM,138,7.825,31.7
2017,ISERE,Les Eparres,750,168,582,16,566,1,NPA,2,7.825,31.7
2017,ISERE,Les Eparres,750,168,582,16,566,1,PCF,9,7.825,31.7
2017,ISERE,Les Eparres,750,168,582,16,566,1,REC,50,7.825,31.7
2017,ISERE,Les Eparres,750,168,582,16,566,1,RES,21,7.825,31.7
2017,ISERE,Grenoble,750,228,522,7,515,1,EELV,31,7.825,31.7
2017,ISERE,Grenoble,750,228,522,7,515,1,FN,60,7.825,31.7
2017,ISERE,Grenoble,750,228,522,7,515,1,LFI,204,7.825,31.7
2017,ISERE,Grenoble,750,228,522,7,515,1,LO,6,7.825,31.7
2017,ISERE,Grenoble,750,228,522,7,515,1,LR,11,7.825,31.7
2017,ISERE,Grenoble,750,228,522,7,515,1,LREM,118,7.825,31.7
2017,ISERE,Grenoble,750,228,522,7,515,1,NPA,6,7.825,31.7
2017,ISERE,Grenoble,750,228,522,7,515,1,PCF,11,7.825,31.7
2017,ISERE,Grenoble,750,228,522,7,515,1,REC,41,7.825,31.7
2017,ISERE,Grenoble,750,228,522,7,515,1,RES,7,7.825,31.7
2017,ISERE,Anjou,752,174,578,19,559,1,EELV,22,7.825,31.7
2017,ISERE,Anjou,752,174,578,19,559,1,FN,160,7.825,31.7
2017,ISERE,Anjou,752,174,578,19,559,1,LFI,107,7.825,31.7
2017,ISERE,Anjou,752,174,578,19,559,1,LO,4,7.825,31.7
2017,ISERE,Anjou,752,174,578,19,559,1,LR,23,7.825,31.7
2017,ISERE,Anjou,752,174,578,19,559,1,LREM,145,7.825,31.7
2017,ISERE,Anjou,752,174,578,19,559,1,NPA,8,7.825,31.7
2017,ISERE,Anjou,752,174,578,19,559,1,PCF,10,7.825,31.7
2017,ISERE,Anjou,752,174,578,19,559,1,REC,39,7.825,31.7
2017,ISERE,Anjou,752,174,578,19,559,1,RES,17,7.825,31.7
2017,ISERE,Grenoble,753,214,539,15,524,1,EELV,34,7.825,31.7
2017,ISERE,Grenoble,753,214,539,15,524,1,FN,69,7.825,31.7
2017,ISERE,Grenoble,753,214,539,15,524,1,LFI,208,7.825,31.7
2017,ISERE,Grenoble,753,214,539,15,524,1,LO,3,7.825,31.7
2017,ISERE,Grenoble,753,214,539,15,524,1,LR,14,7.825,31.7
2017,ISERE,Grenoble,753,214,539,15,524,1,LREM,127,7.825,31.7
2017,ISERE,Grenoble,753,214,539,15,524,1,NPA,2,7.825,31.7
2017,ISERE,Grenoble,753,214,539,15,524,1,PCF,13,7.825,31.7
2017,ISERE,Grenoble,753,214,539,15,524,1,REC,30,7.825,31.7
2017,ISERE,Grenoble,753,214,539,15,524,1,RES,5,7.825,31.7
2017,ISERE,Grenoble,753,220,533,13,520,1,EELV,45,7.825,31.7
2017,ISERE,Grenoble,753,220,533,13,520,1,FN,86,7.825,31.7
2017,ISERE,Grenoble,753,220,533,13,520,1,LFI,199,7.825,31.7
2017,ISERE,Grenoble,753,220,533,13,520,1,LO,4,7.825,31.7
2017,ISERE,Grenoble,753,220,533,13,520,1,LR,10,7.825,31.7
2017,ISERE,Grenoble,753,220,533,13,520,1,LREM,115,7.825,31.7
2017,ISERE,Grenoble,753,220,533,13,520,1,NPA,7,7.825,31.7
2017,ISERE,Grenoble,753,220,533,13,520,1,PCF,7,7.825,31.7
2017,ISERE,Grenoble,753,220,533,13,520,1,REC,18,7.825,31.7
2017,ISERE,Grenoble,753,220,533,13,520,1,RES,5,7.825,31.7
2017,ISERE,Sermérieu,757,136,621,15,606,1,EELV,34,7.825,31.7
2017,ISERE,Sermérieu,757,136,621,15,606,1,FN,215,7.825,31.7
2017,ISERE,Sermérieu,757,136,621,15,606,1,LFI,78,7.825,31.7
2017,ISERE,Sermérieu,757,136,621,15,606,1,LO,3,7.825,31.7
2017,ISERE,Sermérieu,757,136,621,15,606,1,LR,20,7.825,31.7
2017,ISERE,Sermérieu,757,136,621,15,606,1,LREM,140,7.825,31.7
2017,ISERE,Sermérieu,757,136,621,15,606,1,NPA,4,7.825,31.7
2017,ISERE,Sermérieu,757,136,621,15,606,1,PCF,17,7.825,31.7
2017,ISERE,Sermérieu,757,136,621,15,606,1,REC,42,7.825,31.7
2017,ISERE,Sermérieu,757,136,621,15,606,1,RES,19,7.825,31.7
2017,ISERE,Creys-Mépieu,757,164,593,18,575,1,EELV,24,7.825,31.7
2017,ISERE,Creys-Mépieu,757,164,593,18,575,1,FN,207,7.825,31.7
2017,ISERE,Creys-Mépieu,757,164,593,18,575,1,LFI,66,7.825,31.7
2017,ISERE,Creys-Mépieu,757,164,593,18,575,1,LO,4,7.825,31.7
2017,ISERE,Creys-Mépieu,757,164,593,18,575,1,LR,26,7.825,31.7
2017,ISERE,Creys-Mépieu,757,164,593,18,575,1,LREM,136,7.825,31.7
2017,ISERE,Creys-Mépieu,757,164,593,18,575,1,NPA,5,7.825,31.7
2017,ISERE,Creys-Mépieu,757,164,593,18,575,1,PCF,14,7.825,31.7
2017,ISERE,Creys-Mépieu,757,164,593,18,575,1,REC,49,7.825,31.7
2017,ISERE,Creys-Mépieu,757,164,593,18,575,1,RES,32,7.825,31.7
2017,ISERE,Meylan,760,117,643,3,640,1,EELV,34,7.825,31.7
2017,ISERE,Meylan,760,117,643,3,640,1,FN,53,7.825,31.7
2017,ISERE,Meylan,760,117,643,3,640,1,LFI,78,7.825,31.7
2017,ISERE,Meylan,760,117,643,3,640,1,LO,3,7.825,31.7
2017,ISERE,Meylan,760,117,643,3,640,1,LR,51,7.825,31.7
2017,ISERE,Meylan,760,117,643,3,640,1,LREM,308,7.825,31.7
2017,ISERE,Meylan,760,117,643,3,640,1,NPA,3,7.825,31.7
2017,ISERE,Meylan,760,117,643,3,640,1,PCF,4,7.825,31.7
2017,ISERE,Meylan,760,117,643,3,640,1,REC,87,7.825,31.7
2017,ISERE,Meylan,760,117,643,3,640,1,RES,5,7.825,31.7
2017,ISERE,Saint-Egrève,760,193,567,10,557,1,EELV,45,7.825,31.7
2017,ISERE,Saint-Egrève,760,193,567,10,557,1,FN,108,7.825,31.7
2017,ISERE,Saint-Egrève,760,193,567,10,557,1,LFI,150,7.825,31.7
2017,ISERE,Saint-Egrève,760,193,567,10,557,1,LO,1,7.825,31.7
2017,ISERE,Saint-Egrève,760,193,567,10,557,1,LR,17,7.825,31.7
2017,ISERE,Saint-Egrève,760,193,567,10,557,1,LREM,156,7.825,31.7
2017,ISERE,Saint-Egrève,760,193,567,10,557,1,NPA,6,7.825,31.7
2017,ISERE,Saint-Egrève,760,193,567,10,557,1,PCF,11,7.825,31.7
2017,ISERE,Saint-Egrève,760,193,567,10,557,1,REC,33,7.825,31.7
2017,ISERE,Saint-Egrève,760,193,567,10,557,1,RES,9,7.825,31.7
2017,ISERE,Les Avenières Veyrins-Thuellin,760,203,557,13,544,1,EELV,22,7.825,31.7
2017,ISERE,Les Avenières Veyrins-Thuellin,760,203,557,13,544,1,FN,192,7.825,31.7
2017,ISERE,Les Avenières Veyrins-Thuellin,760,203,557,13,544,1,LFI,61,7.825,31.7
2017,ISERE,Les Avenières Veyrins-Thuellin,760,203,557,13,544,1,LO,4,7.825,31.7
2017,ISERE,Les Avenières Veyrins-Thuellin,760,203,557,13,544,1,LR,33,7.825,31.7
2017,ISERE,Les Avenières Veyrins-Thuellin,760,203,557,13,544,1,LREM,156,7.825,31.7
2017,ISERE,Les Avenières Veyrins-Thuellin,760,203,557,13,544,1,NPA,4,7.825,31.7
2017,ISERE,Les Avenières Veyrins-Thuellin,760,203,557,13,544,1,PCF,3,7.825,31.7
2017,ISERE,Les Avenières Veyrins-Thuellin,760,203,557,13,544,1,REC,31,7.825,31.7
2017,ISERE,Les Avenières Veyrins-Thuellin,760,203,557,13,544,1,RES,17,7.825,31.7
2017,ISERE,Oyeu,761,127,634,12,622,1,EELV,35,7.825,31.7
2017,ISERE,Oyeu,761,127,634,12,622,1,FN,152,7.825,31.7
2017,ISERE,Oyeu,761,127,634,12,622,1,LFI,102,7.825,31.7
2017,ISERE,Oyeu,761,127,634,12,622,1,LO,4,7.825,31.7
2017,ISERE,Oyeu,761,127,634,12,622,1,LR,36,7.825,31.7
2017,ISERE,Oyeu,761,127,634,12,622,1,LREM,187,7.825,31.7
2017,ISERE,Oyeu,761,127,634,12,622,1,NPA,3,7.825,31.7
2017,ISERE,Oyeu,761,127,634,12,622,1,PCF,12,7.825,31.7
2017,ISERE,Oyeu,761,127,634,12,622,1,REC,42,7.825,31.7
2017,ISERE,Oyeu,761,127,634,12,622,1,RES,18,7.825,31.7
2017,ISERE,Saint-Jean-de-Bournay,761,135,626,21,605,1,EELV,30,7.825,31.7
2017,ISERE,Saint-Jean-de-Bournay,761,135,626,21,605,1,FN,190,7.825,31.7
2017,ISERE,Saint-Jean-de-Bournay,761,135,626,21,605,1,LFI,94,7.825,31.7
2017,ISERE,Saint-Jean-de-Bournay,761,135,626,21,605,1,LO,1,7.825,31.7
2017,ISERE,Saint-Jean-de-Bournay,761,135,626,21,605,1,LR,38,7.825,31.7
2017,ISERE,Saint-Jean-de-Bournay,761,135,626,21,605,1,LREM,161,7.825,31.7
2017,ISERE,Saint-Jean-de-Bournay,761,135,626,21,605,1,NPA,3,7.825,31.7
2017,ISERE,Saint-Jean-de-Bournay,761,135,626,21,605,1,PCF,6,7.825,31.7
2017,ISERE,Saint-Jean-de-Bournay,761,135,626,21,605,1,REC,48,7.825,31.7
2017,ISERE,Saint-Jean-de-Bournay,761,135,626,21,605,1,RES,18,7.825,31.7
2017,ISERE,Poisat,762,113,649,18,631,1,EELV,59,7.825,31.7
2017,ISERE,Poisat,762,113,649,18,631,1,FN,94,7.825,31.7
2017,ISERE,Poisat,762,113,649,18,631,1,LFI,156,7.825,31.7
2017,ISERE,Poisat,762,113,649,18,631,1,LO,1,7.825,31.7
2017,ISERE,Poisat,762,113,649,18,631,1,LR,30,7.825,31.7
2017,ISERE,Poisat,762,113,649,18,631,1,LREM,184,7.825,31.7
2017,ISERE,Poisat,762,113,649,18,631,1,NPA,2,7.825,31.7
2017,ISERE,Poisat,762,113,649,18,631,1,PCF,22,7.825,31.7
2017,ISERE,Poisat,762,113,649,18,631,1,REC,42,7.825,31.7
2017,ISERE,Poisat,762,113,649,18,631,1,RES,12,7.825,31.7
2017,ISERE,Chanas,762,177,585,14,571,1,EELV,8,7.825,31.7
2017,ISERE,Chanas,762,177,585,14,571,1,FN,201,7.825,31.7
2017,ISERE,Chanas,762,177,585,14,571,1,LFI,98,7.825,31.7
2017,ISERE,Chanas,762,177,585,14,571,1,LO,2,7.825,31.7
2017,ISERE,Chanas,762,177,585,14,571,1,LR,27,7.825,31.7
2017,ISERE,Chanas,762,177,585,14,571,1,LREM,135,7.825,31.7
2017,ISERE,Chanas,762,177,585,14,571,1,NPA,4,7.825,31.7
2017,ISERE,Chanas,762,177,585,14,571,1,PCF,16,7.825,31.7
2017,ISERE,Chanas,762,177,585,14,571,1,REC,39,7.825,31.7
2017,ISERE,Chanas,762,177,585,14,571,1,RES,20,7.825,31.7
2017,ISERE,Voreppe,766,140,626,16,610,1,EELV,51,7.825,31.7
2017,ISERE,Voreppe,766,140,626,16,610,1,FN,100,7.825,31.7
2017,ISERE,Voreppe,766,140,626,16,610,1,LFI,149,7.825,31.7
2017,ISERE,Voreppe,766,140,626,16,610,1,LO,2,7.825,31.7
2017,ISERE,Voreppe,766,140,626,16,610,1,LR,29,7.825,31.7
2017,ISERE,Voreppe,766,140,626,16,610,1,LREM,180,7.825,31.7
2017,ISERE,Voreppe,766,140,626,16,610,1,NPA,1,7.825,31.7
2017,ISERE,Voreppe,766,140,626,16,610,1,PCF,17,7.825,31.7
2017,ISERE,Voreppe,766,140,626,16,610,1,REC,48,7.825,31.7
2017,ISERE,Voreppe,766,140,626,16,610,1,RES,18,7.825,31.7
2017,ISERE,L'Isle-d'Abeau,768,217,551,12,539,1,EELV,28,7.825,31.7
2017,ISERE,L'Isle-d'Abeau,768,217,551,12,539,1,FN,174,7.825,31.7
2017,ISERE,L'Isle-d'Abeau,768,217,551,12,539,1,LFI,137,7.825,31.7
2017,ISERE,L'Isle-d'Abeau,768,217,551,12,539,1,LO,3,7.825,31.7
2017,ISERE,L'Isle-d'Abeau,768,217,551,12,539,1,LR,20,7.825,31.7
2017,ISERE,L'Isle-d'Abeau,768,217,551,12,539,1,LREM,104,7.825,31.7
2017,ISERE,L'Isle-d'Abeau,768,217,551,12,539,1,NPA,2,7.825,31.7
2017,ISERE,L'Isle-d'Abeau,768,217,551,12,539,1,PCF,13,7.825,31.7
2017,ISERE,L'Isle-d'Abeau,768,217,551,12,539,1,REC,24,7.825,31.7
2017,ISERE,L'Isle-d'Abeau,768,217,551,12,539,1,RES,9,7.825,31.7
2017,ISERE,Voreppe,769,151,618,13,605,1,EELV,45,7.825,31.7
2017,ISERE,Voreppe,769,151,618,13,605,1,FN,121,7.825,31.7
2017,ISERE,Voreppe,769,151,618,13,605,1,LFI,126,7.825,31.7
2017,ISERE,Voreppe,769,151,618,13,605,1,LO,1,7.825,31.7
2017,ISERE,Voreppe,769,151,618,13,605,1,LR,30,7.825,31.7
2017,ISERE,Voreppe,769,151,618,13,605,1,LREM,208,7.825,31.7
2017,ISERE,Voreppe,769,151,618,13,605,1,NPA,3,7.825,31.7
2017,ISERE,Voreppe,769,151,618,13,605,1,PCF,13,7.825,31.7
2017,ISERE,Voreppe,769,151,618,13,605,1,REC,27,7.825,31.7
2017,ISERE,Voreppe,769,151,618,13,605,1,RES,13,7.825,31.7
2017,ISERE,Grenoble,771,197,574,6,568,1,EELV,43,7.825,31.7
2017,ISERE,Grenoble,771,197,574,6,568,1,FN,49,7.825,31.7
2017,ISERE,Grenoble,771,197,574,6,568,1,LFI,204,7.825,31.7
2017,ISERE,Grenoble,771,197,574,6,568,1,LO,7,7.825,31.7
2017,ISERE,Grenoble,771,197,574,6,568,1,LR,23,7.825,31.7
2017,ISERE,Grenoble,771,197,574,6,568,1,LREM,145,7.825,31.7
2017,ISERE,Grenoble,771,197,574,6,568,1,NPA,7,7.825,31.7
2017,ISERE,Grenoble,771,197,574,6,568,1,PCF,16,7.825,31.7
2017,ISERE,Grenoble,771,197,574,6,568,1,REC,32,7.825,31.7
2017,ISERE,Grenoble,771,197,574,6,568,1,RES,17,7.825,31.7
2017,ISERE,Vignieu,773,170,603,26,577,1,EELV,24,7.825,31.7
2017,ISERE,Vignieu,773,170,603,26,577,1,FN,193,7.825,31.7
2017,ISERE,Vignieu,773,170,603,26,577,1,LFI,95,7.825,31.7
2017,ISERE,Vignieu,773,170,603,26,577,1,LO,3,7.825,31.7
2017,ISERE,Vignieu,773,170,603,26,577,1,LR,19,7.825,31.7
2017,ISERE,Vignieu,773,170,603,26,577,1,LREM,131,7.825,31.7
2017,ISERE,Vignieu,773,170,603,26,577,1,NPA,4,7.825,31.7
2017,ISERE,Vignieu,773,170,603,26,577,1,PCF,8,7.825,31.7
2017,ISERE,Vignieu,773,170,603,26,577,1,REC,55,7.825,31.7
2017,ISERE,Vignieu,773,170,603,26,577,1,RES,15,7.825,31.7
2017,ISERE,Saint-Clair-de-la-Tour,773,178,595,15,580,1,EELV,21,7.825,31.7
2017,ISERE,Saint-Clair-de-la-Tour,773,178,595,15,580,1,FN,177,7.825,31.7
2017,ISERE,Saint-Clair-de-la-Tour,773,178,595,15,580,1,LFI,117,7.825,31.7
2017,ISERE,Saint-Clair-de-la-Tour,773,178,595,15,580,1,LO,7,7.825,31.7
2017,ISERE,Saint-Clair-de-la-Tour,773,178,595,15,580,1,LR,20,7.825,31.7
2017,ISERE,Saint-Clair-de-la-Tour,773,178,595,15,580,1,LREM,144,7.825,31.7
2017,ISERE,Saint-Clair-de-la-Tour,773,178,595,15,580,1,NPA,4,7.825,31.7
2017,ISERE,Saint-Clair-de-la-Tour,773,178,595,15,580,1,PCF,14,7.825,31.7
2017,ISERE,Saint-Clair-de-la-Tour,773,178,595,15,580,1,REC,41,7.825,31.7
2017,ISERE,Saint-Clair-de-la-Tour,773,178,595,15,580,1,RES,5,7.825,31.7
2017,ISERE,Saint-Victor-de-Cessieu,777,158,619,4,615,1,EELV,28,7.825,31.7
2017,ISERE,Saint-Victor-de-Cessieu,777,158,619,4,615,1,FN,222,7.825,31.7
2017,ISERE,Saint-Victor-de-Cessieu,777,158,619,4,615,1,LFI,76,7.825,31.7
2017,ISERE,Saint-Victor-de-Cessieu,777,158,619,4,615,1,LO,3,7.825,31.7
2017,ISERE,Saint-Victor-de-Cessieu,777,158,619,4,615,1,LR,31,7.825,31.7
2017,ISERE,Saint-Victor-de-Cessieu,777,158,619,4,615,1,LREM,143,7.825,31.7
2017,ISERE,Saint-Victor-de-Cessieu,777,158,619,4,615,1,NPA,3,7.825,31.7
2017,ISERE,Saint-Victor-de-Cessieu,777,158,619,4,615,1,PCF,11,7.825,31.7
2017,ISERE,Saint-Victor-de-Cessieu,777,158,619,4,615,1,REC,48,7.825,31.7
2017,ISERE,Saint-Victor-de-Cessieu,777,158,619,4,615,1,RES,21,7.825,31.7
2017,ISERE,Saint-Agnin-sur-Bion,780,119,661,14,647,1,EELV,34,7.825,31.7
2017,ISERE,Saint-Agnin-sur-Bion,780,119,661,14,647,1,FN,216,7.825,31.7
2017,ISERE,Saint-Agnin-sur-Bion,780,119,661,14,647,1,LFI,69,7.825,31.7
2017,ISERE,Saint-Agnin-sur-Bion,780,119,661,14,647,1,LO,4,7.825,31.7
2017,ISERE,Saint-Agnin-sur-Bion,780,119,661,14,647,1,LR,33,7.825,31.7
2017,ISERE,Saint-Agnin-sur-Bion,780,119,661,14,647,1,LREM,159,7.825,31.7
2017,ISERE,Saint-Agnin-sur-Bion,780,119,661,14,647,1,NPA,2,7.825,31.7
2017,ISERE,Saint-Agnin-sur-Bion,780,119,661,14,647,1,PCF,17,7.825,31.7
2017,ISERE,Saint-Agnin-sur-Bion,780,119,661,14,647,1,REC,45,7.825,31.7
2017,ISERE,Saint-Agnin-sur-Bion,780,119,661,14,647,1,RES,29,7.825,31.7
2017,ISERE,Jarrie,780,125,655,13,642,1,EELV,52,7.825,31.7
2017,ISERE,Jarrie,780,125,655,13,642,1,FN,139,7.825,31.7
2017,ISERE,Jarrie,780,125,655,13,642,1,LFI,111,7.825,31.7
2017,ISERE,Jarrie,780,125,655,13,642,1,LO,4,7.825,31.7
2017,ISERE,Jarrie,780,125,655,13,642,1,LR,23,7.825,31.7
2017,ISERE,Jarrie,780,125,655,13,642,1,LREM,221,7.825,31.7
2017,ISERE,Jarrie,780,125,655,13,642,1,NPA,6,7.825,31.7
2017,ISERE,Jarrie,780,125,655,13,642,1,PCF,17,7.825,31.7
2017,ISERE,Jarrie,780,125,655,13,642,1,REC,38,7.825,31.7
2017,ISERE,Jarrie,780,125,655,13,642,1,RES,9,7.825,31.7
2017,ISERE,Saint-Ismier,780,139,641,8,633,1,EELV,45,7.825,31.7
2017,ISERE,Saint-Ismier,780,139,641,8,633,1,FN,98,7.825,31.7
2017,ISERE,Saint-Ismier,780,139,641,8,633,1,LFI,95,7.825,31.7
2017,ISERE,Saint-Ismier,780,139,641,8,633,1,LO,0,7.825,31.7
2017,ISERE,Saint-Ismier,780,139,641,8,633,1,LR,41,7.825,31.7
2017,ISERE,Saint-Ismier,780,139,641,8,633,1,LREM,266,7.825,31.7
2017,ISERE,Saint-Ismier,780,139,641,8,633,1,NPA,2,7.825,31.7
2017,ISERE,Saint-Ismier,780,139,641,8,633,1,PCF,6,7.825,31.7
2017,ISERE,Saint-Ismier,780,139,641,8,633,1,REC,41,7.825,31.7
2017,ISERE,Saint-Ismier,780,139,641,8,633,1,RES,12,7.825,31.7
2017,ISERE,Maubec,781,149,632,9,623,1,EELV,33,7.825,31.7
2017,ISERE,Maubec,781,149,632,9,623,1,FN,137,7.825,31.7
2017,ISERE,Maubec,781,149,632,9,623,1,LFI,83,7.825,31.7
2017,ISERE,Maubec,781,149,632,9,623,1,LO,1,7.825,31.7
2017,ISERE,Maubec,781,149,632,9,623,1,LR,48,7.825,31.7
2017,ISERE,Maubec,781,149,632,9,623,1,LREM,216,7.825,31.7
2017,ISERE,Maubec,781,149,632,9,623,1,NPA,2,7.825,31.7
2017,ISERE,Maubec,781,149,632,9,623,1,PCF,7,7.825,31.7
2017,ISERE,Maubec,781,149,632,9,623,1,REC,45,7.825,31.7
2017,ISERE,Maubec,781,149,632,9,623,1,RES,22,7.825,31.7
2017,ISERE,Saint-Jean-de-Bournay,781,162,619,22,597,1,EELV,20,7.825,31.7
2017,ISERE,Saint-Jean-de-Bournay,781,162,619,22,597,1,FN,179,7.825,31.7
2017,ISERE,Saint-Jean-de-Bournay,781,162,619,22,597,1,LFI,87,7.825,31.7
2017,ISERE,Saint-Jean-de-Bournay,781,162,619,22,597,1,LO,2,7.825,31.7
2017,ISERE,Saint-Jean-de-Bournay,781,162,619,22,597,1,LR,38,7.825,31.7
2017,ISERE,Saint-Jean-de-Bournay,781,162,619,22,597,1,LREM,157,7.825,31.7
2017,ISERE,Saint-Jean-de-Bournay,781,162,619,22,597,1,NPA,2,7.825,31.7
2017,ISERE,Saint-Jean-de-Bournay,781,162,619,22,597,1,PCF,11,7.825,31.7
2017,ISERE,Saint-Jean-de-Bournay,781,162,619,22,597,1,REC,44,7.825,31.7
2017,ISERE,Saint-Jean-de-Bournay,781,162,619,22,597,1,RES,25,7.825,31.7
2017,ISERE,Beaurepaire,781,266,515,10,505,1,EELV,24,7.825,31.7
2017,ISERE,Beaurepaire,781,266,515,10,505,1,FN,143,7.825,31.7
2017,ISERE,Beaurepaire,781,266,515,10,505,1,LFI,95,7.825,31.7
2017,ISERE,Beaurepaire,781,266,515,10,505,1,LO,4,7.825,31.7
2017,ISERE,Beaurepaire,781,266,515,10,505,1,LR,15,7.825,31.7
2017,ISERE,Beaurepaire,781,266,515,10,505,1,LREM,137,7.825,31.7
2017,ISERE,Beaurepaire,781,266,515,10,505,1,NPA,2,7.825,31.7
2017,ISERE,Beaurepaire,781,266,515,10,505,1,PCF,14,7.825,31.7
2017,ISERE,Beaurepaire,781,266,515,10,505,1,REC,35,7.825,31.7
2017,ISERE,Beaurepaire,781,266,515,10,505,1,RES,14,7.825,31.7
2017,ISERE,Gières,782,166,616,8,608,1,EELV,41,7.825,31.7
2017,ISERE,Gières,782,166,616,8,608,1,FN,120,7.825,31.7
2017,ISERE,Gières,782,166,616,8,608,1,LFI,143,7.825,31.7
2017,ISERE,Gières,782,166,616,8,608,1,LO,4,7.825,31.7
2017,ISERE,Gières,782,166,616,8,608,1,LR,29,7.825,31.7
2017,ISERE,Gières,782,166,616,8,608,1,LREM,196,7.825,31.7
2017,ISERE,Gières,782,166,616,8,608,1,NPA,5,7.825,31.7
2017,ISERE,Gières,782,166,616,8,608,1,PCF,8,7.825,31.7
2017,ISERE,Gières,782,166,616,8,608,1,REC,32,7.825,31.7
2017,ISERE,Gières,782,166,616,8,608,1,RES,14,7.825,31.7
2017,ISERE,Saint-Ismier,783,135,648,8,640,1,EELV,41,7.825,31.7
2017,ISERE,Saint-Ismier,783,135,648,8,640,1,FN,123,7.825,31.7
2017,ISERE,Saint-Ismier,783,135,648,8,640,1,LFI,87,7.825,31.7
2017,ISERE,Saint-Ismier,783,135,648,8,640,1,LO,1,7.825,31.7
2017,ISERE,Saint-Ismier,783,135,648,8,640,1,LR,36,7.825,31.7
2017,ISERE,Saint-Ismier,783,135,648,8,640,1,LREM,247,7.825,31.7
2017,ISERE,Saint-Ismier,783,135,648,8,640,1,NPA,3,7.825,31.7
2017,ISERE,Saint-Ismier,783,135,648,8,640,1,PCF,13,7.825,31.7
2017,ISERE,Saint-Ismier,783,135,648,8,640,1,REC,50,7.825,31.7
2017,ISERE,Saint-Ismier,783,135,648,8,640,1,RES,19,7.825,31.7
2017,ISERE,Faramans,784,152,632,15,617,1,EELV,25,7.825,31.7
2017,ISERE,Faramans,784,152,632,15,617,1,FN,225,7.825,31.7
2017,ISERE,Faramans,784,152,632,15,617,1,LFI,70,7.825,31.7
2017,ISERE,Faramans,784,152,632,15,617,1,LO,2,7.825,31.7
2017,ISERE,Faramans,784,152,632,15,617,1,LR,34,7.825,31.7
2017,ISERE,Faramans,784,152,632,15,617,1,LREM,151,7.825,31.7
2017,ISERE,Faramans,784,152,632,15,617,1,NPA,8,7.825,31.7
2017,ISERE,Faramans,784,152,632,15,617,1,PCF,11,7.825,31.7
2017,ISERE,Faramans,784,152,632,15,617,1,REC,44,7.825,31.7
2017,ISERE,Faramans,784,152,632,15,617,1,RES,22,7.825,31.7
2017,ISERE,Saint-Didier-de-la-Tour,785,178,607,8,599,1,EELV,25,7.825,31.7
2017,ISERE,Saint-Didier-de-la-Tour,785,178,607,8,599,1,FN,238,7.825,31.7
2017,ISERE,Saint-Didier-de-la-Tour,785,178,607,8,599,1,LFI,93,7.825,31.7
2017,ISERE,Saint-Didier-de-la-Tour,785,178,607,8,599,1,LO,5,7.825,31.7
2017,ISERE,Saint-Didier-de-la-Tour,785,178,607,8,599,1,LR,22,7.825,31.7
2017,ISERE,Saint-Didier-de-la-Tour,785,178,607,8,599,1,LREM,121,7.825,31.7
2017,ISERE,Saint-Didier-de-la-Tour,785,178,607,8,599,1,NPA,4,7.825,31.7
2017,ISERE,Saint-Didier-de-la-Tour,785,178,607,8,599,1,PCF,10,7.825,31.7
2017,ISERE,Saint-Didier-de-la-Tour,785,178,607,8,599,1,REC,51,7.825,31.7
2017,ISERE,Saint-Didier-de-la-Tour,785,178,607,8,599,1,RES,7,7.825,31.7
2017,ISERE,Seyssinet-Pariset,786,212,574,9,565,1,EELV,26,7.825,31.7
2017,ISERE,Seyssinet-Pariset,786,212,574,9,565,1,FN,164,7.825,31.7
2017,ISERE,Seyssinet-Pariset,786,212,574,9,565,1,LFI,138,7.825,31.7
2017,ISERE,Seyssinet-Pariset,786,212,574,9,565,1,LO,5,7.825,31.7
2017,ISERE,Seyssinet-Pariset,786,212,574,9,565,1,LR,19,7.825,31.7
2017,ISERE,Seyssinet-Pariset,786,212,574,9,565,1,LREM,125,7.825,31.7
2017,ISERE,Seyssinet-Pariset,786,212,574,9,565,1,NPA,4,7.825,31.7
2017,ISERE,Seyssinet-Pariset,786,212,574,9,565,1,PCF,10,7.825,31.7
2017,ISERE,Seyssinet-Pariset,786,212,574,9,565,1,REC,42,7.825,31.7
2017,ISERE,Seyssinet-Pariset,786,212,574,9,565,1,RES,12,7.825,31.7
2017,ISERE,Meylan,789,113,676,6,670,1,EELV,54,7.825,31.7
2017,ISERE,Meylan,789,113,676,6,670,1,FN,54,7.825,31.7
2017,ISERE,Meylan,789,113,676,6,670,1,LFI,101,7.825,31.7
2017,ISERE,Meylan,789,113,676,6,670,1,LO,1,7.825,31.7
2017,ISERE,Meylan,789,113,676,6,670,1,LR,53,7.825,31.7
2017,ISERE,Meylan,789,113,676,6,670,1,LREM,312,7.825,31.7
2017,ISERE,Meylan,789,113,676,6,670,1,NPA,2,7.825,31.7
2017,ISERE,Meylan,789,113,676,6,670,1,PCF,8,7.825,31.7
2017,ISERE,Meylan,789,113,676,6,670,1,REC,54,7.825,31.7
2017,ISERE,Meylan,789,113,676,6,670,1,RES,9,7.825,31.7
2017,ISERE,Réaumont,789,123,666,16,650,1,EELV,36,7.825,31.7
2017,ISERE,Réaumont,789,123,666,16,650,1,FN,124,7.825,31.7
2017,ISERE,Réaumont,789,123,666,16,650,1,LFI,118,7.825,31.7
2017,ISERE,Réaumont,789,123,666,16,650,1,LO,6,7.825,31.7
2017,ISERE,Réaumont,789,123,666,16,650,1,LR,19,7.825,31.7
2017,ISERE,Réaumont,789,123,666,16,650,1,LREM,209,7.825,31.7
2017,ISERE,Réaumont,789,123,666,16,650,1,NPA,6,7.825,31.7
2017,ISERE,Réaumont,789,123,666,16,650,1,PCF,13,7.825,31.7
2017,ISERE,Réaumont,789,123,666,16,650,1,REC,59,7.825,31.7
2017,ISERE,Réaumont,789,123,666,16,650,1,RES,23,7.825,31.7
2017,ISERE,Seyssins,789,127,662,10,652,1,EELV,47,7.825,31.7
2017,ISERE,Seyssins,789,127,662,10,652,1,FN,115,7.825,31.7
2017,ISERE,Seyssins,789,127,662,10,652,1,LFI,138,7.825,31.7
2017,ISERE,Seyssins,789,127,662,10,652,1,LO,2,7.825,31.7
2017,ISERE,Seyssins,789,127,662,10,652,1,LR,34,7.825,31.7
2017,ISERE,Seyssins,789,127,662,10,652,1,LREM,205,7.825,31.7
2017,ISERE,Seyssins,789,127,662,10,652,1,NPA,3,7.825,31.7
2017,ISERE,Seyssins,789,127,662,10,652,1,PCF,10,7.825,31.7
2017,ISERE,Seyssins,789,127,662,10,652,1,REC,59,7.825,31.7
2017,ISERE,Seyssins,789,127,662,10,652,1,RES,12,7.825,31.7
2017,ISERE,Sardieu,789,132,657,8,649,1,EELV,26,7.825,31.7
2017,ISERE,Sardieu,789,132,657,8,649,1,FN,230,7.825,31.7
2017,ISERE,Sardieu,789,132,657,8,649,1,LFI,109,7.825,31.7
2017,ISERE,Sardieu,789,132,657,8,649,1,LO,2,7.825,31.7
2017,ISERE,Sardieu,789,132,657,8,649,1,LR,49,7.825,31.7
2017,ISERE,Sardieu,789,132,657,8,649,1,LREM,117,7.825,31.7
2017,ISERE,Sardieu,789,132,657,8,649,1,NPA,0,7.825,31.7
2017,ISERE,Sardieu,789,132,657,8,649,1,PCF,8,7.825,31.7
2017,ISERE,Sardieu,789,132,657,8,649,1,REC,57,7.825,31.7
2017,ISERE,Sardieu,789,132,657,8,649,1,RES,26,7.825,31.7
2017,ISERE,Charantonnay,789,152,637,13,624,1,EELV,25,7.825,31.7
2017,ISERE,Charantonnay,789,152,637,13,624,1,FN,218,7.825,31.7
2017,ISERE,Charantonnay,789,152,637,13,624,1,LFI,98,7.825,31.7
2017,ISERE,Charantonnay,789,152,637,13,624,1,LO,5,7.825,31.7
2017,ISERE,Charantonnay,789,152,637,13,624,1,LR,18,7.825,31.7
2017,ISERE,Charantonnay,789,152,637,13,624,1,LREM,138,7.825,31.7
2017,ISERE,Charantonnay,789,152,637,13,624,1,NPA,1,7.825,31.7
2017,ISERE,Charantonnay,789,152,637,13,624,1,PCF,10,7.825,31.7
2017,ISERE,Charantonnay,789,152,637,13,624,1,REC,64,7.825,31.7
2017,ISERE,Charantonnay,789,152,637,13,624,1,RES,20,7.825,31.7
2017,ISERE,Meylan,790,174,616,9,607,1,EELV,43,7.825,31.7
2017,ISERE,Meylan,790,174,616,9,607,1,FN,71,7.825,31.7
2017,ISERE,Meylan,790,174,616,9,607,1,LFI,127,7.825,31.7
2017,ISERE,Meylan,790,174,616,9,607,1,LO,1,7.825,31.7
2017,ISERE,Meylan,790,174,616,9,607,1,LR,39,7.825,31.7
2017,ISERE,Meylan,790,174,616,9,607,1,LREM,250,7.825,31.7
2017,ISERE,Meylan,790,174,616,9,607,1,NPA,2,7.825,31.7
2017,ISERE,Meylan,790,174,616,9,607,1,PCF,12,7.825,31.7
2017,ISERE,Meylan,790,174,616,9,607,1,REC,42,7.825,31.7
2017,ISERE,Meylan,790,174,616,9,607,1,RES,3,7.825,31.7
2017,ISERE,Saint-Martin-d'Hères,791,168,623,9,614,1,EELV,46,7.825,31.7
2017,ISERE,Saint-Martin-d'Hères,791,168,623,9,614,1,FN,88,7.825,31.7
2017,ISERE,Saint-Martin-d'Hères,791,168,623,9,614,1,LFI,211,7.825,31.7
2017,ISERE,Saint-Martin-d'Hères,791,168,623,9,614,1,LO,0,7.825,31.7
2017,ISERE,Saint-Martin-d'Hères,791,168,623,9,614,1,LR,20,7.825,31.7
2017,ISERE,Saint-Martin-d'Hères,791,168,623,9,614,1,LREM,148,7.825,31.7
2017,ISERE,Saint-Martin-d'Hères,791,168,623,9,614,1,NPA,5,7.825,31.7
2017,ISERE,Saint-Martin-d'Hères,791,168,623,9,614,1,PCF,26,7.825,31.7
2017,ISERE,Saint-Martin-d'Hères,791,168,623,9,614,1,REC,34,7.825,31.7
2017,ISERE,Saint-Martin-d'Hères,791,168,623,9,614,1,RES,11,7.825,31.7
2017,ISERE,Beaurepaire,791,205,586,17,569,1,EELV,18,7.825,31.7
2017,ISERE,Beaurepaire,791,205,586,17,569,1,FN,196,7.825,31.7
2017,ISERE,Beaurepaire,791,205,586,17,569,1,LFI,106,7.825,31.7
2017,ISERE,Beaurepaire,791,205,586,17,569,1,LO,4,7.825,31.7
2017,ISERE,Beaurepaire,791,205,586,17,569,1,LR,29,7.825,31.7
2017,ISERE,Beaurepaire,791,205,586,17,569,1,LREM,126,7.825,31.7
2017,ISERE,Beaurepaire,791,205,586,17,569,1,NPA,3,7.825,31.7
2017,ISERE,Beaurepaire,791,205,586,17,569,1,PCF,9,7.825,31.7
2017,ISERE,Beaurepaire,791,205,586,17,569,1,REC,38,7.825,31.7
2017,ISERE,Beaurepaire,791,205,586,17,569,1,RES,10,7.825,31.7
2017,ISERE,Echirolles,791,327,464,7,457,1,EELV,4,7.825,31.7
2017,ISERE,Echirolles,791,327,464,7,457,1,FN,77,7.825,31.7
2017,ISERE,Echirolles,791,327,464,7,457,1,LFI,236,7.825,31.7
2017,ISERE,Echirolles,791,327,464,7,457,1,LO,5,7.825,31.7
2017,ISERE,Echirolles,791,327,464,7,457,1,LR,9,7.825,31.7
2017,ISERE,Echirolles,791,327,464,7,457,1,LREM,65,7.825,31.7
2017,ISERE,Echirolles,791,327,464,7,457,1,NPA,5,7.825,31.7
2017,ISERE,Echirolles,791,327,464,7,457,1,PCF,20,7.825,31.7
2017,ISERE,Echirolles,791,327,464,7,457,1,REC,24,7.825,31.7
2017,ISERE,Echirolles,791,327,464,7,457,1,RES,4,7.825,31.7
2017,ISERE,Charvieu-Chavagneux,792,128,664,7,657,1,EELV,29,7.825,31.7
2017,ISERE,Charvieu-Chavagneux,792,128,664,7,657,1,FN,241,7.825,31.7
2017,ISERE,Charvieu-Chavagneux,792,128,664,7,657,1,LFI,118,7.825,31.7
2017,ISERE,Charvieu-Chavagneux,792,128,664,7,657,1,LO,7,7.825,31.7
2017,ISERE,Charvieu-Chavagneux,792,128,664,7,657,1,LR,14,7.825,31.7
2017,ISERE,Charvieu-Chavagneux,792,128,664,7,657,1,LREM,139,7.825,31.7
2017,ISERE,Charvieu-Chavagneux,792,128,664,7,657,1,NPA,5,7.825,31.7
2017,ISERE,Charvieu-Chavagneux,792,128,664,7,657,1,PCF,11,7.825,31.7
2017,ISERE,Charvieu-Chavagneux,792,128,664,7,657,1,REC,60,7.825,31.7
2017,ISERE,Charvieu-Chavagneux,792,128,664,7,657,1,RES,17,7.825,31.7
2017,ISERE,Grenoble,792,172,620,6,614,1,EELV,72,7.825,31.7
2017,ISERE,Grenoble,792,172,620,6,614,1,FN,47,7.825,31.7
2017,ISERE,Grenoble,792,172,620,6,614,1,LFI,207,7.825,31.7
2017,ISERE,Grenoble,792,172,620,6,614,1,LO,1,7.825,31.7
2017,ISERE,Grenoble,792,172,620,6,614,1,LR,13,7.825,31.7
2017,ISERE,Grenoble,792,172,620,6,614,1,LREM,188,7.825,31.7
2017,ISERE,Grenoble,792,172,620,6,614,1,NPA,6,7.825,31.7
2017,ISERE,Grenoble,792,172,620,6,614,1,PCF,12,7.825,31.7
2017,ISERE,Grenoble,792,172,620,6,614,1,REC,30,7.825,31.7
2017,ISERE,Grenoble,792,172,620,6,614,1,RES,10,7.825,31.7
2017,ISERE,Saint-Martin-d'Hères,792,238,554,16,538,1,EELV,17,7.825,31.7
2017,ISERE,Saint-Martin-d'Hères,792,238,554,16,538,1,FN,125,7.825,31.7
2017,ISERE,Saint-Martin-d'Hères,792,238,554,16,538,1,LFI,179,7.825,31.7
2017,ISERE,Saint-Martin-d'Hères,792,238,554,16,538,1,LO,3,7.825,31.7
2017,ISERE,Saint-Martin-d'Hères,792,238,554,16,538,1,LR,14,7.825,31.7
2017,ISERE,Saint-Martin-d'Hères,792,238,554,16,538,1,LREM,122,7.825,31.7
2017,ISERE,Saint-Martin-d'Hères,792,238,554,16,538,1,NPA,5,7.825,31.7
2017,ISERE,Saint-Martin-d'Hères,792,238,554,16,538,1,PCF,21,7.825,31.7
2017,ISERE,Saint-Martin-d'Hères,792,238,554,16,538,1,REC,23,7.825,31.7
2017,ISERE,Saint-Martin-d'Hères,792,238,554,16,538,1,RES,8,7.825,31.7
2017,ISERE,La Buisse,793,174,619,16,603,1,EELV,40,7.825,31.7
2017,ISERE,La Buisse,793,174,619,16,603,1,FN,126,7.825,31.7
2017,ISERE,La Buisse,793,174,619,16,603,1,LFI,134,7.825,31.7
2017,ISERE,La Buisse,793,174,619,16,603,1,LO,3,7.825,31.7
2017,ISERE,La Buisse,793,174,619,16,603,1,LR,17,7.825,31.7
2017,ISERE,La Buisse,793,174,619,16,603,1,LREM,164,7.825,31.7
2017,ISERE,La Buisse,793,174,619,16,603,1,NPA,9,7.825,31.7
2017,ISERE,La Buisse,793,174,619,16,603,1,PCF,12,7.825,31.7
2017,ISERE,La Buisse,793,174,619,16,603,1,REC,53,7.825,31.7
2017,ISERE,La Buisse,793,174,619,16,603,1,RES,24,7.825,31.7
2017,ISERE,Grenoble,794,158,636,10,626,1,EELV,70,7.825,31.7
2017,ISERE,Grenoble,794,158,636,10,626,1,FN,80,7.825,31.7
2017,ISERE,Grenoble,794,158,636,10,626,1,LFI,202,7.825,31.7
2017,ISERE,Grenoble,794,158,636,10,626,1,LO,3,7.825,31.7
2017,ISERE,Grenoble,794,158,636,10,626,1,LR,17,7.825,31.7
2017,ISERE,Grenoble,794,158,636,10,626,1,LREM,184,7.825,31.7
2017,ISERE,Grenoble,794,158,636,10,626,1,NPA,3,7.825,31.7
2017,ISERE,Grenoble,794,158,636,10,626,1,PCF,9,7.825,31.7
2017,ISERE,Grenoble,794,158,636,10,626,1,REC,32,7.825,31.7
2017,ISERE,Grenoble,794,158,636,10,626,1,RES,7,7.825,31.7
2017,ISERE,Satolas-et-Bonce,794,158,636,13,623,1,EELV,22,7.825,31.7
2017,ISERE,Satolas-et-Bonce,794,158,636,13,623,1,FN,239,7.825,31.7
2017,ISERE,Satolas-et-Bonce,794,158,636,13,623,1,LFI,66,7.825,31.7
2017,ISERE,Satolas-et-Bonce,794,158,636,13,623,1,LO,1,7.825,31.7
2017,ISERE,Satolas-et-Bonce,794,158,636,13,623,1,LR,20,7.825,31.7
2017,ISERE,Satolas-et-Bonce,794,158,636,13,623,1,LREM,147,7.825,31.7
2017,ISERE,Satolas-et-Bonce,794,158,636,13,623,1,NPA,4,7.825,31.7
2017,ISERE,Satolas-et-Bonce,794,158,636,13,623,1,PCF,10,7.825,31.7
2017,ISERE,Satolas-et-Bonce,794,158,636,13,623,1,REC,66,7.825,31.7
2017,ISERE,Satolas-et-Bonce,794,158,636,13,623,1,RES,17,7.825,31.7
2017,ISERE,Frontonas,797,127,670,19,651,1,EELV,42,7.825,31.7
2017,ISERE,Frontonas,797,127,670,19,651,1,FN,177,7.825,31.7
2017,ISERE,Frontonas,797,127,670,19,651,1,LFI,94,7.825,31.7
2017,ISERE,Frontonas,797,127,670,19,651,1,LO,2,7.825,31.7
2017,ISERE,Frontonas,797,127,670,19,651,1,LR,22,7.825,31.7
2017,ISERE,Frontonas,797,127,670,19,651,1,LREM,215,7.825,31.7
2017,ISERE,Frontonas,797,127,670,19,651,1,NPA,3,7.825,31.7
2017,ISERE,Frontonas,797,127,670,19,651,1,PCF,13,7.825,31.7
2017,ISERE,Frontonas,797,127,670,19,651,1,REC,39,7.825,31.7
2017,ISERE,Frontonas,797,127,670,19,651,1,RES,14,7.825,31.7
2017,ISERE,Saint-Romain-de-Jalionas,798,157,641,15,626,1,EELV,16,7.825,31.7
2017,ISERE,Saint-Romain-de-Jalionas,798,157,641,15,626,1,FN,228,7.825,31.7
2017,ISERE,Saint-Romain-de-Jalionas,798,157,641,15,626,1,LFI,79,7.825,31.7
2017,ISERE,Saint-Romain-de-Jalionas,798,157,641,15,626,1,LO,3,7.825,31.7
2017,ISERE,Saint-Romain-de-Jalionas,798,157,641,15,626,1,LR,23,7.825,31.7
2017,ISERE,Saint-Romain-de-Jalionas,798,157,641,15,626,1,LREM,165,7.825,31.7
2017,ISERE,Saint-Romain-de-Jalionas,798,157,641,15,626,1,NPA,2,7.825,31.7
2017,ISERE,Saint-Romain-de-Jalionas,798,157,641,15,626,1,PCF,5,7.825,31.7
2017,ISERE,Saint-Romain-de-Jalionas,798,157,641,15,626,1,REC,65,7.825,31.7
2017,ISERE,Saint-Romain-de-Jalionas,798,157,641,15,626,1,RES,15,7.825,31.7
2017,ISERE,Vaulx-Milieu,799,134,665,15,650,1,EELV,40,7.825,31.7
2017,ISERE,Vaulx-Milieu,799,134,665,15,650,1,FN,154,7.825,31.7
2017,ISERE,Vaulx-Milieu,799,134,665,15,650,1,LFI,96,7.825,31.7
2017,ISERE,Vaulx-Milieu,799,134,665,15,650,1,LO,5,7.825,31.7
2017,ISERE,Vaulx-Milieu,799,134,665,15,650,1,LR,27,7.825,31.7
2017,ISERE,Vaulx-Milieu,799,134,665,15,650,1,LREM,207,7.825,31.7
2017,ISERE,Vaulx-Milieu,799,134,665,15,650,1,NPA,4,7.825,31.7
2017,ISERE,Vaulx-Milieu,799,134,665,15,650,1,PCF,14,7.825,31.7
2017,ISERE,Vaulx-Milieu,799,134,665,15,650,1,REC,56,7.825,31.7
2017,ISERE,Vaulx-Milieu,799,134,665,15,650,1,RES,22,7.825,31.7
2017,ISERE,Saint-Ismier,800,123,677,9,668,1,EELV,69,7.825,31.7
2017,ISERE,Saint-Ismier,800,123,677,9,668,1,FN,48,7.825,31.7
2017,ISERE,Saint-Ismier,800,123,677,9,668,1,LFI,83,7.825,31.7
2017,ISERE,Saint-Ismier,800,123,677,9,668,1,LO,2,7.825,31.7
2017,ISERE,Saint-Ismier,800,123,677,9,668,1,LR,49,7.825,31.7
2017,ISERE,Saint-Ismier,800,123,677,9,668,1,LREM,316,7.825,31.7
2017,ISERE,Saint-Ismier,800,123,677,9,668,1,NPA,5,7.825,31.7
2017,ISERE,Saint-Ismier,800,123,677,9,668,1,PCF,7,7.825,31.7
2017,ISERE,Saint-Ismier,800,123,677,9,668,1,REC,52,7.825,31.7
2017,ISERE,Saint-Ismier,800,123,677,9,668,1,RES,14,7.825,31.7
2017,ISERE,Grenoble,800,431,369,3,366,1,EELV,3,7.825,31.7
2017,ISERE,Grenoble,800,431,369,3,366,1,FN,43,7.825,31.7
2017,ISERE,Grenoble,800,431,369,3,366,1,LFI,232,7.825,31.7
2017,ISERE,Grenoble,800,431,369,3,366,1,LO,3,7.825,31.7
2017,ISERE,Grenoble,800,431,369,3,366,1,LR,6,7.825,31.7
2017,ISERE,Grenoble,800,431,369,3,366,1,LREM,53,7.825,31.7
2017,ISERE,Grenoble,800,431,369,3,366,1,NPA,5,7.825,31.7
2017,ISERE,Grenoble,800,431,369,3,366,1,PCF,2,7.825,31.7
2017,ISERE,Grenoble,800,431,369,3,366,1,REC,9,7.825,31.7
2017,ISERE,Grenoble,800,431,369,3,366,1,RES,3,7.825,31.7
2017,ISERE,Saint-Blaise-du-Buis,802,135,667,13,654,1,EELV,47,7.825,31.7
2017,ISERE,Saint-Blaise-du-Buis,802,135,667,13,654,1,FN,140,7.825,31.7
2017,ISERE,Saint-Blaise-du-Buis,802,135,667,13,654,1,LFI,121,7.825,31.7
2017,ISERE,Saint-Blaise-du-Buis,802,135,667,13,654,1,LO,1,7.825,31.7
2017,ISERE,Saint-Blaise-du-Buis,802,135,667,13,654,1,LR,35,7.825,31.7
2017,ISERE,Saint-Blaise-du-Buis,802,135,667,13,654,1,LREM,177,7.825,31.7
2017,ISERE,Saint-Blaise-du-Buis,802,135,667,13,654,1,NPA,4,7.825,31.7
2017,ISERE,Saint-Blaise-du-Buis,802,135,667,13,654,1,PCF,14,7.825,31.7
2017,ISERE,Saint-Blaise-du-Buis,802,135,667,13,654,1,REC,64,7.825,31.7
2017,ISERE,Saint-Blaise-du-Buis,802,135,667,13,654,1,RES,8,7.825,31.7
2017,ISERE,Saint-Quentin-Fallavier,802,180,622,15,607,1,EELV,31,7.825,31.7
2017,ISERE,Saint-Quentin-Fallavier,802,180,622,15,607,1,FN,194,7.825,31.7
2017,ISERE,Saint-Quentin-Fallavier,802,180,622,15,607,1,LFI,126,7.825,31.7
2017,ISERE,Saint-Quentin-Fallavier,802,180,622,15,607,1,LO,6,7.825,31.7
2017,ISERE,Saint-Quentin-Fallavier,802,180,622,15,607,1,LR,21,7.825,31.7
2017,ISERE,Saint-Quentin-Fallavier,802,180,622,15,607,1,LREM,141,7.825,31.7
2017,ISERE,Saint-Quentin-Fallavier,802,180,622,15,607,1,NPA,6,7.825,31.7
2017,ISERE,Saint-Quentin-Fallavier,802,180,622,15,607,1,PCF,21,7.825,31.7
2017,ISERE,Saint-Quentin-Fallavier,802,180,622,15,607,1,REC,36,7.825,31.7
2017,ISERE,Saint-Quentin-Fallavier,802,180,622,15,607,1,RES,14,7.825,31.7
2017,ISERE,Beaurepaire,802,254,548,13,535,1,EELV,18,7.825,31.7
2017,ISERE,Beaurepaire,802,254,548,13,535,1,FN,166,7.825,31.7
2017,ISERE,Beaurepaire,802,254,548,13,535,1,LFI,108,7.825,31.7
2017,ISERE,Beaurepaire,802,254,548,13,535,1,LO,2,7.825,31.7
2017,ISERE,Beaurepaire,802,254,548,13,535,1,LR,17,7.825,31.7
2017,ISERE,Beaurepaire,802,254,548,13,535,1,LREM,126,7.825,31.7
2017,ISERE,Beaurepaire,802,254,548,13,535,1,NPA,2,7.825,31.7
2017,ISERE,Beaurepaire,802,254,548,13,535,1,PCF,14,7.825,31.7
2017,ISERE,Beaurepaire,802,254,548,13,535,1,REC,38,7.825,31.7
2017,ISERE,Beaurepaire,802,254,548,13,535,1,RES,21,7.825,31.7
2017,ISERE,Grenoble,803,139,664,12,652,1,EELV,74,7.825,31.7
2017,ISERE,Grenoble,803,139,664,12,652,1,FN,48,7.825,31.7
2017,ISERE,Grenoble,803,139,664,12,652,1,LFI,196,7.825,31.7
2017,ISERE,Grenoble,803,139,664,12,652,1,LO,2,7.825,31.7
2017,ISERE,Grenoble,803,139,664,12,652,1,LR,40,7.825,31.7
2017,ISERE,Grenoble,803,139,664,12,652,1,LREM,211,7.825,31.7
2017,ISERE,Grenoble,803,139,664,12,652,1,NPA,6,7.825,31.7
2017,ISERE,Grenoble,803,139,664,12,652,1,PCF,11,7.825,31.7
2017,ISERE,Grenoble,803,139,664,12,652,1,REC,37,7.825,31.7
2017,ISERE,Grenoble,803,139,664,12,652,1,RES,10,7.825,31.7
2017,ISERE,Bourgoin-Jallieu,803,217,586,17,569,1,EELV,25,7.825,31.7
2017,ISERE,Bourgoin-Jallieu,803,217,586,17,569,1,FN,113,7.825,31.7
2017,ISERE,Bourgoin-Jallieu,803,217,586,17,569,1,LFI,133,7.825,31.7
2017,ISERE,Bourgoin-Jallieu,803,217,586,17,569,1,LO,0,7.825,31.7
2017,ISERE,Bourgoin-Jallieu,803,217,586,17,569,1,LR,33,7.825,31.7
2017,ISERE,Bourgoin-Jallieu,803,217,586,17,569,1,LREM,164,7.825,31.7
2017,ISERE,Bourgoin-Jallieu,803,217,586,17,569,1,NPA,6,7.825,31.7
2017,ISERE,Bourgoin-Jallieu,803,217,586,17,569,1,PCF,11,7.825,31.7
2017,ISERE,Bourgoin-Jallieu,803,217,586,17,569,1,REC,48,7.825,31.7
2017,ISERE,Bourgoin-Jallieu,803,217,586,17,569,1,RES,12,7.825,31.7
2017,ISERE,Meylan,805,186,619,10,609,1,EELV,31,7.825,31.7
2017,ISERE,Meylan,805,186,619,10,609,1,FN,73,7.825,31.7
2017,ISERE,Meylan,805,186,619,10,609,1,LFI,119,7.825,31.7
2017,ISERE,Meylan,805,186,619,10,609,1,LO,1,7.825,31.7
2017,ISERE,Meylan,805,186,619,10,609,1,LR,47,7.825,31.7
2017,ISERE,Meylan,805,186,619,10,609,1,LREM,229,7.825,31.7
2017,ISERE,Meylan,805,186,619,10,609,1,NPA,4,7.825,31.7
2017,ISERE,Meylan,805,186,619,10,609,1,PCF,14,7.825,31.7
2017,ISERE,Meylan,805,186,619,10,609,1,REC,54,7.825,31.7
2017,ISERE,Meylan,805,186,619,10,609,1,RES,9,7.825,31.7
2017,ISERE,Saint-Nicolas-de-Macherin,806,127,679,24,655,1,EELV,50,7.825,31.7
2017,ISERE,Saint-Nicolas-de-Macherin,806,127,679,24,655,1,FN,142,7.825,31.7
2017,ISERE,Saint-Nicolas-de-Macherin,806,127,679,24,655,1,LFI,127,7.825,31.7
2017,ISERE,Saint-Nicolas-de-Macherin,806,127,679,24,655,1,LO,3,7.825,31.7
2017,ISERE,Saint-Nicolas-de-Macherin,806,127,679,24,655,1,LR,25,7.825,31.7
2017,ISERE,Saint-Nicolas-de-Macherin,806,127,679,24,655,1,LREM,197,7.825,31.7
2017,ISERE,Saint-Nicolas-de-Macherin,806,127,679,24,655,1,NPA,6,7.825,31.7
2017,ISERE,Saint-Nicolas-de-Macherin,806,127,679,24,655,1,PCF,17,7.825,31.7
2017,ISERE,Saint-Nicolas-de-Macherin,806,127,679,24,655,1,REC,31,7.825,31.7
2017,ISERE,Saint-Nicolas-de-Macherin,806,127,679,24,655,1,RES,20,7.825,31.7
2017,ISERE,Izeaux,807,178,629,17,612,1,EELV,28,7.825,31.7
2017,ISERE,Izeaux,807,178,629,17,612,1,FN,182,7.825,31.7
2017,ISERE,Izeaux,807,178,629,17,612,1,LFI,114,7.825,31.7
2017,ISERE,Izeaux,807,178,629,17,612,1,LO,5,7.825,31.7
2017,ISERE,Izeaux,807,178,629,17,612,1,LR,20,7.825,31.7
2017,ISERE,Izeaux,807,178,629,17,612,1,LREM,144,7.825,31.7
2017,ISERE,Izeaux,807,178,629,17,612,1,NPA,12,7.825,31.7
2017,ISERE,Izeaux,807,178,629,17,612,1,PCF,19,7.825,31.7
2017,ISERE,Izeaux,807,178,629,17,612,1,REC,38,7.825,31.7
2017,ISERE,Izeaux,807,178,629,17,612,1,RES,18,7.825,31.7
2017,ISERE,Les Abrets en Dauphiné,807,202,605,23,582,1,EELV,18,7.825,31.7
2017,ISERE,Les Abrets en Dauphiné,807,202,605,23,582,1,FN,229,7.825,31.7
2017,ISERE,Les Abrets en Dauphiné,807,202,605,23,582,1,LFI,100,7.825,31.7
2017,ISERE,Les Abrets en Dauphiné,807,202,605,23,582,1,LO,7,7.825,31.7
2017,ISERE,Les Abrets en Dauphiné,807,202,605,23,582,1,LR,20,7.825,31.7
2017,ISERE,Les Abrets en Dauphiné,807,202,605,23,582,1,LREM,108,7.825,31.7
2017,ISERE,Les Abrets en Dauphiné,807,202,605,23,582,1,NPA,8,7.825,31.7
2017,ISERE,Les Abrets en Dauphiné,807,202,605,23,582,1,PCF,11,7.825,31.7
2017,ISERE,Les Abrets en Dauphiné,807,202,605,23,582,1,REC,44,7.825,31.7
2017,ISERE,Les Abrets en Dauphiné,807,202,605,23,582,1,RES,17,7.825,31.7
2017,ISERE,Vienne,809,148,661,7,654,1,EELV,38,7.825,31.7
2017,ISERE,Vienne,809,148,661,7,654,1,FN,55,7.825,31.7
2017,ISERE,Vienne,809,148,661,7,654,1,LFI,107,7.825,31.7
2017,ISERE,Vienne,809,148,661,7,654,1,LO,1,7.825,31.7
2017,ISERE,Vienne,809,148,661,7,654,1,LR,64,7.825,31.7
2017,ISERE,Vienne,809,148,661,7,654,1,LREM,257,7.825,31.7
2017,ISERE,Vienne,809,148,661,7,654,1,NPA,2,7.825,31.7
2017,ISERE,Vienne,809,148,661,7,654,1,PCF,13,7.825,31.7
2017,ISERE,Vienne,809,148,661,7,654,1,REC,78,7.825,31.7
2017,ISERE,Vienne,809,148,661,7,654,1,RES,11,7.825,31.7
2017,ISERE,Séchilienne,810,178,632,14,618,1,EELV,31,7.825,31.7
2017,ISERE,Séchilienne,810,178,632,14,618,1,FN,191,7.825,31.7
2017,ISERE,Séchilienne,810,178,632,14,618,1,LFI,144,7.825,31.7
2017,ISERE,Séchilienne,810,178,632,14,618,1,LO,8,7.825,31.7
2017,ISERE,Séchilienne,810,178,632,14,618,1,LR,15,7.825,31.7
2017,ISERE,Séchilienne,810,178,632,14,618,1,LREM,120,7.825,31.7
2017,ISERE,Séchilienne,810,178,632,14,618,1,NPA,8,7.825,31.7
2017,ISERE,Séchilienne,810,178,632,14,618,1,PCF,15,7.825,31.7
2017,ISERE,Séchilienne,810,178,632,14,618,1,REC,34,7.825,31.7
2017,ISERE,Séchilienne,810,178,632,14,618,1,RES,29,7.825,31.7
2017,ISERE,Saint-Maurice-l'Exil,810,212,598,15,583,1,EELV,20,7.825,31.7
2017,ISERE,Saint-Maurice-l'Exil,810,212,598,15,583,1,FN,177,7.825,31.7
2017,ISERE,Saint-Maurice-l'Exil,810,212,598,15,583,1,LFI,164,7.825,31.7
2017,ISERE,Saint-Maurice-l'Exil,810,212,598,15,583,1,LO,2,7.825,31.7
2017,ISERE,Saint-Maurice-l'Exil,810,212,598,15,583,1,LR,19,7.825,31.7
2017,ISERE,Saint-Maurice-l'Exil,810,212,598,15,583,1,LREM,116,7.825,31.7
2017,ISERE,Saint-Maurice-l'Exil,810,212,598,15,583,1,NPA,4,7.825,31.7
2017,ISERE,Saint-Maurice-l'Exil,810,212,598,15,583,1,PCF,15,7.825,31.7
2017,ISERE,Saint-Maurice-l'Exil,810,212,598,15,583,1,REC,46,7.825,31.7
2017,ISERE,Saint-Maurice-l'Exil,810,212,598,15,583,1,RES,13,7.825,31.7
2017,ISERE,Les Avenières Veyrins-Thuellin,811,264,547,5,542,1,EELV,13,7.825,31.7
2017,ISERE,Les Avenières Veyrins-Thuellin,811,264,547,5,542,1,FN,205,7.825,31.7
2017,ISERE,Les Avenières Veyrins-Thuellin,811,264,547,5,542,1,LFI,84,7.825,31.7
2017,ISERE,Les Avenières Veyrins-Thuellin,811,264,547,5,542,1,LO,8,7.825,31.7
2017,ISERE,Les Avenières Veyrins-Thuellin,811,264,547,5,542,1,LR,20,7.825,31.7
2017,ISERE,Les Avenières Veyrins-Thuellin,811,264,547,5,542,1,LREM,130,7.825,31.7
2017,ISERE,Les Avenières Veyrins-Thuellin,811,264,547,5,542,1,NPA,3,7.825,31.7
2017,ISERE,Les Avenières Veyrins-Thuellin,811,264,547,5,542,1,PCF,9,7.825,31.7
2017,ISERE,Les Avenières Veyrins-Thuellin,811,264,547,5,542,1,REC,32,7.825,31.7
2017,ISERE,Les Avenières Veyrins-Thuellin,811,264,547,5,542,1,RES,16,7.825,31.7
2017,ISERE,La Tour-du-Pin,811,266,545,7,538,1,EELV,31,7.825,31.7
2017,ISERE,La Tour-du-Pin,811,266,545,7,538,1,FN,139,7.825,31.7
2017,ISERE,La Tour-du-Pin,811,266,545,7,538,1,LFI,132,7.825,31.7
2017,ISERE,La Tour-du-Pin,811,266,545,7,538,1,LO,3,7.825,31.7
2017,ISERE,La Tour-du-Pin,811,266,545,7,538,1,LR,20,7.825,31.7
2017,ISERE,La Tour-du-Pin,811,266,545,7,538,1,LREM,110,7.825,31.7
2017,ISERE,La Tour-du-Pin,811,266,545,7,538,1,NPA,5,7.825,31.7
2017,ISERE,La Tour-du-Pin,811,266,545,7,538,1,PCF,10,7.825,31.7
2017,ISERE,La Tour-du-Pin,811,266,545,7,538,1,REC,45,7.825,31.7
2017,ISERE,La Tour-du-Pin,811,266,545,7,538,1,RES,15,7.825,31.7
2017,ISERE,Saint-Victor-de-Cessieu,812,194,618,9,609,1,EELV,10,7.825,31.7
2017,ISERE,Saint-Victor-de-Cessieu,812,194,618,9,609,1,FN,226,7.825,31.7
2017,ISERE,Saint-Victor-de-Cessieu,812,194,618,9,609,1,LFI,105,7.825,31.7
2017,ISERE,Saint-Victor-de-Cessieu,812,194,618,9,609,1,LO,7,7.825,31.7
2017,ISERE,Saint-Victor-de-Cessieu,812,194,618,9,609,1,LR,30,7.825,31.7
2017,ISERE,Saint-Victor-de-Cessieu,812,194,618,9,609,1,LREM,135,7.825,31.7
2017,ISERE,Saint-Victor-de-Cessieu,812,194,618,9,609,1,NPA,2,7.825,31.7
2017,ISERE,Saint-Victor-de-Cessieu,812,194,618,9,609,1,PCF,7,7.825,31.7
2017,ISERE,Saint-Victor-de-Cessieu,812,194,618,9,609,1,REC,35,7.825,31.7
2017,ISERE,Saint-Victor-de-Cessieu,812,194,618,9,609,1,RES,18,7.825,31.7
2017,ISERE,Chozeau,815,134,681,16,665,1,EELV,29,7.825,31.7
2017,ISERE,Chozeau,815,134,681,16,665,1,FN,177,7.825,31.7
2017,ISERE,Chozeau,815,134,681,16,665,1,LFI,70,7.825,31.7
2017,ISERE,Chozeau,815,134,681,16,665,1,LO,2,7.825,31.7
2017,ISERE,Chozeau,815,134,681,16,665,1,LR,48,7.825,31.7
2017,ISERE,Chozeau,815,134,681,16,665,1,LREM,229,7.825,31.7
2017,ISERE,Chozeau,815,134,681,16,665,1,NPA,4,7.825,31.7
2017,ISERE,Chozeau,815,134,681,16,665,1,PCF,12,7.825,31.7
2017,ISERE,Chozeau,815,134,681,16,665,1,REC,59,7.825,31.7
2017,ISERE,Chozeau,815,134,681,16,665,1,RES,16,7.825,31.7
2017,ISERE,Trept,815,164,651,15,636,1,EELV,33,7.825,31.7
2017,ISERE,Trept,815,164,651,15,636,1,FN,193,7.825,31.7
2017,ISERE,Trept,815,164,651,15,636,1,LFI,84,7.825,31.7
2017,ISERE,Trept,815,164,651,15,636,1,LO,4,7.825,31.7
2017,ISERE,Trept,815,164,651,15,636,1,LR,18,7.825,31.7
2017,ISERE,Trept,815,164,651,15,636,1,LREM,173,7.825,31.7
2017,ISERE,Trept,815,164,651,15,636,1,NPA,3,7.825,31.7
2017,ISERE,Trept,815,164,651,15,636,1,PCF,9,7.825,31.7
2017,ISERE,Trept,815,164,651,15,636,1,REC,75,7.825,31.7
2017,ISERE,Trept,815,164,651,15,636,1,RES,13,7.825,31.7
2017,ISERE,Ruy-Montceau,817,147,670,12,658,1,EELV,41,7.825,31.7
2017,ISERE,Ruy-Montceau,817,147,670,12,658,1,FN,168,7.825,31.7
2017,ISERE,Ruy-Montceau,817,147,670,12,658,1,LFI,83,7.825,31.7
2017,ISERE,Ruy-Montceau,817,147,670,12,658,1,LO,2,7.825,31.7
2017,ISERE,Ruy-Montceau,817,147,670,12,658,1,LR,37,7.825,31.7
2017,ISERE,Ruy-Montceau,817,147,670,12,658,1,LREM,210,7.825,31.7
2017,ISERE,Ruy-Montceau,817,147,670,12,658,1,NPA,2,7.825,31.7
2017,ISERE,Ruy-Montceau,817,147,670,12,658,1,PCF,13,7.825,31.7
2017,ISERE,Ruy-Montceau,817,147,670,12,658,1,REC,58,7.825,31.7
2017,ISERE,Ruy-Montceau,817,147,670,12,658,1,RES,22,7.825,31.7
2017,ISERE,Villeneuve-de-Marc,817,153,664,16,648,1,EELV,29,7.825,31.7
2017,ISERE,Villeneuve-de-Marc,817,153,664,16,648,1,FN,211,7.825,31.7
2017,ISERE,Villeneuve-de-Marc,817,153,664,16,648,1,LFI,88,7.825,31.7
2017,ISERE,Villeneuve-de-Marc,817,153,664,16,648,1,LO,1,7.825,31.7
2017,ISERE,Villeneuve-de-Marc,817,153,664,16,648,1,LR,26,7.825,31.7
2017,ISERE,Villeneuve-de-Marc,817,153,664,16,648,1,LREM,173,7.825,31.7
2017,ISERE,Villeneuve-de-Marc,817,153,664,16,648,1,NPA,5,7.825,31.7
2017,ISERE,Villeneuve-de-Marc,817,153,664,16,648,1,PCF,12,7.825,31.7
2017,ISERE,Villeneuve-de-Marc,817,153,664,16,648,1,REC,54,7.825,31.7
2017,ISERE,Villeneuve-de-Marc,817,153,664,16,648,1,RES,28,7.825,31.7
2017,ISERE,Grenoble,817,351,466,5,461,1,EELV,18,7.825,31.7
2017,ISERE,Grenoble,817,351,466,5,461,1,FN,31,7.825,31.7
2017,ISERE,Grenoble,817,351,466,5,461,1,LFI,259,7.825,31.7
2017,ISERE,Grenoble,817,351,466,5,461,1,LO,5,7.825,31.7
2017,ISERE,Grenoble,817,351,466,5,461,1,LR,7,7.825,31.7
2017,ISERE,Grenoble,817,351,466,5,461,1,LREM,89,7.825,31.7
2017,ISERE,Grenoble,817,351,466,5,461,1,NPA,3,7.825,31.7
2017,ISERE,Grenoble,817,351,466,5,461,1,PCF,9,7.825,31.7
2017,ISERE,Grenoble,817,351,466,5,461,1,REC,7,7.825,31.7
2017,ISERE,Grenoble,817,351,466,5,461,1,RES,8,7.825,31.7
2017,ISERE,Luzinay,818,161,657,15,642,1,EELV,50,7.825,31.7
2017,ISERE,Luzinay,818,161,657,15,642,1,FN,176,7.825,31.7
2017,ISERE,Luzinay,818,161,657,15,642,1,LFI,76,7.825,31.7
2017,ISERE,Luzinay,818,161,657,15,642,1,LO,3,7.825,31.7
2017,ISERE,Luzinay,818,161,657,15,642,1,LR,29,7.825,31.7
2017,ISERE,Luzinay,818,161,657,15,642,1,LREM,191,7.825,31.7
2017,ISERE,Luzinay,818,161,657,15,642,1,NPA,3,7.825,31.7
2017,ISERE,Luzinay,818,161,657,15,642,1,PCF,13,7.825,31.7
2017,ISERE,Luzinay,818,161,657,15,642,1,REC,56,7.825,31.7
2017,ISERE,Luzinay,818,161,657,15,642,1,RES,18,7.825,31.7
2017,ISERE,Saint-Romain-de-Jalionas,821,145,676,16,660,1,EELV,30,7.825,31.7
2017,ISERE,Saint-Romain-de-Jalionas,821,145,676,16,660,1,FN,236,7.825,31.7
2017,ISERE,Saint-Romain-de-Jalionas,821,145,676,16,660,1,LFI,92,7.825,31.7
2017,ISERE,Saint-Romain-de-Jalionas,821,145,676,16,660,1,LO,1,7.825,31.7
2017,ISERE,Saint-Romain-de-Jalionas,821,145,676,16,660,1,LR,30,7.825,31.7
2017,ISERE,Saint-Romain-de-Jalionas,821,145,676,16,660,1,LREM,130,7.825,31.7
2017,ISERE,Saint-Romain-de-Jalionas,821,145,676,16,660,1,NPA,2,7.825,31.7
2017,ISERE,Saint-Romain-de-Jalionas,821,145,676,16,660,1,PCF,17,7.825,31.7
2017,ISERE,Saint-Romain-de-Jalionas,821,145,676,16,660,1,REC,79,7.825,31.7
2017,ISERE,Saint-Romain-de-Jalionas,821,145,676,16,660,1,RES,15,7.825,31.7
2017,ISERE,Saint-Georges-de-Commiers,821,155,666,16,650,1,EELV,37,7.825,31.7
2017,ISERE,Saint-Georges-de-Commiers,821,155,666,16,650,1,FN,171,7.825,31.7
2017,ISERE,Saint-Georges-de-Commiers,821,155,666,16,650,1,LFI,131,7.825,31.7
2017,ISERE,Saint-Georges-de-Commiers,821,155,666,16,650,1,LO,1,7.825,31.7
2017,ISERE,Saint-Georges-de-Commiers,821,155,666,16,650,1,LR,28,7.825,31.7
2017,ISERE,Saint-Georges-de-Commiers,821,155,666,16,650,1,LREM,164,7.825,31.7
2017,ISERE,Saint-Georges-de-Commiers,821,155,666,16,650,1,NPA,10,7.825,31.7
2017,ISERE,Saint-Georges-de-Commiers,821,155,666,16,650,1,PCF,20,7.825,31.7
2017,ISERE,Saint-Georges-de-Commiers,821,155,666,16,650,1,REC,50,7.825,31.7
2017,ISERE,Saint-Georges-de-Commiers,821,155,666,16,650,1,RES,15,7.825,31.7
2017,ISERE,Bévenais,822,173,649,24,625,1,EELV,32,7.825,31.7
2017,ISERE,Bévenais,822,173,649,24,625,1,FN,185,7.825,31.7
2017,ISERE,Bévenais,822,173,649,24,625,1,LFI,119,7.825,31.7
2017,ISERE,Bévenais,822,173,649,24,625,1,LO,5,7.825,31.7
2017,ISERE,Bévenais,822,173,649,24,625,1,LR,28,7.825,31.7
2017,ISERE,Bévenais,822,173,649,24,625,1,LREM,144,7.825,31.7
2017,ISERE,Bévenais,822,173,649,24,625,1,NPA,4,7.825,31.7
2017,ISERE,Bévenais,822,173,649,24,625,1,PCF,13,7.825,31.7
2017,ISERE,Bévenais,822,173,649,24,625,1,REC,46,7.825,31.7
2017,ISERE,Bévenais,822,173,649,24,625,1,RES,20,7.825,31.7
2017,ISERE,Saint-Clair-du-Rhône,822,181,641,18,623,1,EELV,23,7.825,31.7
2017,ISERE,Saint-Clair-du-Rhône,822,181,641,18,623,1,FN,173,7.825,31.7
2017,ISERE,Saint-Clair-du-Rhône,822,181,641,18,623,1,LFI,129,7.825,31.7
2017,ISERE,Saint-Clair-du-Rhône,822,181,641,18,623,1,LO,6,7.825,31.7
2017,ISERE,Saint-Clair-du-Rhône,822,181,641,18,623,1,LR,34,7.825,31.7
2017,ISERE,Saint-Clair-du-Rhône,822,181,641,18,623,1,LREM,157,7.825,31.7
2017,ISERE,Saint-Clair-du-Rhône,822,181,641,18,623,1,NPA,5,7.825,31.7
2017,ISERE,Saint-Clair-du-Rhône,822,181,641,18,623,1,PCF,15,7.825,31.7
2017,ISERE,Saint-Clair-du-Rhône,822,181,641,18,623,1,REC,38,7.825,31.7
2017,ISERE,Saint-Clair-du-Rhône,822,181,641,18,623,1,RES,21,7.825,31.7
2017,ISERE,Hières-sur-Amby,824,206,618,9,609,1,EELV,12,7.825,31.7
2017,ISERE,Hières-sur-Amby,824,206,618,9,609,1,FN,237,7.825,31.7
2017,ISERE,Hières-sur-Amby,824,206,618,9,609,1,LFI,108,7.825,31.7
2017,ISERE,Hières-sur-Amby,824,206,618,9,609,1,LO,7,7.825,31.7
2017,ISERE,Hières-sur-Amby,824,206,618,9,609,1,LR,14,7.825,31.7
2017,ISERE,Hières-sur-Amby,824,206,618,9,609,1,LREM,126,7.825,31.7
2017,ISERE,Hières-sur-Amby,824,206,618,9,609,1,NPA,5,7.825,31.7
2017,ISERE,Hières-sur-Amby,824,206,618,9,609,1,PCF,11,7.825,31.7
2017,ISERE,Hières-sur-Amby,824,206,618,9,609,1,REC,63,7.825,31.7
2017,ISERE,Hières-sur-Amby,824,206,618,9,609,1,RES,9,7.825,31.7
2017,ISERE,Meylan,825,129,696,4,692,1,EELV,53,7.825,31.7
2017,ISERE,Meylan,825,129,696,4,692,1,FN,67,7.825,31.7
2017,ISERE,Meylan,825,129,696,4,692,1,LFI,100,7.825,31.7
2017,ISERE,Meylan,825,129,696,4,692,1,LO,0,7.825,31.7
2017,ISERE,Meylan,825,129,696,4,692,1,LR,89,7.825,31.7
2017,ISERE,Meylan,825,129,696,4,692,1,LREM,274,7.825,31.7
2017,ISERE,Meylan,825,129,696,4,692,1,NPA,3,7.825,31.7
2017,ISERE,Meylan,825,129,696,4,692,1,PCF,5,7.825,31.7
2017,ISERE,Meylan,825,129,696,4,692,1,REC,67,7.825,31.7
2017,ISERE,Meylan,825,129,696,4,692,1,RES,9,7.825,31.7
2017,ISERE,Quaix-en-Chartreuse,825,142,683,12,671,1,EELV,73,7.825,31.7
2017,ISERE,Quaix-en-Chartreuse,825,142,683,12,671,1,FN,91,7.825,31.7
2017,ISERE,Quaix-en-Chartreuse,825,142,683,12,671,1,LFI,161,7.825,31.7
2017,ISERE,Quaix-en-Chartreuse,825,142,683,12,671,1,LO,2,7.825,31.7
2017,ISERE,Quaix-en-Chartreuse,825,142,683,12,671,1,LR,22,7.825,31.7
2017,ISERE,Quaix-en-Chartreuse,825,142,683,12,671,1,LREM,212,7.825,31.7
2017,ISERE,Quaix-en-Chartreuse,825,142,683,12,671,1,NPA,5,7.825,31.7
2017,ISERE,Quaix-en-Chartreuse,825,142,683,12,671,1,PCF,13,7.825,31.7
2017,ISERE,Quaix-en-Chartreuse,825,142,683,12,671,1,REC,50,7.825,31.7
2017,ISERE,Quaix-en-Chartreuse,825,142,683,12,671,1,RES,14,7.825,31.7
2017,ISERE,Champ-sur-Drac,825,149,676,18,658,1,EELV,25,7.825,31.7
2017,ISERE,Champ-sur-Drac,825,149,676,18,658,1,FN,192,7.825,31.7
2017,ISERE,Champ-sur-Drac,825,149,676,18,658,1,LFI,118,7.825,31.7
2017,ISERE,Champ-sur-Drac,825,149,676,18,658,1,LO,4,7.825,31.7
2017,ISERE,Champ-sur-Drac,825,149,676,18,658,1,LR,20,7.825,31.7
2017,ISERE,Champ-sur-Drac,825,149,676,18,658,1,LREM,174,7.825,31.7
2017,ISERE,Champ-sur-Drac,825,149,676,18,658,1,NPA,7,7.825,31.7
2017,ISERE,Champ-sur-Drac,825,149,676,18,658,1,PCF,26,7.825,31.7
2017,ISERE,Champ-sur-Drac,825,149,676,18,658,1,REC,41,7.825,31.7
2017,ISERE,Champ-sur-Drac,825,149,676,18,658,1,RES,21,7.825,31.7
2017,ISERE,Bellegarde-Poussieu,825,161,664,18,646,1,EELV,21,7.825,31.7
2017,ISERE,Bellegarde-Poussieu,825,161,664,18,646,1,FN,224,7.825,31.7
2017,ISERE,Bellegarde-Poussieu,825,161,664,18,646,1,LFI,70,7.825,31.7
2017,ISERE,Bellegarde-Poussieu,825,161,664,18,646,1,LO,9,7.825,31.7
2017,ISERE,Bellegarde-Poussieu,825,161,664,18,646,1,LR,20,7.825,31.7
2017,ISERE,Bellegarde-Poussieu,825,161,664,18,646,1,LREM,197,7.825,31.7
2017,ISERE,Bellegarde-Poussieu,825,161,664,18,646,1,NPA,3,7.825,31.7
2017,ISERE,Bellegarde-Poussieu,825,161,664,18,646,1,PCF,17,7.825,31.7
2017,ISERE,Bellegarde-Poussieu,825,161,664,18,646,1,REC,38,7.825,31.7
2017,ISERE,Bellegarde-Poussieu,825,161,664,18,646,1,RES,22,7.825,31.7
2017,ISERE,Saint-Maurice-l'Exil,825,211,614,18,596,1,EELV,18,7.825,31.7
2017,ISERE,Saint-Maurice-l'Exil,825,211,614,18,596,1,FN,177,7.825,31.7
2017,ISERE,Saint-Maurice-l'Exil,825,211,614,18,596,1,LFI,100,7.825,31.7
2017,ISERE,Saint-Maurice-l'Exil,825,211,614,18,596,1,LO,3,7.825,31.7
2017,ISERE,Saint-Maurice-l'Exil,825,211,614,18,596,1,LR,27,7.825,31.7
2017,ISERE,Saint-Maurice-l'Exil,825,211,614,18,596,1,LREM,160,7.825,31.7
2017,ISERE,Saint-Maurice-l'Exil,825,211,614,18,596,1,NPA,3,7.825,31.7
2017,ISERE,Saint-Maurice-l'Exil,825,211,614,18,596,1,PCF,12,7.825,31.7
2017,ISERE,Saint-Maurice-l'Exil,825,211,614,18,596,1,REC,43,7.825,31.7
2017,ISERE,Saint-Maurice-l'Exil,825,211,614,18,596,1,RES,23,7.825,31.7
2017,ISERE,Pont-de-Chéruy,825,318,507,13,494,1,EELV,12,7.825,31.7
2017,ISERE,Pont-de-Chéruy,825,318,507,13,494,1,FN,103,7.825,31.7
2017,ISERE,Pont-de-Chéruy,825,318,507,13,494,1,LFI,190,7.825,31.7
2017,ISERE,Pont-de-Chéruy,825,318,507,13,494,1,LO,3,7.825,31.7
2017,ISERE,Pont-de-Chéruy,825,318,507,13,494,1,LR,20,7.825,31.7
2017,ISERE,Pont-de-Chéruy,825,318,507,13,494,1,LREM,97,7.825,31.7
2017,ISERE,Pont-de-Chéruy,825,318,507,13,494,1,NPA,5,7.825,31.7
2017,ISERE,Pont-de-Chéruy,825,318,507,13,494,1,PCF,6,7.825,31.7
2017,ISERE,Pont-de-Chéruy,825,318,507,13,494,1,REC,38,7.825,31.7
2017,ISERE,Pont-de-Chéruy,825,318,507,13,494,1,RES,8,7.825,31.7
2017,ISERE,Moidieu-Détourbe,827,157,670,17,653,1,EELV,26,7.825,31.7
2017,ISERE,Moidieu-Détourbe,827,157,670,17,653,1,FN,194,7.825,31.7
2017,ISERE,Moidieu-Détourbe,827,157,670,17,653,1,LFI,104,7.825,31.7
2017,ISERE,Moidieu-Détourbe,827,157,670,17,653,1,LO,7,7.825,31.7
2017,ISERE,Moidieu-Détourbe,827,157,670,17,653,1,LR,31,7.825,31.7
2017,ISERE,Moidieu-Détourbe,827,157,670,17,653,1,LREM,146,7.825,31.7
2017,ISERE,Moidieu-Détourbe,827,157,670,17,653,1,NPA,5,7.825,31.7
2017,ISERE,Moidieu-Détourbe,827,157,670,17,653,1,PCF,14,7.825,31.7
2017,ISERE,Moidieu-Détourbe,827,157,670,17,653,1,REC,68,7.825,31.7
2017,ISERE,Moidieu-Détourbe,827,157,670,17,653,1,RES,24,7.825,31.7
2017,ISERE,Les Avenières Veyrins-Thuellin,827,200,627,18,609,1,EELV,27,7.825,31.7
2017,ISERE,Les Avenières Veyrins-Thuellin,827,200,627,18,609,1,FN,200,7.825,31.7
2017,ISERE,Les Avenières Veyrins-Thuellin,827,200,627,18,609,1,LFI,77,7.825,31.7
2017,ISERE,Les Avenières Veyrins-Thuellin,827,200,627,18,609,1,LO,1,7.825,31.7
2017,ISERE,Les Avenières Veyrins-Thuellin,827,200,627,18,609,1,LR,34,7.825,31.7
2017,ISERE,Les Avenières Veyrins-Thuellin,827,200,627,18,609,1,LREM,153,7.825,31.7
2017,ISERE,Les Avenières Veyrins-Thuellin,827,200,627,18,609,1,NPA,7,7.825,31.7
2017,ISERE,Les Avenières Veyrins-Thuellin,827,200,627,18,609,1,PCF,5,7.825,31.7
2017,ISERE,Les Avenières Veyrins-Thuellin,827,200,627,18,609,1,REC,59,7.825,31.7
2017,ISERE,Les Avenières Veyrins-Thuellin,827,200,627,18,609,1,RES,18,7.825,31.7
2017,ISERE,Poisat,828,139,689,18,671,1,EELV,51,7.825,31.7
2017,ISERE,Poisat,828,139,689,18,671,1,FN,125,7.825,31.7
2017,ISERE,Poisat,828,139,689,18,671,1,LFI,140,7.825,31.7
2017,ISERE,Poisat,828,139,689,18,671,1,LO,1,7.825,31.7
2017,ISERE,Poisat,828,139,689,18,671,1,LR,26,7.825,31.7
2017,ISERE,Poisat,828,139,689,18,671,1,LREM,215,7.825,31.7
2017,ISERE,Poisat,828,139,689,18,671,1,NPA,11,7.825,31.7
2017,ISERE,Poisat,828,139,689,18,671,1,PCF,15,7.825,31.7
2017,ISERE,Poisat,828,139,689,18,671,1,REC,41,7.825,31.7
2017,ISERE,Poisat,828,139,689,18,671,1,RES,9,7.825,31.7
2017,ISERE,Grenoble,828,382,446,6,440,1,EELV,7,7.825,31.7
2017,ISERE,Grenoble,828,382,446,6,440,1,FN,64,7.825,31.7
2017,ISERE,Grenoble,828,382,446,6,440,1,LFI,231,7.825,31.7
2017,ISERE,Grenoble,828,382,446,6,440,1,LO,1,7.825,31.7
2017,ISERE,Grenoble,828,382,446,6,440,1,LR,8,7.825,31.7
2017,ISERE,Grenoble,828,382,446,6,440,1,LREM,79,7.825,31.7
2017,ISERE,Grenoble,828,382,446,6,440,1,NPA,2,7.825,31.7
2017,ISERE,Grenoble,828,382,446,6,440,1,PCF,12,7.825,31.7
2017,ISERE,Grenoble,828,382,446,6,440,1,REC,16,7.825,31.7
2017,ISERE,Grenoble,828,382,446,6,440,1,RES,7,7.825,31.7
2017,ISERE,Sainte-Blandine,830,133,697,9,688,1,EELV,22,7.825,31.7
2017,ISERE,Sainte-Blandine,830,133,697,9,688,1,FN,247,7.825,31.7
2017,ISERE,Sainte-Blandine,830,133,697,9,688,1,LFI,113,7.825,31.7
2017,ISERE,Sainte-Blandine,830,133,697,9,688,1,LO,5,7.825,31.7
2017,ISERE,Sainte-Blandine,830,133,697,9,688,1,LR,28,7.825,31.7
2017,ISERE,Sainte-Blandine,830,133,697,9,688,1,LREM,138,7.825,31.7
2017,ISERE,Sainte-Blandine,830,133,697,9,688,1,NPA,2,7.825,31.7
2017,ISERE,Sainte-Blandine,830,133,697,9,688,1,PCF,15,7.825,31.7
2017,ISERE,Sainte-Blandine,830,133,697,9,688,1,REC,58,7.825,31.7
2017,ISERE,Sainte-Blandine,830,133,697,9,688,1,RES,23,7.825,31.7
2017,ISERE,Echirolles,830,235,595,19,576,1,EELV,9,7.825,31.7
2017,ISERE,Echirolles,830,235,595,19,576,1,FN,169,7.825,31.7
2017,ISERE,Echirolles,830,235,595,19,576,1,LFI,172,7.825,31.7
2017,ISERE,Echirolles,830,235,595,19,576,1,LO,4,7.825,31.7
2017,ISERE,Echirolles,830,235,595,19,576,1,LR,7,7.825,31.7
2017,ISERE,Echirolles,830,235,595,19,576,1,LREM,131,7.825,31.7
2017,ISERE,Echirolles,830,235,595,19,576,1,NPA,6,7.825,31.7
2017,ISERE,Echirolles,830,235,595,19,576,1,PCF,17,7.825,31.7
2017,ISERE,Echirolles,830,235,595,19,576,1,REC,33,7.825,31.7
2017,ISERE,Echirolles,830,235,595,19,576,1,RES,16,7.825,31.7
2017,ISERE,Saint-Maurice-l'Exil,830,235,595,10,585,1,EELV,11,7.825,31.7
2017,ISERE,Saint-Maurice-l'Exil,830,235,595,10,585,1,FN,187,7.825,31.7
2017,ISERE,Saint-Maurice-l'Exil,830,235,595,10,585,1,LFI,142,7.825,31.7
2017,ISERE,Saint-Maurice-l'Exil,830,235,595,10,585,1,LO,7,7.825,31.7
2017,ISERE,Saint-Maurice-l'Exil,830,235,595,10,585,1,LR,26,7.825,31.7
2017,ISERE,Saint-Maurice-l'Exil,830,235,595,10,585,1,LREM,112,7.825,31.7
2017,ISERE,Saint-Maurice-l'Exil,830,235,595,10,585,1,NPA,4,7.825,31.7
2017,ISERE,Saint-Maurice-l'Exil,830,235,595,10,585,1,PCF,22,7.825,31.7
2017,ISERE,Saint-Maurice-l'Exil,830,235,595,10,585,1,REC,34,7.825,31.7
2017,ISERE,Saint-Maurice-l'Exil,830,235,595,10,585,1,RES,18,7.825,31.7
2017,ISERE,Grenoble,830,314,516,6,510,1,EELV,14,7.825,31.7
2017,ISERE,Grenoble,830,314,516,6,510,1,FN,81,7.825,31.7
2017,ISERE,Grenoble,830,314,516,6,510,1,LFI,268,7.825,31.7
2017,ISERE,Grenoble,830,314,516,6,510,1,LO,2,7.825,31.7
2017,ISERE,Grenoble,830,314,516,6,510,1,LR,12,7.825,31.7
2017,ISERE,Grenoble,830,314,516,6,510,1,LREM,95,7.825,31.7
2017,ISERE,Grenoble,830,314,516,6,510,1,NPA,1,7.825,31.7
2017,ISERE,Grenoble,830,314,516,6,510,1,PCF,6,7.825,31.7
2017,ISERE,Grenoble,830,314,516,6,510,1,REC,14,7.825,31.7
2017,ISERE,Grenoble,830,314,516,6,510,1,RES,5,7.825,31.7
2017,ISERE,Beauvoir-de-Marc,831,161,670,24,646,1,EELV,12,7.825,31.7
2017,ISERE,Beauvoir-de-Marc,831,161,670,24,646,1,FN,215,7.825,31.7
2017,ISERE,Beauvoir-de-Marc,831,161,670,24,646,1,LFI,92,7.825,31.7
2017,ISERE,Beauvoir-de-Marc,831,161,670,24,646,1,LO,1,7.825,31.7
2017,ISERE,Beauvoir-de-Marc,831,161,670,24,646,1,LR,28,7.825,31.7
2017,ISERE,Beauvoir-de-Marc,831,161,670,24,646,1,LREM,181,7.825,31.7
2017,ISERE,Beauvoir-de-Marc,831,161,670,24,646,1,NPA,6,7.825,31.7
2017,ISERE,Beauvoir-de-Marc,831,161,670,24,646,1,PCF,7,7.825,31.7
2017,ISERE,Beauvoir-de-Marc,831,161,670,24,646,1,REC,48,7.825,31.7
2017,ISERE,Beauvoir-de-Marc,831,161,670,24,646,1,RES,23,7.825,31.7
2017,ISERE,Châbons,831,186,645,20,625,1,EELV,21,7.825,31.7
2017,ISERE,Châbons,831,186,645,20,625,1,FN,206,7.825,31.7
2017,ISERE,Châbons,831,186,645,20,625,1,LFI,119,7.825,31.7
2017,ISERE,Châbons,831,186,645,20,625,1,LO,2,7.825,31.7
2017,ISERE,Châbons,831,186,645,20,625,1,LR,26,7.825,31.7
2017,ISERE,Châbons,831,186,645,20,625,1,LREM,140,7.825,31.7
2017,ISERE,Châbons,831,186,645,20,625,1,NPA,0,7.825,31.7
2017,ISERE,Châbons,831,186,645,20,625,1,PCF,12,7.825,31.7
2017,ISERE,Châbons,831,186,645,20,625,1,REC,59,7.825,31.7
2017,ISERE,Châbons,831,186,645,20,625,1,RES,13,7.825,31.7
2017,ISERE,Le Cheylas,831,236,595,8,587,1,EELV,34,7.825,31.7
2017,ISERE,Le Cheylas,831,236,595,8,587,1,FN,144,7.825,31.7
2017,ISERE,Le Cheylas,831,236,595,8,587,1,LFI,159,7.825,31.7
2017,ISERE,Le Cheylas,831,236,595,8,587,1,LO,3,7.825,31.7
2017,ISERE,Le Cheylas,831,236,595,8,587,1,LR,23,7.825,31.7
2017,ISERE,Le Cheylas,831,236,595,8,587,1,LREM,147,7.825,31.7
2017,ISERE,Le Cheylas,831,236,595,8,587,1,NPA,14,7.825,31.7
2017,ISERE,Le Cheylas,831,236,595,8,587,1,PCF,13,7.825,31.7
2017,ISERE,Le Cheylas,831,236,595,8,587,1,REC,23,7.825,31.7
2017,ISERE,Le Cheylas,831,236,595,8,587,1,RES,16,7.825,31.7
2017,ISERE,Villemoirieu,832,147,685,22,663,1,EELV,37,7.825,31.7
2017,ISERE,Villemoirieu,832,147,685,22,663,1,FN,184,7.825,31.7
2017,ISERE,Villemoirieu,832,147,685,22,663,1,LFI,91,7.825,31.7
2017,ISERE,Villemoirieu,832,147,685,22,663,1,LO,6,7.825,31.7
2017,ISERE,Villemoirieu,832,147,685,22,663,1,LR,37,7.825,31.7
2017,ISERE,Villemoirieu,832,147,685,22,663,1,LREM,188,7.825,31.7
2017,ISERE,Villemoirieu,832,147,685,22,663,1,NPA,3,7.825,31.7
2017,ISERE,Villemoirieu,832,147,685,22,663,1,PCF,6,7.825,31.7
2017,ISERE,Villemoirieu,832,147,685,22,663,1,REC,66,7.825,31.7
2017,ISERE,Villemoirieu,832,147,685,22,663,1,RES,25,7.825,31.7
2017,ISERE,Saint-Egrève,833,126,707,11,696,1,EELV,80,7.825,31.7
2017,ISERE,Saint-Egrève,833,126,707,11,696,1,FN,93,7.825,31.7
2017,ISERE,Saint-Egrève,833,126,707,11,696,1,LFI,167,7.825,31.7
2017,ISERE,Saint-Egrève,833,126,707,11,696,1,LO,1,7.825,31.7
2017,ISERE,Saint-Egrève,833,126,707,11,696,1,LR,31,7.825,31.7
2017,ISERE,Saint-Egrève,833,126,707,11,696,1,LREM,229,7.825,31.7
2017,ISERE,Saint-Egrève,833,126,707,11,696,1,NPA,3,7.825,31.7
2017,ISERE,Saint-Egrève,833,126,707,11,696,1,PCF,9,7.825,31.7
2017,ISERE,Saint-Egrève,833,126,707,11,696,1,REC,39,7.825,31.7
2017,ISERE,Saint-Egrève,833,126,707,11,696,1,RES,8,7.825,31.7
2017,ISERE,Saint-Ismier,833,164,669,12,657,1,EELV,50,7.825,31.7
2017,ISERE,Saint-Ismier,833,164,669,12,657,1,FN,68,7.825,31.7
2017,ISERE,Saint-Ismier,833,164,669,12,657,1,LFI,72,7.825,31.7
2017,ISERE,Saint-Ismier,833,164,669,12,657,1,LO,2,7.825,31.7
2017,ISERE,Saint-Ismier,833,164,669,12,657,1,LR,71,7.825,31.7
2017,ISERE,Saint-Ismier,833,164,669,12,657,1,LREM,305,7.825,31.7
2017,ISERE,Saint-Ismier,833,164,669,12,657,1,NPA,2,7.825,31.7
2017,ISERE,Saint-Ismier,833,164,669,12,657,1,PCF,6,7.825,31.7
2017,ISERE,Saint-Ismier,833,164,669,12,657,1,REC,57,7.825,31.7
2017,ISERE,Saint-Ismier,833,164,669,12,657,1,RES,9,7.825,31.7
2017,ISERE,Vienne,833,231,602,19,583,1,EELV,20,7.825,31.7
2017,ISERE,Vienne,833,231,602,19,583,1,FN,117,7.825,31.7
2017,ISERE,Vienne,833,231,602,19,583,1,LFI,197,7.825,31.7
2017,ISERE,Vienne,833,231,602,19,583,1,LO,3,7.825,31.7
2017,ISERE,Vienne,833,231,602,19,583,1,LR,22,7.825,31.7
2017,ISERE,Vienne,833,231,602,19,583,1,LREM,133,7.825,31.7
2017,ISERE,Vienne,833,231,602,19,583,1,NPA,0,7.825,31.7
2017,ISERE,Vienne,833,231,602,19,583,1,PCF,15,7.825,31.7
2017,ISERE,Vienne,833,231,602,19,583,1,REC,31,7.825,31.7
2017,ISERE,Vienne,833,231,602,19,583,1,RES,15,7.825,31.7
2017,ISERE,Grenoble,833,437,396,4,392,1,EELV,14,7.825,31.7
2017,ISERE,Grenoble,833,437,396,4,392,1,FN,22,7.825,31.7
2017,ISERE,Grenoble,833,437,396,4,392,1,LFI,275,7.825,31.7
2017,ISERE,Grenoble,833,437,396,4,392,1,LO,4,7.825,31.7
2017,ISERE,Grenoble,833,437,396,4,392,1,LR,5,7.825,31.7
2017,ISERE,Grenoble,833,437,396,4,392,1,LREM,51,7.825,31.7
2017,ISERE,Grenoble,833,437,396,4,392,1,NPA,1,7.825,31.7
2017,ISERE,Grenoble,833,437,396,4,392,1,PCF,3,7.825,31.7
2017,ISERE,Grenoble,833,437,396,4,392,1,REC,10,7.825,31.7
2017,ISERE,Grenoble,833,437,396,4,392,1,RES,1,7.825,31.7
2017,ISERE,Grenoble,834,245,589,10,579,1,EELV,24,7.825,31.7
2017,ISERE,Grenoble,834,245,589,10,579,1,FN,99,7.825,31.7
2017,ISERE,Grenoble,834,245,589,10,579,1,LFI,215,7.825,31.7
2017,ISERE,Grenoble,834,245,589,10,579,1,LO,0,7.825,31.7
2017,ISERE,Grenoble,834,245,589,10,579,1,LR,14,7.825,31.7
2017,ISERE,Grenoble,834,245,589,10,579,1,LREM,148,7.825,31.7
2017,ISERE,Grenoble,834,245,589,10,579,1,NPA,6,7.825,31.7
2017,ISERE,Grenoble,834,245,589,10,579,1,PCF,16,7.825,31.7
2017,ISERE,Grenoble,834,245,589,10,579,1,REC,41,7.825,31.7
2017,ISERE,Grenoble,834,245,589,10,579,1,RES,5,7.825,31.7
2017,ISERE,Echirolles,834,324,510,12,498,1,EELV,8,7.825,31.7
2017,ISERE,Echirolles,834,324,510,12,498,1,FN,119,7.825,31.7
2017,ISERE,Echirolles,834,324,510,12,498,1,LFI,222,7.825,31.7
2017,ISERE,Echirolles,834,324,510,12,498,1,LO,5,7.825,31.7
2017,ISERE,Echirolles,834,324,510,12,498,1,LR,15,7.825,31.7
2017,ISERE,Echirolles,834,324,510,12,498,1,LREM,77,7.825,31.7
2017,ISERE,Echirolles,834,324,510,12,498,1,NPA,2,7.825,31.7
2017,ISERE,Echirolles,834,324,510,12,498,1,PCF,13,7.825,31.7
2017,ISERE,Echirolles,834,324,510,12,498,1,REC,19,7.825,31.7
2017,ISERE,Echirolles,834,324,510,12,498,1,RES,7,7.825,31.7
2017,ISERE,Charvieu-Chavagneux,836,290,546,10,536,1,EELV,10,7.825,31.7
2017,ISERE,Charvieu-Chavagneux,836,290,546,10,536,1,FN,168,7.825,31.7
2017,ISERE,Charvieu-Chavagneux,836,290,546,10,536,1,LFI,177,7.825,31.7
2017,ISERE,Charvieu-Chavagneux,836,290,546,10,536,1,LO,2,7.825,31.7
2017,ISERE,Charvieu-Chavagneux,836,290,546,10,536,1,LR,12,7.825,31.7
2017,ISERE,Charvieu-Chavagneux,836,290,546,10,536,1,LREM,91,7.825,31.7
2017,ISERE,Charvieu-Chavagneux,836,290,546,10,536,1,NPA,4,7.825,31.7
2017,ISERE,Charvieu-Chavagneux,836,290,546,10,536,1,PCF,11,7.825,31.7
2017,ISERE,Charvieu-Chavagneux,836,290,546,10,536,1,REC,42,7.825,31.7
2017,ISERE,Charvieu-Chavagneux,836,290,546,10,536,1,RES,8,7.825,31.7
2017,ISERE,Saint-Martin-d'Hères,837,234,603,12,591,1,EELV,28,7.825,31.7
2017,ISERE,Saint-Martin-d'Hères,837,234,603,12,591,1,FN,94,7.825,31.7
2017,ISERE,Saint-Martin-d'Hères,837,234,603,12,591,1,LFI,229,7.825,31.7
2017,ISERE,Saint-Martin-d'Hères,837,234,603,12,591,1,LO,1,7.825,31.7
2017,ISERE,Saint-Martin-d'Hères,837,234,603,12,591,1,LR,18,7.825,31.7
2017,ISERE,Saint-Martin-d'Hères,837,234,603,12,591,1,LREM,137,7.825,31.7
2017,ISERE,Saint-Martin-d'Hères,837,234,603,12,591,1,NPA,6,7.825,31.7
2017,ISERE,Saint-Martin-d'Hères,837,234,603,12,591,1,PCF,19,7.825,31.7
2017,ISERE,Saint-Martin-d'Hères,837,234,603,12,591,1,REC,35,7.825,31.7
2017,ISERE,Saint-Martin-d'Hères,837,234,603,12,591,1,RES,7,7.825,31.7
2017,ISERE,Sérézin-de-la-Tour,838,151,687,11,676,1,EELV,32,7.825,31.7
2017,ISERE,Sérézin-de-la-Tour,838,151,687,11,676,1,FN,226,7.825,31.7
2017,ISERE,Sérézin-de-la-Tour,838,151,687,11,676,1,LFI,98,7.825,31.7
2017,ISERE,Sérézin-de-la-Tour,838,151,687,11,676,1,LO,3,7.825,31.7
2017,ISERE,Sérézin-de-la-Tour,838,151,687,11,676,1,LR,36,7.825,31.7
2017,ISERE,Sérézin-de-la-Tour,838,151,687,11,676,1,LREM,191,7.825,31.7
2017,ISERE,Sérézin-de-la-Tour,838,151,687,11,676,1,NPA,1,7.825,31.7
2017,ISERE,Sérézin-de-la-Tour,838,151,687,11,676,1,PCF,8,7.825,31.7
2017,ISERE,Sérézin-de-la-Tour,838,151,687,11,676,1,REC,36,7.825,31.7
2017,ISERE,Sérézin-de-la-Tour,838,151,687,11,676,1,RES,18,7.825,31.7
2017,ISERE,Roybon,838,206,632,17,615,1,EELV,20,7.825,31.7
2017,ISERE,Roybon,838,206,632,17,615,1,FN,135,7.825,31.7
2017,ISERE,Roybon,838,206,632,17,615,1,LFI,137,7.825,31.7
2017,ISERE,Roybon,838,206,632,17,615,1,LO,2,7.825,31.7
2017,ISERE,Roybon,838,206,632,17,615,1,LR,36,7.825,31.7
2017,ISERE,Roybon,838,206,632,17,615,1,LREM,176,7.825,31.7
2017,ISERE,Roybon,838,206,632,17,615,1,NPA,4,7.825,31.7
2017,ISERE,Roybon,838,206,632,17,615,1,PCF,17,7.825,31.7
2017,ISERE,Roybon,838,206,632,17,615,1,REC,34,7.825,31.7
2017,ISERE,Roybon,838,206,632,17,615,1,RES,25,7.825,31.7
2017,ISERE,Saint-Martin-d'Uriage,839,134,705,16,689,1,EELV,106,7.825,31.7
2017,ISERE,Saint-Martin-d'Uriage,839,134,705,16,689,1,FN,56,7.825,31.7
2017,ISERE,Saint-Martin-d'Uriage,839,134,705,16,689,1,LFI,155,7.825,31.7
2017,ISERE,Saint-Martin-d'Uriage,839,134,705,16,689,1,LO,7,7.825,31.7
2017,ISERE,Saint-Martin-d'Uriage,839,134,705,16,689,1,LR,37,7.825,31.7
2017,ISERE,Saint-Martin-d'Uriage,839,134,705,16,689,1,LREM,241,7.825,31.7
2017,ISERE,Saint-Martin-d'Uriage,839,134,705,16,689,1,NPA,2,7.825,31.7
2017,ISERE,Saint-Martin-d'Uriage,839,134,705,16,689,1,PCF,16,7.825,31.7
2017,ISERE,Saint-Martin-d'Uriage,839,134,705,16,689,1,REC,26,7.825,31.7
2017,ISERE,Saint-Martin-d'Uriage,839,134,705,16,689,1,RES,11,7.825,31.7
2017,ISERE,Saint-Egrève,840,157,683,10,673,1,EELV,55,7.825,31.7
2017,ISERE,Saint-Egrève,840,157,683,10,673,1,FN,89,7.825,31.7
2017,ISERE,Saint-Egrève,840,157,683,10,673,1,LFI,215,7.825,31.7
2017,ISERE,Saint-Egrève,840,157,683,10,673,1,LO,3,7.825,31.7
2017,ISERE,Saint-Egrève,840,157,683,10,673,1,LR,16,7.825,31.7
2017,ISERE,Saint-Egrève,840,157,683,10,673,1,LREM,173,7.825,31.7
2017,ISERE,Saint-Egrève,840,157,683,10,673,1,NPA,6,7.825,31.7
2017,ISERE,Saint-Egrève,840,157,683,10,673,1,PCF,27,7.825,31.7
2017,ISERE,Saint-Egrève,840,157,683,10,673,1,REC,26,7.825,31.7
2017,ISERE,Saint-Egrève,840,157,683,10,673,1,RES,15,7.825,31.7
2017,ISERE,Meylan,840,180,660,6,654,1,EELV,44,7.825,31.7
2017,ISERE,Meylan,840,180,660,6,654,1,FN,76,7.825,31.7
2017,ISERE,Meylan,840,180,660,6,654,1,LFI,122,7.825,31.7
2017,ISERE,Meylan,840,180,660,6,654,1,LO,2,7.825,31.7
2017,ISERE,Meylan,840,180,660,6,654,1,LR,41,7.825,31.7
2017,ISERE,Meylan,840,180,660,6,654,1,LREM,260,7.825,31.7
2017,ISERE,Meylan,840,180,660,6,654,1,NPA,4,7.825,31.7
2017,ISERE,Meylan,840,180,660,6,654,1,PCF,8,7.825,31.7
2017,ISERE,Meylan,840,180,660,6,654,1,REC,67,7.825,31.7
2017,ISERE,Meylan,840,180,660,6,654,1,RES,3,7.825,31.7
2017,ISERE,La Frette,842,193,649,20,629,1,EELV,26,7.825,31.7
2017,ISERE,La Frette,842,193,649,20,629,1,FN,175,7.825,31.7
2017,ISERE,La Frette,842,193,649,20,629,1,LFI,111,7.825,31.7
2017,ISERE,La Frette,842,193,649,20,629,1,LO,5,7.825,31.7
2017,ISERE,La Frette,842,193,649,20,629,1,LR,29,7.825,31.7
2017,ISERE,La Frette,842,193,649,20,629,1,LREM,160,7.825,31.7
2017,ISERE,La Frette,842,193,649,20,629,1,NPA,1,7.825,31.7
2017,ISERE,La Frette,842,193,649,20,629,1,PCF,13,7.825,31.7
2017,ISERE,La Frette,842,193,649,20,629,1,REC,51,7.825,31.7
2017,ISERE,La Frette,842,193,649,20,629,1,RES,19,7.825,31.7
2017,ISERE,Varces-Allières-et-Risset,842,225,617,11,606,1,EELV,24,7.825,31.7
2017,ISERE,Varces-Allières-et-Risset,842,225,617,11,606,1,FN,196,7.825,31.7
2017,ISERE,Varces-Allières-et-Risset,842,225,617,11,606,1,LFI,90,7.825,31.7
2017,ISERE,Varces-Allières-et-Risset,842,225,617,11,606,1,LO,6,7.825,31.7
2017,ISERE,Varces-Allières-et-Risset,842,225,617,11,606,1,LR,28,7.825,31.7
2017,ISERE,Varces-Allières-et-Risset,842,225,617,11,606,1,LREM,149,7.825,31.7
2017,ISERE,Varces-Allières-et-Risset,842,225,617,11,606,1,NPA,1,7.825,31.7
2017,ISERE,Varces-Allières-et-Risset,842,225,617,11,606,1,PCF,10,7.825,31.7
2017,ISERE,Varces-Allières-et-Risset,842,225,617,11,606,1,REC,67,7.825,31.7
2017,ISERE,Varces-Allières-et-Risset,842,225,617,11,606,1,RES,14,7.825,31.7
2017,ISERE,Les Avenières Veyrins-Thuellin,842,247,595,12,583,1,EELV,21,7.825,31.7
2017,ISERE,Les Avenières Veyrins-Thuellin,842,247,595,12,583,1,FN,206,7.825,31.7
2017,ISERE,Les Avenières Veyrins-Thuellin,842,247,595,12,583,1,LFI,98,7.825,31.7
2017,ISERE,Les Avenières Veyrins-Thuellin,842,247,595,12,583,1,LO,6,7.825,31.7
2017,ISERE,Les Avenières Veyrins-Thuellin,842,247,595,12,583,1,LR,26,7.825,31.7
2017,ISERE,Les Avenières Veyrins-Thuellin,842,247,595,12,583,1,LREM,133,7.825,31.7
2017,ISERE,Les Avenières Veyrins-Thuellin,842,247,595,12,583,1,NPA,5,7.825,31.7
2017,ISERE,Les Avenières Veyrins-Thuellin,842,247,595,12,583,1,PCF,13,7.825,31.7
2017,ISERE,Les Avenières Veyrins-Thuellin,842,247,595,12,583,1,REC,50,7.825,31.7
2017,ISERE,Les Avenières Veyrins-Thuellin,842,247,595,12,583,1,RES,14,7.825,31.7
2017,ISERE,Tignieu-Jameyzieu,843,238,605,20,585,1,EELV,20,7.825,31.7
2017,ISERE,Tignieu-Jameyzieu,843,238,605,20,585,1,FN,170,7.825,31.7
2017,ISERE,Tignieu-Jameyzieu,843,238,605,20,585,1,LFI,144,7.825,31.7
2017,ISERE,Tignieu-Jameyzieu,843,238,605,20,585,1,LO,4,7.825,31.7
2017,ISERE,Tignieu-Jameyzieu,843,238,605,20,585,1,LR,13,7.825,31.7
2017,ISERE,Tignieu-Jameyzieu,843,238,605,20,585,1,LREM,152,7.825,31.7
2017,ISERE,Tignieu-Jameyzieu,843,238,605,20,585,1,NPA,4,7.825,31.7
2017,ISERE,Tignieu-Jameyzieu,843,238,605,20,585,1,PCF,9,7.825,31.7
2017,ISERE,Tignieu-Jameyzieu,843,238,605,20,585,1,REC,45,7.825,31.7
2017,ISERE,Tignieu-Jameyzieu,843,238,605,20,585,1,RES,13,7.825,31.7
2017,ISERE,Voreppe,844,155,689,9,680,1,EELV,51,7.825,31.7
2017,ISERE,Voreppe,844,155,689,9,680,1,FN,142,7.825,31.7
2017,ISERE,Voreppe,844,155,689,9,680,1,LFI,163,7.825,31.7
2017,ISERE,Voreppe,844,155,689,9,680,1,LO,3,7.825,31.7
2017,ISERE,Voreppe,844,155,689,9,680,1,LR,26,7.825,31.7
2017,ISERE,Voreppe,844,155,689,9,680,1,LREM,202,7.825,31.7
2017,ISERE,Voreppe,844,155,689,9,680,1,NPA,4,7.825,31.7
2017,ISERE,Voreppe,844,155,689,9,680,1,PCF,17,7.825,31.7
2017,ISERE,Voreppe,844,155,689,9,680,1,REC,26,7.825,31.7
2017,ISERE,Voreppe,844,155,689,9,680,1,RES,21,7.825,31.7
2017,ISERE,Vienne,844,183,661,18,643,1,EELV,43,7.825,31.7
2017,ISERE,Vienne,844,183,661,18,643,1,FN,87,7.825,31.7
2017,ISERE,Vienne,844,183,661,18,643,1,LFI,165,7.825,31.7
2017,ISERE,Vienne,844,183,661,18,643,1,LO,5,7.825,31.7
2017,ISERE,Vienne,844,183,661,18,643,1,LR,43,7.825,31.7
2017,ISERE,Vienne,844,183,661,18,643,1,LREM,194,7.825,31.7
2017,ISERE,Vienne,844,183,661,18,643,1,NPA,3,7.825,31.7
2017,ISERE,Vienne,844,183,661,18,643,1,PCF,13,7.825,31.7
2017,ISERE,Vienne,844,183,661,18,643,1,REC,50,7.825,31.7
2017,ISERE,Vienne,844,183,661,18,643,1,RES,16,7.825,31.7
2017,ISERE,Seyssinet-Pariset,845,176,669,13,656,1,EELV,42,7.825,31.7
2017,ISERE,Seyssinet-Pariset,845,176,669,13,656,1,FN,133,7.825,31.7
2017,ISERE,Seyssinet-Pariset,845,176,669,13,656,1,LFI,139,7.825,31.7
2017,ISERE,Seyssinet-Pariset,845,176,669,13,656,1,LO,5,7.825,31.7
2017,ISERE,Seyssinet-Pariset,845,176,669,13,656,1,LR,28,7.825,31.7
2017,ISERE,Seyssinet-Pariset,845,176,669,13,656,1,LREM,212,7.825,31.7
2017,ISERE,Seyssinet-Pariset,845,176,669,13,656,1,NPA,6,7.825,31.7
2017,ISERE,Seyssinet-Pariset,845,176,669,13,656,1,PCF,14,7.825,31.7
2017,ISERE,Seyssinet-Pariset,845,176,669,13,656,1,REC,36,7.825,31.7
2017,ISERE,Seyssinet-Pariset,845,176,669,13,656,1,RES,16,7.825,31.7
2017,ISERE,Saint-Martin-d'Hères,845,268,577,13,564,1,EELV,29,7.825,31.7
2017,ISERE,Saint-Martin-d'Hères,845,268,577,13,564,1,FN,128,7.825,31.7
2017,ISERE,Saint-Martin-d'Hères,845,268,577,13,564,1,LFI,182,7.825,31.7
2017,ISERE,Saint-Martin-d'Hères,845,268,577,13,564,1,LO,6,7.825,31.7
2017,ISERE,Saint-Martin-d'Hères,845,268,577,13,564,1,LR,14,7.825,31.7
2017,ISERE,Saint-Martin-d'Hères,845,268,577,13,564,1,LREM,119,7.825,31.7
2017,ISERE,Saint-Martin-d'Hères,845,268,577,13,564,1,NPA,6,7.825,31.7
2017,ISERE,Saint-Martin-d'Hères,845,268,577,13,564,1,PCF,20,7.825,31.7
2017,ISERE,Saint-Martin-d'Hères,845,268,577,13,564,1,REC,34,7.825,31.7
2017,ISERE,Saint-Martin-d'Hères,845,268,577,13,564,1,RES,3,7.825,31.7
2017,ISERE,Le Pont-de-Claix,845,332,513,13,500,1,EELV,5,7.825,31.7
2017,ISERE,Le Pont-de-Claix,845,332,513,13,500,1,FN,107,7.825,31.7
2017,ISERE,Le Pont-de-Claix,845,332,513,13,500,1,LFI,254,7.825,31.7
2017,ISERE,Le Pont-de-Claix,845,332,513,13,500,1,LO,6,7.825,31.7
2017,ISERE,Le Pont-de-Claix,845,332,513,13,500,1,LR,10,7.825,31.7
2017,ISERE,Le Pont-de-Claix,845,332,513,13,500,1,LREM,78,7.825,31.7
2017,ISERE,Le Pont-de-Claix,845,332,513,13,500,1,NPA,3,7.825,31.7
2017,ISERE,Le Pont-de-Claix,845,332,513,13,500,1,PCF,6,7.825,31.7
2017,ISERE,Le Pont-de-Claix,845,332,513,13,500,1,REC,19,7.825,31.7
2017,ISERE,Le Pont-de-Claix,845,332,513,13,500,1,RES,6,7.825,31.7
2017,ISERE,Grenoble,846,201,645,13,632,1,EELV,57,7.825,31.7
2017,ISERE,Grenoble,846,201,645,13,632,1,FN,71,7.825,31.7
2017,ISERE,Grenoble,846,201,645,13,632,1,LFI,237,7.825,31.7
2017,ISERE,Grenoble,846,201,645,13,632,1,LO,6,7.825,31.7
2017,ISERE,Grenoble,846,201,645,13,632,1,LR,24,7.825,31.7
2017,ISERE,Grenoble,846,201,645,13,632,1,LREM,142,7.825,31.7
2017,ISERE,Grenoble,846,201,645,13,632,1,NPA,3,7.825,31.7
2017,ISERE,Grenoble,846,201,645,13,632,1,PCF,12,7.825,31.7
2017,ISERE,Grenoble,846,201,645,13,632,1,REC,46,7.825,31.7
2017,ISERE,Grenoble,846,201,645,13,632,1,RES,8,7.825,31.7
2017,ISERE,La Verpillière,846,217,629,12,617,1,EELV,15,7.825,31.7
2017,ISERE,La Verpillière,846,217,629,12,617,1,FN,179,7.825,31.7
2017,ISERE,La Verpillière,846,217,629,12,617,1,LFI,151,7.825,31.7
2017,ISERE,La Verpillière,846,217,629,12,617,1,LO,3,7.825,31.7
2017,ISERE,La Verpillière,846,217,629,12,617,1,LR,20,7.825,31.7
2017,ISERE,La Verpillière,846,217,629,12,617,1,LREM,140,7.825,31.7
2017,ISERE,La Verpillière,846,217,629,12,617,1,NPA,6,7.825,31.7
2017,ISERE,La Verpillière,846,217,629,12,617,1,PCF,8,7.825,31.7
2017,ISERE,La Verpillière,846,217,629,12,617,1,REC,53,7.825,31.7
2017,ISERE,La Verpillière,846,217,629,12,617,1,RES,21,7.825,31.7
2017,ISERE,Le Versoud,847,144,703,16,687,1,EELV,45,7.825,31.7
2017,ISERE,Le Versoud,847,144,703,16,687,1,FN,133,7.825,31.7
2017,ISERE,Le Versoud,847,144,703,16,687,1,LFI,107,7.825,31.7
2017,ISERE,Le Versoud,847,144,703,16,687,1,LO,2,7.825,31.7
2017,ISERE,Le Versoud,847,144,703,16,687,1,LR,23,7.825,31.7
2017,ISERE,Le Versoud,847,144,703,16,687,1,LREM,280,7.825,31.7
2017,ISERE,Le Versoud,847,144,703,16,687,1,NPA,4,7.825,31.7
2017,ISERE,Le Versoud,847,144,703,16,687,1,PCF,14,7.825,31.7
2017,ISERE,Le Versoud,847,144,703,16,687,1,REC,42,7.825,31.7
2017,ISERE,Le Versoud,847,144,703,16,687,1,RES,11,7.825,31.7
2017,ISERE,Poliénas,847,173,674,17,657,1,EELV,30,7.825,31.7
2017,ISERE,Poliénas,847,173,674,17,657,1,FN,187,7.825,31.7
2017,ISERE,Poliénas,847,173,674,17,657,1,LFI,127,7.825,31.7
2017,ISERE,Poliénas,847,173,674,17,657,1,LO,4,7.825,31.7
2017,ISERE,Poliénas,847,173,674,17,657,1,LR,31,7.825,31.7
2017,ISERE,Poliénas,847,173,674,17,657,1,LREM,143,7.825,31.7
2017,ISERE,Poliénas,847,173,674,17,657,1,NPA,14,7.825,31.7
2017,ISERE,Poliénas,847,173,674,17,657,1,PCF,15,7.825,31.7
2017,ISERE,Poliénas,847,173,674,17,657,1,REC,42,7.825,31.7
2017,ISERE,Poliénas,847,173,674,17,657,1,RES,31,7.825,31.7
2017,ISERE,Saint-Romain-de-Jalionas,849,144,705,14,691,1,EELV,22,7.825,31.7
2017,ISERE,Saint-Romain-de-Jalionas,849,144,705,14,691,1,FN,274,7.825,31.7
2017,ISERE,Saint-Romain-de-Jalionas,849,144,705,14,691,1,LFI,91,7.825,31.7
2017,ISERE,Saint-Romain-de-Jalionas,849,144,705,14,691,1,LO,8,7.825,31.7
2017,ISERE,Saint-Romain-de-Jalionas,849,144,705,14,691,1,LR,33,7.825,31.7
2017,ISERE,Saint-Romain-de-Jalionas,849,144,705,14,691,1,LREM,157,7.825,31.7
2017,ISERE,Saint-Romain-de-Jalionas,849,144,705,14,691,1,NPA,3,7.825,31.7
2017,ISERE,Saint-Romain-de-Jalionas,849,144,705,14,691,1,PCF,11,7.825,31.7
2017,ISERE,Saint-Romain-de-Jalionas,849,144,705,14,691,1,REC,57,7.825,31.7
2017,ISERE,Saint-Romain-de-Jalionas,849,144,705,14,691,1,RES,14,7.825,31.7
2017,ISERE,La Verpillière,851,197,654,11,643,1,EELV,44,7.825,31.7
2017,ISERE,La Verpillière,851,197,654,11,643,1,FN,169,7.825,31.7
2017,ISERE,La Verpillière,851,197,654,11,643,1,LFI,131,7.825,31.7
2017,ISERE,La Verpillière,851,197,654,11,643,1,LO,3,7.825,31.7
2017,ISERE,La Verpillière,851,197,654,11,643,1,LR,29,7.825,31.7
2017,ISERE,La Verpillière,851,197,654,11,643,1,LREM,155,7.825,31.7
2017,ISERE,La Verpillière,851,197,654,11,643,1,NPA,3,7.825,31.7
2017,ISERE,La Verpillière,851,197,654,11,643,1,PCF,20,7.825,31.7
2017,ISERE,La Verpillière,851,197,654,11,643,1,REC,58,7.825,31.7
2017,ISERE,La Verpillière,851,197,654,11,643,1,RES,10,7.825,31.7
2017,ISERE,Saint-Martin-d'Hères,852,215,637,19,618,1,EELV,34,7.825,31.7
2017,ISERE,Saint-Martin-d'Hères,852,215,637,19,618,1,FN,101,7.825,31.7
2017,ISERE,Saint-Martin-d'Hères,852,215,637,19,618,1,LFI,218,7.825,31.7
2017,ISERE,Saint-Martin-d'Hères,852,215,637,19,618,1,LO,3,7.825,31.7
2017,ISERE,Saint-Martin-d'Hères,852,215,637,19,618,1,LR,18,7.825,31.7
2017,ISERE,Saint-Martin-d'Hères,852,215,637,19,618,1,LREM,158,7.825,31.7
2017,ISERE,Saint-Martin-d'Hères,852,215,637,19,618,1,NPA,6,7.825,31.7
2017,ISERE,Saint-Martin-d'Hères,852,215,637,19,618,1,PCF,25,7.825,31.7
2017,ISERE,Saint-Martin-d'Hères,852,215,637,19,618,1,REC,24,7.825,31.7
2017,ISERE,Saint-Martin-d'Hères,852,215,637,19,618,1,RES,10,7.825,31.7
2017,ISERE,Nivolas-Vermelle,853,191,662,7,655,1,EELV,33,7.825,31.7
2017,ISERE,Nivolas-Vermelle,853,191,662,7,655,1,FN,159,7.825,31.7
2017,ISERE,Nivolas-Vermelle,853,191,662,7,655,1,LFI,115,7.825,31.7
2017,ISERE,Nivolas-Vermelle,853,191,662,7,655,1,LO,4,7.825,31.7
2017,ISERE,Nivolas-Vermelle,853,191,662,7,655,1,LR,24,7.825,31.7
2017,ISERE,Nivolas-Vermelle,853,191,662,7,655,1,LREM,200,7.825,31.7
2017,ISERE,Nivolas-Vermelle,853,191,662,7,655,1,NPA,3,7.825,31.7
2017,ISERE,Nivolas-Vermelle,853,191,662,7,655,1,PCF,16,7.825,31.7
2017,ISERE,Nivolas-Vermelle,853,191,662,7,655,1,REC,47,7.825,31.7
2017,ISERE,Nivolas-Vermelle,853,191,662,7,655,1,RES,23,7.825,31.7
2017,ISERE,Eybens,853,220,633,7,626,1,EELV,29,7.825,31.7
2017,ISERE,Eybens,853,220,633,7,626,1,FN,120,7.825,31.7
2017,ISERE,Eybens,853,220,633,7,626,1,LFI,170,7.825,31.7
2017,ISERE,Eybens,853,220,633,7,626,1,LO,2,7.825,31.7
2017,ISERE,Eybens,853,220,633,7,626,1,LR,12,7.825,31.7
2017,ISERE,Eybens,853,220,633,7,626,1,LREM,185,7.825,31.7
2017,ISERE,Eybens,853,220,633,7,626,1,NPA,5,7.825,31.7
2017,ISERE,Eybens,853,220,633,7,626,1,PCF,10,7.825,31.7
2017,ISERE,Eybens,853,220,633,7,626,1,REC,55,7.825,31.7
2017,ISERE,Eybens,853,220,633,7,626,1,RES,14,7.825,31.7
2017,ISERE,Les Adrets,854,142,712,13,699,1,EELV,81,7.825,31.7
2017,ISERE,Les Adrets,854,142,712,13,699,1,FN,78,7.825,31.7
2017,ISERE,Les Adrets,854,142,712,13,699,1,LFI,219,7.825,31.7
2017,ISERE,Les Adrets,854,142,712,13,699,1,LO,0,7.825,31.7
2017,ISERE,Les Adrets,854,142,712,13,699,1,LR,29,7.825,31.7
2017,ISERE,Les Adrets,854,142,712,13,699,1,LREM,189,7.825,31.7
2017,ISERE,Les Adrets,854,142,712,13,699,1,NPA,6,7.825,31.7
2017,ISERE,Les Adrets,854,142,712,13,699,1,PCF,19,7.825,31.7
2017,ISERE,Les Adrets,854,142,712,13,699,1,REC,43,7.825,31.7
2017,ISERE,Les Adrets,854,142,712,13,699,1,RES,12,7.825,31.7
2017,ISERE,La Buisse,854,153,701,12,689,1,EELV,45,7.825,31.7
2017,ISERE,La Buisse,854,153,701,12,689,1,FN,147,7.825,31.7
2017,ISERE,La Buisse,854,153,701,12,689,1,LFI,135,7.825,31.7
2017,ISERE,La Buisse,854,153,701,12,689,1,LO,3,7.825,31.7
2017,ISERE,La Buisse,854,153,701,12,689,1,LR,28,7.825,31.7
2017,ISERE,La Buisse,854,153,701,12,689,1,LREM,240,7.825,31.7
2017,ISERE,La Buisse,854,153,701,12,689,1,NPA,8,7.825,31.7
2017,ISERE,La Buisse,854,153,701,12,689,1,PCF,15,7.825,31.7
2017,ISERE,La Buisse,854,153,701,12,689,1,REC,38,7.825,31.7
2017,ISERE,La Buisse,854,153,701,12,689,1,RES,10,7.825,31.7
2017,ISERE,Voreppe,855,140,715,12,703,1,EELV,35,7.825,31.7
2017,ISERE,Voreppe,855,140,715,12,703,1,FN,155,7.825,31.7
2017,ISERE,Voreppe,855,140,715,12,703,1,LFI,111,7.825,31.7
2017,ISERE,Voreppe,855,140,715,12,703,1,LO,4,7.825,31.7
2017,ISERE,Voreppe,855,140,715,12,703,1,LR,37,7.825,31.7
2017,ISERE,Voreppe,855,140,715,12,703,1,LREM,245,7.825,31.7
2017,ISERE,Voreppe,855,140,715,12,703,1,NPA,6,7.825,31.7
2017,ISERE,Voreppe,855,140,715,12,703,1,PCF,11,7.825,31.7
2017,ISERE,Voreppe,855,140,715,12,703,1,REC,61,7.825,31.7
2017,ISERE,Voreppe,855,140,715,12,703,1,RES,12,7.825,31.7
2017,ISERE,Moirans,855,213,642,13,629,1,EELV,39,7.825,31.7
2017,ISERE,Moirans,855,213,642,13,629,1,FN,135,7.825,31.7
2017,ISERE,Moirans,855,213,642,13,629,1,LFI,172,7.825,31.7
2017,ISERE,Moirans,855,213,642,13,629,1,LO,2,7.825,31.7
2017,ISERE,Moirans,855,213,642,13,629,1,LR,27,7.825,31.7
2017,ISERE,Moirans,855,213,642,13,629,1,LREM,152,7.825,31.7
2017,ISERE,Moirans,855,213,642,13,629,1,NPA,5,7.825,31.7
2017,ISERE,Moirans,855,213,642,13,629,1,PCF,17,7.825,31.7
2017,ISERE,Moirans,855,213,642,13,629,1,REC,40,7.825,31.7
2017,ISERE,Moirans,855,213,642,13,629,1,RES,17,7.825,31.7
2017,ISERE,Beaurepaire,855,233,622,12,610,1,EELV,28,7.825,31.7
2017,ISERE,Beaurepaire,855,233,622,12,610,1,FN,204,7.825,31.7
2017,ISERE,Beaurepaire,855,233,622,12,610,1,LFI,93,7.825,31.7
2017,ISERE,Beaurepaire,855,233,622,12,610,1,LO,1,7.825,31.7
2017,ISERE,Beaurepaire,855,233,622,12,610,1,LR,19,7.825,31.7
2017,ISERE,Beaurepaire,855,233,622,12,610,1,LREM,143,7.825,31.7
2017,ISERE,Beaurepaire,855,233,622,12,610,1,NPA,8,7.825,31.7
2017,ISERE,Beaurepaire,855,233,622,12,610,1,PCF,11,7.825,31.7
2017,ISERE,Beaurepaire,855,233,622,12,610,1,REC,58,7.825,31.7
2017,ISERE,Beaurepaire,855,233,622,12,610,1,RES,17,7.825,31.7
2017,ISERE,Echirolles,855,238,617,12,605,1,EELV,35,7.825,31.7
2017,ISERE,Echirolles,855,238,617,12,605,1,FN,128,7.825,31.7
2017,ISERE,Echirolles,855,238,617,12,605,1,LFI,165,7.825,31.7
2017,ISERE,Echirolles,855,238,617,12,605,1,LO,6,7.825,31.7
2017,ISERE,Echirolles,855,238,617,12,605,1,LR,14,7.825,31.7
2017,ISERE,Echirolles,855,238,617,12,605,1,LREM,167,7.825,31.7
2017,ISERE,Echirolles,855,238,617,12,605,1,NPA,5,7.825,31.7
2017,ISERE,Echirolles,855,238,617,12,605,1,PCF,25,7.825,31.7
2017,ISERE,Echirolles,855,238,617,12,605,1,REC,26,7.825,31.7
2017,ISERE,Echirolles,855,238,617,12,605,1,RES,12,7.825,31.7
2017,ISERE,Jardin,856,152,704,10,694,1,EELV,43,7.825,31.7
2017,ISERE,Jardin,856,152,704,10,694,1,FN,147,7.825,31.7
2017,ISERE,Jardin,856,152,704,10,694,1,LFI,118,7.825,31.7
2017,ISERE,Jardin,856,152,704,10,694,1,LO,3,7.825,31.7
2017,ISERE,Jardin,856,152,704,10,694,1,LR,45,7.825,31.7
2017,ISERE,Jardin,856,152,704,10,694,1,LREM,223,7.825,31.7
2017,ISERE,Jardin,856,152,704,10,694,1,NPA,7,7.825,31.7
2017,ISERE,Jardin,856,152,704,10,694,1,PCF,15,7.825,31.7
2017,ISERE,Jardin,856,152,704,10,694,1,REC,55,7.825,31.7
2017,ISERE,Jardin,856,152,704,10,694,1,RES,10,7.825,31.7
2017,ISERE,Montbonnot-Saint-Martin,857,116,741,12,729,1,EELV,62,7.825,31.7
2017,ISERE,Montbonnot-Saint-Martin,857,116,741,12,729,1,FN,84,7.825,31.7
2017,ISERE,Montbonnot-Saint-Martin,857,116,741,12,729,1,LFI,97,7.825,31.7
2017,ISERE,Montbonnot-Saint-Martin,857,116,741,12,729,1,LO,5,7.825,31.7
2017,ISERE,Montbonnot-Saint-Martin,857,116,741,12,729,1,LR,58,7.825,31.7
2017,ISERE,Montbonnot-Saint-Martin,857,116,741,12,729,1,LREM,335,7.825,31.7
2017,ISERE,Montbonnot-Saint-Martin,857,116,741,12,729,1,NPA,1,7.825,31.7
2017,ISERE,Montbonnot-Saint-Martin,857,116,741,12,729,1,PCF,4,7.825,31.7
2017,ISERE,Montbonnot-Saint-Martin,857,116,741,12,729,1,REC,45,7.825,31.7
2017,ISERE,Montbonnot-Saint-Martin,857,116,741,12,729,1,RES,11,7.825,31.7
2017,ISERE,Saint-Didier-de-la-Tour,857,152,705,11,694,1,EELV,22,7.825,31.7
2017,ISERE,Saint-Didier-de-la-Tour,857,152,705,11,694,1,FN,261,7.825,31.7
2017,ISERE,Saint-Didier-de-la-Tour,857,152,705,11,694,1,LFI,94,7.825,31.7
2017,ISERE,Saint-Didier-de-la-Tour,857,152,705,11,694,1,LO,1,7.825,31.7
2017,ISERE,Saint-Didier-de-la-Tour,857,152,705,11,694,1,LR,38,7.825,31.7
2017,ISERE,Saint-Didier-de-la-Tour,857,152,705,11,694,1,LREM,162,7.825,31.7
2017,ISERE,Saint-Didier-de-la-Tour,857,152,705,11,694,1,NPA,1,7.825,31.7
2017,ISERE,Saint-Didier-de-la-Tour,857,152,705,11,694,1,PCF,12,7.825,31.7
2017,ISERE,Saint-Didier-de-la-Tour,857,152,705,11,694,1,REC,55,7.825,31.7
2017,ISERE,Saint-Didier-de-la-Tour,857,152,705,11,694,1,RES,18,7.825,31.7
2017,ISERE,Fontaine,857,188,669,6,663,1,EELV,58,7.825,31.7
2017,ISERE,Fontaine,857,188,669,6,663,1,FN,99,7.825,31.7
2017,ISERE,Fontaine,857,188,669,6,663,1,LFI,244,7.825,31.7
2017,ISERE,Fontaine,857,188,669,6,663,1,LO,6,7.825,31.7
2017,ISERE,Fontaine,857,188,669,6,663,1,LR,25,7.825,31.7
2017,ISERE,Fontaine,857,188,669,6,663,1,LREM,138,7.825,31.7
2017,ISERE,Fontaine,857,188,669,6,663,1,NPA,9,7.825,31.7
2017,ISERE,Fontaine,857,188,669,6,663,1,PCF,21,7.825,31.7
2017,ISERE,Fontaine,857,188,669,6,663,1,REC,38,7.825,31.7
2017,ISERE,Fontaine,857,188,669,6,663,1,RES,13,7.825,31.7
2017,ISERE,Aoste,857,207,650,19,631,1,EELV,27,7.825,31.7
2017,ISERE,Aoste,857,207,650,19,631,1,FN,211,7.825,31.7
2017,ISERE,Aoste,857,207,650,19,631,1,LFI,134,7.825,31.7
2017,ISERE,Aoste,857,207,650,19,631,1,LO,3,7.825,31.7
2017,ISERE,Aoste,857,207,650,19,631,1,LR,15,7.825,31.7
2017,ISERE,Aoste,857,207,650,19,631,1,LREM,134,7.825,31.7
2017,ISERE,Aoste,857,207,650,19,631,1,NPA,5,7.825,31.7
2017,ISERE,Aoste,857,207,650,19,631,1,PCF,14,7.825,31.7
2017,ISERE,Aoste,857,207,650,19,631,1,REC,43,7.825,31.7
2017,ISERE,Aoste,857,207,650,19,631,1,RES,16,7.825,31.7
2017,ISERE,Saint-Martin-le-Vinoux,857,218,639,3,636,1,EELV,50,7.825,31.7
2017,ISERE,Saint-Martin-le-Vinoux,857,218,639,3,636,1,FN,79,7.825,31.7
2017,ISERE,Saint-Martin-le-Vinoux,857,218,639,3,636,1,LFI,242,7.825,31.7
2017,ISERE,Saint-Martin-le-Vinoux,857,218,639,3,636,1,LO,3,7.825,31.7
2017,ISERE,Saint-Martin-le-Vinoux,857,218,639,3,636,1,LR,19,7.825,31.7
2017,ISERE,Saint-Martin-le-Vinoux,857,218,639,3,636,1,LREM,163,7.825,31.7
2017,ISERE,Saint-Martin-le-Vinoux,857,218,639,3,636,1,NPA,5,7.825,31.7
2017,ISERE,Saint-Martin-le-Vinoux,857,218,639,3,636,1,PCF,16,7.825,31.7
2017,ISERE,Saint-Martin-le-Vinoux,857,218,639,3,636,1,REC,36,7.825,31.7
2017,ISERE,Saint-Martin-le-Vinoux,857,218,639,3,636,1,RES,8,7.825,31.7
2017,ISERE,Gillonnay,858,143,715,10,705,1,EELV,35,7.825,31.7
2017,ISERE,Gillonnay,858,143,715,10,705,1,FN,223,7.825,31.7
2017,ISERE,Gillonnay,858,143,715,10,705,1,LFI,104,7.825,31.7
2017,ISERE,Gillonnay,858,143,715,10,705,1,LO,11,7.825,31.7
2017,ISERE,Gillonnay,858,143,715,10,705,1,LR,37,7.825,31.7
2017,ISERE,Gillonnay,858,143,715,10,705,1,LREM,147,7.825,31.7
2017,ISERE,Gillonnay,858,143,715,10,705,1,NPA,6,7.825,31.7
2017,ISERE,Gillonnay,858,143,715,10,705,1,PCF,14,7.825,31.7
2017,ISERE,Gillonnay,858,143,715,10,705,1,REC,59,7.825,31.7
2017,ISERE,Gillonnay,858,143,715,10,705,1,RES,30,7.825,31.7
2017,ISERE,La Verpillière,858,288,570,9,561,1,EELV,23,7.825,31.7
2017,ISERE,La Verpillière,858,288,570,9,561,1,FN,163,7.825,31.7
2017,ISERE,La Verpillière,858,288,570,9,561,1,LFI,144,7.825,31.7
2017,ISERE,La Verpillière,858,288,570,9,561,1,LO,7,7.825,31.7
2017,ISERE,La Verpillière,858,288,570,9,561,1,LR,13,7.825,31.7
2017,ISERE,La Verpillière,858,288,570,9,561,1,LREM,121,7.825,31.7
2017,ISERE,La Verpillière,858,288,570,9,561,1,NPA,4,7.825,31.7
2017,ISERE,La Verpillière,858,288,570,9,561,1,PCF,12,7.825,31.7
2017,ISERE,La Verpillière,858,288,570,9,561,1,REC,45,7.825,31.7
2017,ISERE,La Verpillière,858,288,570,9,561,1,RES,12,7.825,31.7
2017,ISERE,Saint-Egrève,860,217,643,9,634,1,EELV,44,7.825,31.7
2017,ISERE,Saint-Egrève,860,217,643,9,634,1,FN,100,7.825,31.7
2017,ISERE,Saint-Egrève,860,217,643,9,634,1,LFI,244,7.825,31.7
2017,ISERE,Saint-Egrève,860,217,643,9,634,1,LO,1,7.825,31.7
2017,ISERE,Saint-Egrève,860,217,643,9,634,1,LR,20,7.825,31.7
2017,ISERE,Saint-Egrève,860,217,643,9,634,1,LREM,136,7.825,31.7
2017,ISERE,Saint-Egrève,860,217,643,9,634,1,NPA,6,7.825,31.7
2017,ISERE,Saint-Egrève,860,217,643,9,634,1,PCF,6,7.825,31.7
2017,ISERE,Saint-Egrève,860,217,643,9,634,1,REC,30,7.825,31.7
2017,ISERE,Saint-Egrève,860,217,643,9,634,1,RES,15,7.825,31.7
2017,ISERE,Froges,860,230,630,15,615,1,EELV,34,7.825,31.7
2017,ISERE,Froges,860,230,630,15,615,1,FN,190,7.825,31.7
2017,ISERE,Froges,860,230,630,15,615,1,LFI,130,7.825,31.7
2017,ISERE,Froges,860,230,630,15,615,1,LO,1,7.825,31.7
2017,ISERE,Froges,860,230,630,15,615,1,LR,16,7.825,31.7
2017,ISERE,Froges,860,230,630,15,615,1,LREM,155,7.825,31.7
2017,ISERE,Froges,860,230,630,15,615,1,NPA,4,7.825,31.7
2017,ISERE,Froges,860,230,630,15,615,1,PCF,21,7.825,31.7
2017,ISERE,Froges,860,230,630,15,615,1,REC,24,7.825,31.7
2017,ISERE,Froges,860,230,630,15,615,1,RES,18,7.825,31.7
2017,ISERE,Sassenage,862,153,709,13,696,1,EELV,62,7.825,31.7
2017,ISERE,Sassenage,862,153,709,13,696,1,FN,152,7.825,31.7
2017,ISERE,Sassenage,862,153,709,13,696,1,LFI,154,7.825,31.7
2017,ISERE,Sassenage,862,153,709,13,696,1,LO,0,7.825,31.7
2017,ISERE,Sassenage,862,153,709,13,696,1,LR,18,7.825,31.7
2017,ISERE,Sassenage,862,153,709,13,696,1,LREM,212,7.825,31.7
2017,ISERE,Sassenage,862,153,709,13,696,1,NPA,8,7.825,31.7
2017,ISERE,Sassenage,862,153,709,13,696,1,PCF,13,7.825,31.7
2017,ISERE,Sassenage,862,153,709,13,696,1,REC,38,7.825,31.7
2017,ISERE,Sassenage,862,153,709,13,696,1,RES,11,7.825,31.7
2017,ISERE,Huez,863,148,715,16,699,1,EELV,20,7.825,31.7
2017,ISERE,Huez,863,148,715,16,699,1,FN,142,7.825,31.7
2017,ISERE,Huez,863,148,715,16,699,1,LFI,75,7.825,31.7
2017,ISERE,Huez,863,148,715,16,699,1,LO,3,7.825,31.7
2017,ISERE,Huez,863,148,715,16,699,1,LR,65,7.825,31.7
2017,ISERE,Huez,863,148,715,16,699,1,LREM,245,7.825,31.7
2017,ISERE,Huez,863,148,715,16,699,1,NPA,6,7.825,31.7
2017,ISERE,Huez,863,148,715,16,699,1,PCF,7,7.825,31.7
2017,ISERE,Huez,863,148,715,16,699,1,REC,98,7.825,31.7
2017,ISERE,Huez,863,148,715,16,699,1,RES,20,7.825,31.7
2017,ISERE,Saint-Chef,863,164,699,11,688,1,EELV,26,7.825,31.7
2017,ISERE,Saint-Chef,863,164,699,11,688,1,FN,206,7.825,31.7
2017,ISERE,Saint-Chef,863,164,699,11,688,1,LFI,103,7.825,31.7
2017,ISERE,Saint-Chef,863,164,699,11,688,1,LO,4,7.825,31.7
2017,ISERE,Saint-Chef,863,164,699,11,688,1,LR,31,7.825,31.7
2017,ISERE,Saint-Chef,863,164,699,11,688,1,LREM,197,7.825,31.7
2017,ISERE,Saint-Chef,863,164,699,11,688,1,NPA,4,7.825,31.7
2017,ISERE,Saint-Chef,863,164,699,11,688,1,PCF,8,7.825,31.7
2017,ISERE,Saint-Chef,863,164,699,11,688,1,REC,69,7.825,31.7
2017,ISERE,Saint-Chef,863,164,699,11,688,1,RES,13,7.825,31.7
2017,ISERE,Saint-Martin-d'Hères,863,324,539,6,533,1,EELV,24,7.825,31.7
2017,ISERE,Saint-Martin-d'Hères,863,324,539,6,533,1,FN,74,7.825,31.7
2017,ISERE,Saint-Martin-d'Hères,863,324,539,6,533,1,LFI,289,7.825,31.7
2017,ISERE,Saint-Martin-d'Hères,863,324,539,6,533,1,LO,3,7.825,31.7
2017,ISERE,Saint-Martin-d'Hères,863,324,539,6,533,1,LR,7,7.825,31.7
2017,ISERE,Saint-Martin-d'Hères,863,324,539,6,533,1,LREM,75,7.825,31.7
2017,ISERE,Saint-Martin-d'Hères,863,324,539,6,533,1,NPA,4,7.825,31.7
2017,ISERE,Saint-Martin-d'Hères,863,324,539,6,533,1,PCF,18,7.825,31.7
2017,ISERE,Saint-Martin-d'Hères,863,324,539,6,533,1,REC,17,7.825,31.7
2017,ISERE,Saint-Martin-d'Hères,863,324,539,6,533,1,RES,8,7.825,31.7
2017,ISERE,Voreppe,864,150,714,12,702,1,EELV,38,7.825,31.7
2017,ISERE,Voreppe,864,150,714,12,702,1,FN,164,7.825,31.7
2017,ISERE,Voreppe,864,150,714,12,702,1,LFI,160,7.825,31.7
2017,ISERE,Voreppe,864,150,714,12,702,1,LO,2,7.825,31.7
2017,ISERE,Voreppe,864,150,714,12,702,1,LR,42,7.825,31.7
2017,ISERE,Voreppe,864,150,714,12,702,1,LREM,180,7.825,31.7
2017,ISERE,Voreppe,864,150,714,12,702,1,NPA,5,7.825,31.7
2017,ISERE,Voreppe,864,150,714,12,702,1,PCF,13,7.825,31.7
2017,ISERE,Voreppe,864,150,714,12,702,1,REC,47,7.825,31.7
2017,ISERE,Voreppe,864,150,714,12,702,1,RES,17,7.825,31.7
2017,ISERE,Roche,864,155,709,22,687,1,EELV,43,7.825,31.7
2017,ISERE,Roche,864,155,709,22,687,1,FN,210,7.825,31.7
2017,ISERE,Roche,864,155,709,22,687,1,LFI,81,7.825,31.7
2017,ISERE,Roche,864,155,709,22,687,1,LO,2,7.825,31.7
2017,ISERE,Roche,864,155,709,22,687,1,LR,35,7.825,31.7
2017,ISERE,Roche,864,155,709,22,687,1,LREM,160,7.825,31.7
2017,ISERE,Roche,864,155,709,22,687,1,NPA,3,7.825,31.7
2017,ISERE,Roche,864,155,709,22,687,1,PCF,12,7.825,31.7
2017,ISERE,Roche,864,155,709,22,687,1,REC,72,7.825,31.7
2017,ISERE,Roche,864,155,709,22,687,1,RES,42,7.825,31.7
2017,ISERE,Jarcieu,865,200,665,20,645,1,EELV,28,7.825,31.7
2017,ISERE,Jarcieu,865,200,665,20,645,1,FN,181,7.825,31.7
2017,ISERE,Jarcieu,865,200,665,20,645,1,LFI,109,7.825,31.7
2017,ISERE,Jarcieu,865,200,665,20,645,1,LO,6,7.825,31.7
2017,ISERE,Jarcieu,865,200,665,20,645,1,LR,31,7.825,31.7
2017,ISERE,Jarcieu,865,200,665,20,645,1,LREM,162,7.825,31.7
2017,ISERE,Jarcieu,865,200,665,20,645,1,NPA,4,7.825,31.7
2017,ISERE,Jarcieu,865,200,665,20,645,1,PCF,20,7.825,31.7
2017,ISERE,Jarcieu,865,200,665,20,645,1,REC,47,7.825,31.7
2017,ISERE,Jarcieu,865,200,665,20,645,1,RES,21,7.825,31.7
2017,ISERE,Grenoble,865,201,664,6,658,1,EELV,36,7.825,31.7
2017,ISERE,Grenoble,865,201,664,6,658,1,FN,153,7.825,31.7
2017,ISERE,Grenoble,865,201,664,6,658,1,LFI,163,7.825,31.7
2017,ISERE,Grenoble,865,201,664,6,658,1,LO,0,7.825,31.7
2017,ISERE,Grenoble,865,201,664,6,658,1,LR,33,7.825,31.7
2017,ISERE,Grenoble,865,201,664,6,658,1,LREM,164,7.825,31.7
2017,ISERE,Grenoble,865,201,664,6,658,1,NPA,4,7.825,31.7
2017,ISERE,Grenoble,865,201,664,6,658,1,PCF,9,7.825,31.7
2017,ISERE,Grenoble,865,201,664,6,658,1,REC,68,7.825,31.7
2017,ISERE,Grenoble,865,201,664,6,658,1,RES,8,7.825,31.7
2017,ISERE,Vienne,865,292,573,31,542,1,EELV,11,7.825,31.7
2017,ISERE,Vienne,865,292,573,31,542,1,FN,120,7.825,31.7
2017,ISERE,Vienne,865,292,573,31,542,1,LFI,226,7.825,31.7
2017,ISERE,Vienne,865,292,573,31,542,1,LO,2,7.825,31.7
2017,ISERE,Vienne,865,292,573,31,542,1,LR,7,7.825,31.7
2017,ISERE,Vienne,865,292,573,31,542,1,LREM,118,7.825,31.7
2017,ISERE,Vienne,865,292,573,31,542,1,NPA,3,7.825,31.7
2017,ISERE,Vienne,865,292,573,31,542,1,PCF,7,7.825,31.7
2017,ISERE,Vienne,865,292,573,31,542,1,REC,23,7.825,31.7
2017,ISERE,Vienne,865,292,573,31,542,1,RES,2,7.825,31.7
2017,ISERE,Saint-Egrève,866,143,723,8,715,1,EELV,78,7.825,31.7
2017,ISERE,Saint-Egrève,866,143,723,8,715,1,FN,76,7.825,31.7
2017,ISERE,Saint-Egrève,866,143,723,8,715,1,LFI,151,7.825,31.7
2017,ISERE,Saint-Egrève,866,143,723,8,715,1,LO,4,7.825,31.7
2017,ISERE,Saint-Egrève,866,143,723,8,715,1,LR,41,7.825,31.7
2017,ISERE,Saint-Egrève,866,143,723,8,715,1,LREM,258,7.825,31.7
2017,ISERE,Saint-Egrève,866,143,723,8,715,1,NPA,5,7.825,31.7
2017,ISERE,Saint-Egrève,866,143,723,8,715,1,PCF,27,7.825,31.7
2017,ISERE,Saint-Egrève,866,143,723,8,715,1,REC,46,7.825,31.7
2017,ISERE,Saint-Egrève,866,143,723,8,715,1,RES,9,7.825,31.7
2017,ISERE,Cheyssieu,867,228,639,17,622,1,EELV,32,7.825,31.7
2017,ISERE,Cheyssieu,867,228,639,17,622,1,FN,183,7.825,31.7
2017,ISERE,Cheyssieu,867,228,639,17,622,1,LFI,93,7.825,31.7
2017,ISERE,Cheyssieu,867,228,639,17,622,1,LO,3,7.825,31.7
2017,ISERE,Cheyssieu,867,228,639,17,622,1,LR,17,7.825,31.7
2017,ISERE,Cheyssieu,867,228,639,17,622,1,LREM,183,7.825,31.7
2017,ISERE,Cheyssieu,867,228,639,17,622,1,NPA,6,7.825,31.7
2017,ISERE,Cheyssieu,867,228,639,17,622,1,PCF,25,7.825,31.7
2017,ISERE,Cheyssieu,867,228,639,17,622,1,REC,42,7.825,31.7
2017,ISERE,Cheyssieu,867,228,639,17,622,1,RES,14,7.825,31.7
2017,ISERE,Grenoble,868,158,710,10,700,1,EELV,93,7.825,31.7
2017,ISERE,Grenoble,868,158,710,10,700,1,FN,64,7.825,31.7
2017,ISERE,Grenoble,868,158,710,10,700,1,LFI,175,7.825,31.7
2017,ISERE,Grenoble,868,158,710,10,700,1,LO,2,7.825,31.7
2017,ISERE,Grenoble,868,158,710,10,700,1,LR,31,7.825,31.7
2017,ISERE,Grenoble,868,158,710,10,700,1,LREM,248,7.825,31.7
2017,ISERE,Grenoble,868,158,710,10,700,1,NPA,5,7.825,31.7
2017,ISERE,Grenoble,868,158,710,10,700,1,PCF,11,7.825,31.7
2017,ISERE,Grenoble,868,158,710,10,700,1,REC,40,7.825,31.7
2017,ISERE,Grenoble,868,158,710,10,700,1,RES,5,7.825,31.7
2017,ISERE,Les Avenières Veyrins-Thuellin,868,237,631,17,614,1,EELV,15,7.825,31.7
2017,ISERE,Les Avenières Veyrins-Thuellin,868,237,631,17,614,1,FN,249,7.825,31.7
2017,ISERE,Les Avenières Veyrins-Thuellin,868,237,631,17,614,1,LFI,93,7.825,31.7
2017,ISERE,Les Avenières Veyrins-Thuellin,868,237,631,17,614,1,LO,6,7.825,31.7
2017,ISERE,Les Avenières Veyrins-Thuellin,868,237,631,17,614,1,LR,29,7.825,31.7
2017,ISERE,Les Avenières Veyrins-Thuellin,868,237,631,17,614,1,LREM,110,7.825,31.7
2017,ISERE,Les Avenières Veyrins-Thuellin,868,237,631,17,614,1,NPA,2,7.825,31.7
2017,ISERE,Les Avenières Veyrins-Thuellin,868,237,631,17,614,1,PCF,7,7.825,31.7
2017,ISERE,Les Avenières Veyrins-Thuellin,868,237,631,17,614,1,REC,70,7.825,31.7
2017,ISERE,Les Avenières Veyrins-Thuellin,868,237,631,17,614,1,RES,15,7.825,31.7
2017,ISERE,Saint-Egrève,870,159,711,11,700,1,EELV,71,7.825,31.7
2017,ISERE,Saint-Egrève,870,159,711,11,700,1,FN,98,7.825,31.7
2017,ISERE,Saint-Egrève,870,159,711,11,700,1,LFI,143,7.825,31.7
2017,ISERE,Saint-Egrève,870,159,711,11,700,1,LO,1,7.825,31.7
2017,ISERE,Saint-Egrève,870,159,711,11,700,1,LR,37,7.825,31.7
2017,ISERE,Saint-Egrève,870,159,711,11,700,1,LREM,237,7.825,31.7
2017,ISERE,Saint-Egrève,870,159,711,11,700,1,NPA,0,7.825,31.7
2017,ISERE,Saint-Egrève,870,159,711,11,700,1,PCF,20,7.825,31.7
2017,ISERE,Saint-Egrève,870,159,711,11,700,1,REC,48,7.825,31.7
2017,ISERE,Saint-Egrève,870,159,711,11,700,1,RES,10,7.825,31.7
2017,ISERE,Susville,870,203,667,21,646,1,EELV,19,7.825,31.7
2017,ISERE,Susville,870,203,667,21,646,1,FN,227,7.825,31.7
2017,ISERE,Susville,870,203,667,21,646,1,LFI,140,7.825,31.7
2017,ISERE,Susville,870,203,667,21,646,1,LO,3,7.825,31.7
2017,ISERE,Susville,870,203,667,21,646,1,LR,19,7.825,31.7
2017,ISERE,Susville,870,203,667,21,646,1,LREM,94,7.825,31.7
2017,ISERE,Susville,870,203,667,21,646,1,NPA,8,7.825,31.7
2017,ISERE,Susville,870,203,667,21,646,1,PCF,22,7.825,31.7
2017,ISERE,Susville,870,203,667,21,646,1,REC,55,7.825,31.7
2017,ISERE,Susville,870,203,667,21,646,1,RES,22,7.825,31.7
2017,ISERE,Charvieu-Chavagneux,870,251,619,6,613,1,EELV,17,7.825,31.7
2017,ISERE,Charvieu-Chavagneux,870,251,619,6,613,1,FN,193,7.825,31.7
2017,ISERE,Charvieu-Chavagneux,870,251,619,6,613,1,LFI,162,7.825,31.7
2017,ISERE,Charvieu-Chavagneux,870,251,619,6,613,1,LO,2,7.825,31.7
2017,ISERE,Charvieu-Chavagneux,870,251,619,6,613,1,LR,16,7.825,31.7
2017,ISERE,Charvieu-Chavagneux,870,251,619,6,613,1,LREM,121,7.825,31.7
2017,ISERE,Charvieu-Chavagneux,870,251,619,6,613,1,NPA,3,7.825,31.7
2017,ISERE,Charvieu-Chavagneux,870,251,619,6,613,1,PCF,12,7.825,31.7
2017,ISERE,Charvieu-Chavagneux,870,251,619,6,613,1,REC,53,7.825,31.7
2017,ISERE,Charvieu-Chavagneux,870,251,619,6,613,1,RES,12,7.825,31.7
2017,ISERE,Claix,871,234,637,15,622,1,EELV,28,7.825,31.7
2017,ISERE,Claix,871,234,637,15,622,1,FN,169,7.825,31.7
2017,ISERE,Claix,871,234,637,15,622,1,LFI,138,7.825,31.7
2017,ISERE,Claix,871,234,637,15,622,1,LO,3,7.825,31.7
2017,ISERE,Claix,871,234,637,15,622,1,LR,23,7.825,31.7
2017,ISERE,Claix,871,234,637,15,622,1,LREM,181,7.825,31.7
2017,ISERE,Claix,871,234,637,15,622,1,NPA,8,7.825,31.7
2017,ISERE,Claix,871,234,637,15,622,1,PCF,10,7.825,31.7
2017,ISERE,Claix,871,234,637,15,622,1,REC,35,7.825,31.7
2017,ISERE,Claix,871,234,637,15,622,1,RES,14,7.825,31.7
2017,ISERE,Grenoble,871,237,634,9,625,1,EELV,49,7.825,31.7
2017,ISERE,Grenoble,871,237,634,9,625,1,FN,85,7.825,31.7
2017,ISERE,Grenoble,871,237,634,9,625,1,LFI,209,7.825,31.7
2017,ISERE,Grenoble,871,237,634,9,625,1,LO,1,7.825,31.7
2017,ISERE,Grenoble,871,237,634,9,625,1,LR,16,7.825,31.7
2017,ISERE,Grenoble,871,237,634,9,625,1,LREM,181,7.825,31.7
2017,ISERE,Grenoble,871,237,634,9,625,1,NPA,7,7.825,31.7
2017,ISERE,Grenoble,871,237,634,9,625,1,PCF,7,7.825,31.7
2017,ISERE,Grenoble,871,237,634,9,625,1,REC,37,7.825,31.7
2017,ISERE,Grenoble,871,237,634,9,625,1,RES,15,7.825,31.7
2017,ISERE,Grenoble,872,217,655,12,643,1,EELV,41,7.825,31.7
2017,ISERE,Grenoble,872,217,655,12,643,1,FN,81,7.825,31.7
2017,ISERE,Grenoble,872,217,655,12,643,1,LFI,230,7.825,31.7
2017,ISERE,Grenoble,872,217,655,12,643,1,LO,2,7.825,31.7
2017,ISERE,Grenoble,872,217,655,12,643,1,LR,17,7.825,31.7
2017,ISERE,Grenoble,872,217,655,12,643,1,LREM,192,7.825,31.7
2017,ISERE,Grenoble,872,217,655,12,643,1,NPA,10,7.825,31.7
2017,ISERE,Grenoble,872,217,655,12,643,1,PCF,9,7.825,31.7
2017,ISERE,Grenoble,872,217,655,12,643,1,REC,33,7.825,31.7
2017,ISERE,Grenoble,872,217,655,12,643,1,RES,5,7.825,31.7
2017,ISERE,Theys,873,148,725,10,715,1,EELV,60,7.825,31.7
2017,ISERE,Theys,873,148,725,10,715,1,FN,127,7.825,31.7
2017,ISERE,Theys,873,148,725,10,715,1,LFI,160,7.825,31.7
2017,ISERE,Theys,873,148,725,10,715,1,LO,0,7.825,31.7
2017,ISERE,Theys,873,148,725,10,715,1,LR,56,7.825,31.7
2017,ISERE,Theys,873,148,725,10,715,1,LREM,214,7.825,31.7
2017,ISERE,Theys,873,148,725,10,715,1,NPA,7,7.825,31.7
2017,ISERE,Theys,873,148,725,10,715,1,PCF,12,7.825,31.7
2017,ISERE,Theys,873,148,725,10,715,1,REC,37,7.825,31.7
2017,ISERE,Theys,873,148,725,10,715,1,RES,21,7.825,31.7
2017,ISERE,Revel-Tourdan,873,162,711,21,690,1,EELV,33,7.825,31.7
2017,ISERE,Revel-Tourdan,873,162,711,21,690,1,FN,233,7.825,31.7
2017,ISERE,Revel-Tourdan,873,162,711,21,690,1,LFI,123,7.825,31.7
2017,ISERE,Revel-Tourdan,873,162,711,21,690,1,LO,5,7.825,31.7
2017,ISERE,Revel-Tourdan,873,162,711,21,690,1,LR,26,7.825,31.7
2017,ISERE,Revel-Tourdan,873,162,711,21,690,1,LREM,166,7.825,31.7
2017,ISERE,Revel-Tourdan,873,162,711,21,690,1,NPA,6,7.825,31.7
2017,ISERE,Revel-Tourdan,873,162,711,21,690,1,PCF,6,7.825,31.7
2017,ISERE,Revel-Tourdan,873,162,711,21,690,1,REC,24,7.825,31.7
2017,ISERE,Revel-Tourdan,873,162,711,21,690,1,RES,23,7.825,31.7
2017,ISERE,Chirens,873,181,692,15,677,1,EELV,45,7.825,31.7
2017,ISERE,Chirens,873,181,692,15,677,1,FN,174,7.825,31.7
2017,ISERE,Chirens,873,181,692,15,677,1,LFI,130,7.825,31.7
2017,ISERE,Chirens,873,181,692,15,677,1,LO,2,7.825,31.7
2017,ISERE,Chirens,873,181,692,15,677,1,LR,35,7.825,31.7
2017,ISERE,Chirens,873,181,692,15,677,1,LREM,176,7.825,31.7
2017,ISERE,Chirens,873,181,692,15,677,1,NPA,6,7.825,31.7
2017,ISERE,Chirens,873,181,692,15,677,1,PCF,12,7.825,31.7
2017,ISERE,Chirens,873,181,692,15,677,1,REC,45,7.825,31.7
2017,ISERE,Chirens,873,181,692,15,677,1,RES,22,7.825,31.7
2017,ISERE,Grenoble,874,279,595,8,587,1,EELV,56,7.825,31.7
2017,ISERE,Grenoble,874,279,595,8,587,1,FN,95,7.825,31.7
2017,ISERE,Grenoble,874,279,595,8,587,1,LFI,237,7.825,31.7
2017,ISERE,Grenoble,874,279,595,8,587,1,LO,3,7.825,31.7
2017,ISERE,Grenoble,874,279,595,8,587,1,LR,8,7.825,31.7
2017,ISERE,Grenoble,874,279,595,8,587,1,LREM,102,7.825,31.7
2017,ISERE,Grenoble,874,279,595,8,587,1,NPA,7,7.825,31.7
2017,ISERE,Grenoble,874,279,595,8,587,1,PCF,13,7.825,31.7
2017,ISERE,Grenoble,874,279,595,8,587,1,REC,30,7.825,31.7
2017,ISERE,Grenoble,874,279,595,8,587,1,RES,12,7.825,31.7
2017,ISERE,Salaise-sur-Sanne,874,289,585,14,571,1,EELV,10,7.825,31.7
2017,ISERE,Salaise-sur-Sanne,874,289,585,14,571,1,FN,156,7.825,31.7
2017,ISERE,Salaise-sur-Sanne,874,289,585,14,571,1,LFI,167,7.825,31.7
2017,ISERE,Salaise-sur-Sanne,874,289,585,14,571,1,LO,4,7.825,31.7
2017,ISERE,Salaise-sur-Sanne,874,289,585,14,571,1,LR,12,7.825,31.7
2017,ISERE,Salaise-sur-Sanne,874,289,585,14,571,1,LREM,126,7.825,31.7
2017,ISERE,Salaise-sur-Sanne,874,289,585,14,571,1,NPA,6,7.825,31.7
2017,ISERE,Salaise-sur-Sanne,874,289,585,14,571,1,PCF,27,7.825,31.7
2017,ISERE,Salaise-sur-Sanne,874,289,585,14,571,1,REC,27,7.825,31.7
2017,ISERE,Salaise-sur-Sanne,874,289,585,14,571,1,RES,12,7.825,31.7
2017,ISERE,Eyzin-Pinet,875,156,719,17,702,1,EELV,35,7.825,31.7
2017,ISERE,Eyzin-Pinet,875,156,719,17,702,1,FN,174,7.825,31.7
2017,ISERE,Eyzin-Pinet,875,156,719,17,702,1,LFI,105,7.825,31.7
2017,ISERE,Eyzin-Pinet,875,156,719,17,702,1,LO,3,7.825,31.7
2017,ISERE,Eyzin-Pinet,875,156,719,17,702,1,LR,49,7.825,31.7
2017,ISERE,Eyzin-Pinet,875,156,719,17,702,1,LREM,204,7.825,31.7
2017,ISERE,Eyzin-Pinet,875,156,719,17,702,1,NPA,6,7.825,31.7
2017,ISERE,Eyzin-Pinet,875,156,719,17,702,1,PCF,9,7.825,31.7
2017,ISERE,Eyzin-Pinet,875,156,719,17,702,1,REC,71,7.825,31.7
2017,ISERE,Eyzin-Pinet,875,156,719,17,702,1,RES,16,7.825,31.7
2017,ISERE,Voreppe,875,164,711,12,699,1,EELV,55,7.825,31.7
2017,ISERE,Voreppe,875,164,711,12,699,1,FN,118,7.825,31.7
2017,ISERE,Voreppe,875,164,711,12,699,1,LFI,187,7.825,31.7
2017,ISERE,Voreppe,875,164,711,12,699,1,LO,4,7.825,31.7
2017,ISERE,Voreppe,875,164,711,12,699,1,LR,29,7.825,31.7
2017,ISERE,Voreppe,875,164,711,12,699,1,LREM,179,7.825,31.7
2017,ISERE,Voreppe,875,164,711,12,699,1,NPA,1,7.825,31.7
2017,ISERE,Voreppe,875,164,711,12,699,1,PCF,15,7.825,31.7
2017,ISERE,Voreppe,875,164,711,12,699,1,REC,57,7.825,31.7
2017,ISERE,Voreppe,875,164,711,12,699,1,RES,21,7.825,31.7
2017,ISERE,Seyssinet-Pariset,875,196,679,20,659,1,EELV,37,7.825,31.7
2017,ISERE,Seyssinet-Pariset,875,196,679,20,659,1,FN,179,7.825,31.7
2017,ISERE,Seyssinet-Pariset,875,196,679,20,659,1,LFI,147,7.825,31.7
2017,ISERE,Seyssinet-Pariset,875,196,679,20,659,1,LO,4,7.825,31.7
2017,ISERE,Seyssinet-Pariset,875,196,679,20,659,1,LR,26,7.825,31.7
2017,ISERE,Seyssinet-Pariset,875,196,679,20,659,1,LREM,178,7.825,31.7
2017,ISERE,Seyssinet-Pariset,875,196,679,20,659,1,NPA,7,7.825,31.7
2017,ISERE,Seyssinet-Pariset,875,196,679,20,659,1,PCF,10,7.825,31.7
2017,ISERE,Seyssinet-Pariset,875,196,679,20,659,1,REC,43,7.825,31.7
2017,ISERE,Seyssinet-Pariset,875,196,679,20,659,1,RES,7,7.825,31.7
2017,ISERE,Le Pont-de-Claix,875,242,633,11,622,1,EELV,14,7.825,31.7
2017,ISERE,Le Pont-de-Claix,875,242,633,11,622,1,FN,136,7.825,31.7
2017,ISERE,Le Pont-de-Claix,875,242,633,11,622,1,LFI,189,7.825,31.7
2017,ISERE,Le Pont-de-Claix,875,242,633,11,622,1,LO,6,7.825,31.7
2017,ISERE,Le Pont-de-Claix,875,242,633,11,622,1,LR,17,7.825,31.7
2017,ISERE,Le Pont-de-Claix,875,242,633,11,622,1,LREM,145,7.825,31.7
2017,ISERE,Le Pont-de-Claix,875,242,633,11,622,1,NPA,5,7.825,31.7
2017,ISERE,Le Pont-de-Claix,875,242,633,11,622,1,PCF,20,7.825,31.7
2017,ISERE,Le Pont-de-Claix,875,242,633,11,622,1,REC,48,7.825,31.7
2017,ISERE,Le Pont-de-Claix,875,242,633,11,622,1,RES,18,7.825,31.7
2017,ISERE,Grenoble,878,219,659,7,652,1,EELV,73,7.825,31.7
2017,ISERE,Grenoble,878,219,659,7,652,1,FN,56,7.825,31.7
2017,ISERE,Grenoble,878,219,659,7,652,1,LFI,241,7.825,31.7
2017,ISERE,Grenoble,878,219,659,7,652,1,LO,1,7.825,31.7
2017,ISERE,Grenoble,878,219,659,7,652,1,LR,23,7.825,31.7
2017,ISERE,Grenoble,878,219,659,7,652,1,LREM,181,7.825,31.7
2017,ISERE,Grenoble,878,219,659,7,652,1,NPA,3,7.825,31.7
2017,ISERE,Grenoble,878,219,659,7,652,1,PCF,7,7.825,31.7
2017,ISERE,Grenoble,878,219,659,7,652,1,REC,39,7.825,31.7
2017,ISERE,Grenoble,878,219,659,7,652,1,RES,8,7.825,31.7
2017,ISERE,Echirolles,878,329,549,15,534,1,EELV,2,7.825,31.7
2017,ISERE,Echirolles,878,329,549,15,534,1,FN,99,7.825,31.7
2017,ISERE,Echirolles,878,329,549,15,534,1,LFI,295,7.825,31.7
2017,ISERE,Echirolles,878,329,549,15,534,1,LO,2,7.825,31.7
2017,ISERE,Echirolles,878,329,549,15,534,1,LR,3,7.825,31.7
2017,ISERE,Echirolles,878,329,549,15,534,1,LREM,88,7.825,31.7
2017,ISERE,Echirolles,878,329,549,15,534,1,NPA,2,7.825,31.7
2017,ISERE,Echirolles,878,329,549,15,534,1,PCF,8,7.825,31.7
2017,ISERE,Echirolles,878,329,549,15,534,1,REC,17,7.825,31.7
2017,ISERE,Echirolles,878,329,549,15,534,1,RES,8,7.825,31.7
2017,ISERE,Allemond,879,227,652,13,639,1,EELV,34,7.825,31.7
2017,ISERE,Allemond,879,227,652,13,639,1,FN,134,7.825,31.7
2017,ISERE,Allemond,879,227,652,13,639,1,LFI,119,7.825,31.7
2017,ISERE,Allemond,879,227,652,13,639,1,LO,4,7.825,31.7
2017,ISERE,Allemond,879,227,652,13,639,1,LR,41,7.825,31.7
2017,ISERE,Allemond,879,227,652,13,639,1,LREM,190,7.825,31.7
2017,ISERE,Allemond,879,227,652,13,639,1,NPA,7,7.825,31.7
2017,ISERE,Allemond,879,227,652,13,639,1,PCF,27,7.825,31.7
2017,ISERE,Allemond,879,227,652,13,639,1,REC,39,7.825,31.7
2017,ISERE,Allemond,879,227,652,13,639,1,RES,18,7.825,31.7
2017,ISERE,Laval-en-Belledonne,880,146,734,11,723,1,EELV,89,7.825,31.7
2017,ISERE,Laval-en-Belledonne,880,146,734,11,723,1,FN,128,7.825,31.7
2017,ISERE,Laval-en-Belledonne,880,146,734,11,723,1,LFI,190,7.825,31.7
2017,ISERE,Laval-en-Belledonne,880,146,734,11,723,1,LO,1,7.825,31.7
2017,ISERE,Laval-en-Belledonne,880,146,734,11,723,1,LR,33,7.825,31.7
2017,ISERE,Laval-en-Belledonne,880,146,734,11,723,1,LREM,157,7.825,31.7
2017,ISERE,Laval-en-Belledonne,880,146,734,11,723,1,NPA,7,7.825,31.7
2017,ISERE,Laval-en-Belledonne,880,146,734,11,723,1,PCF,21,7.825,31.7
2017,ISERE,Laval-en-Belledonne,880,146,734,11,723,1,REC,48,7.825,31.7
2017,ISERE,Laval-en-Belledonne,880,146,734,11,723,1,RES,21,7.825,31.7
2017,ISERE,Saint-Jean-de-Moirans,880,225,655,26,629,1,EELV,28,7.825,31.7
2017,ISERE,Saint-Jean-de-Moirans,880,225,655,26,629,1,FN,174,7.825,31.7
2017,ISERE,Saint-Jean-de-Moirans,880,225,655,26,629,1,LFI,157,7.825,31.7
2017,ISERE,Saint-Jean-de-Moirans,880,225,655,26,629,1,LO,1,7.825,31.7
2017,ISERE,Saint-Jean-de-Moirans,880,225,655,26,629,1,LR,27,7.825,31.7
2017,ISERE,Saint-Jean-de-Moirans,880,225,655,26,629,1,LREM,130,7.825,31.7
2017,ISERE,Saint-Jean-de-Moirans,880,225,655,26,629,1,NPA,3,7.825,31.7
2017,ISERE,Saint-Jean-de-Moirans,880,225,655,26,629,1,PCF,21,7.825,31.7
2017,ISERE,Saint-Jean-de-Moirans,880,225,655,26,629,1,REC,39,7.825,31.7
2017,ISERE,Saint-Jean-de-Moirans,880,225,655,26,629,1,RES,12,7.825,31.7
2017,ISERE,Agnin,881,149,732,11,721,1,EELV,17,7.825,31.7
2017,ISERE,Agnin,881,149,732,11,721,1,FN,247,7.825,31.7
2017,ISERE,Agnin,881,149,732,11,721,1,LFI,132,7.825,31.7
2017,ISERE,Agnin,881,149,732,11,721,1,LO,1,7.825,31.7
2017,ISERE,Agnin,881,149,732,11,721,1,LR,27,7.825,31.7
2017,ISERE,Agnin,881,149,732,11,721,1,LREM,175,7.825,31.7
2017,ISERE,Agnin,881,149,732,11,721,1,NPA,2,7.825,31.7
2017,ISERE,Agnin,881,149,732,11,721,1,PCF,17,7.825,31.7
2017,ISERE,Agnin,881,149,732,11,721,1,REC,55,7.825,31.7
2017,ISERE,Agnin,881,149,732,11,721,1,RES,25,7.825,31.7
2017,ISERE,Meylan,881,153,728,9,719,1,EELV,58,7.825,31.7
2017,ISERE,Meylan,881,153,728,9,719,1,FN,78,7.825,31.7
2017,ISERE,Meylan,881,153,728,9,719,1,LFI,132,7.825,31.7
2017,ISERE,Meylan,881,153,728,9,719,1,LO,2,7.825,31.7
2017,ISERE,Meylan,881,153,728,9,719,1,LR,47,7.825,31.7
2017,ISERE,Meylan,881,153,728,9,719,1,LREM,280,7.825,31.7
2017,ISERE,Meylan,881,153,728,9,719,1,NPA,4,7.825,31.7
2017,ISERE,Meylan,881,153,728,9,719,1,PCF,12,7.825,31.7
2017,ISERE,Meylan,881,153,728,9,719,1,REC,68,7.825,31.7
2017,ISERE,Meylan,881,153,728,9,719,1,RES,11,7.825,31.7
2017,ISERE,Saint-Jean-de-Moirans,883,140,743,18,725,1,EELV,41,7.825,31.7
2017,ISERE,Saint-Jean-de-Moirans,883,140,743,18,725,1,FN,137,7.825,31.7
2017,ISERE,Saint-Jean-de-Moirans,883,140,743,18,725,1,LFI,110,7.825,31.7
2017,ISERE,Saint-Jean-de-Moirans,883,140,743,18,725,1,LO,5,7.825,31.7
2017,ISERE,Saint-Jean-de-Moirans,883,140,743,18,725,1,LR,45,7.825,31.7
2017,ISERE,Saint-Jean-de-Moirans,883,140,743,18,725,1,LREM,267,7.825,31.7
2017,ISERE,Saint-Jean-de-Moirans,883,140,743,18,725,1,NPA,3,7.825,31.7
2017,ISERE,Saint-Jean-de-Moirans,883,140,743,18,725,1,PCF,24,7.825,31.7
2017,ISERE,Saint-Jean-de-Moirans,883,140,743,18,725,1,REC,48,7.825,31.7
2017,ISERE,Saint-Jean-de-Moirans,883,140,743,18,725,1,RES,21,7.825,31.7
2017,ISERE,Sassenage,883,168,715,25,690,1,EELV,42,7.825,31.7
2017,ISERE,Sassenage,883,168,715,25,690,1,FN,185,7.825,31.7
2017,ISERE,Sassenage,883,168,715,25,690,1,LFI,135,7.825,31.7
2017,ISERE,Sassenage,883,168,715,25,690,1,LO,1,7.825,31.7
2017,ISERE,Sassenage,883,168,715,25,690,1,LR,21,7.825,31.7
2017,ISERE,Sassenage,883,168,715,25,690,1,LREM,190,7.825,31.7
2017,ISERE,Sassenage,883,168,715,25,690,1,NPA,8,7.825,31.7
2017,ISERE,Sassenage,883,168,715,25,690,1,PCF,18,7.825,31.7
2017,ISERE,Sassenage,883,168,715,25,690,1,REC,48,7.825,31.7
2017,ISERE,Sassenage,883,168,715,25,690,1,RES,19,7.825,31.7
2017,ISERE,Pontcharra,883,254,629,15,614,1,EELV,38,7.825,31.7
2017,ISERE,Pontcharra,883,254,629,15,614,1,FN,167,7.825,31.7
2017,ISERE,Pontcharra,883,254,629,15,614,1,LFI,188,7.825,31.7
2017,ISERE,Pontcharra,883,254,629,15,614,1,LO,3,7.825,31.7
2017,ISERE,Pontcharra,883,254,629,15,614,1,LR,11,7.825,31.7
2017,ISERE,Pontcharra,883,254,629,15,614,1,LREM,119,7.825,31.7
2017,ISERE,Pontcharra,883,254,629,15,614,1,NPA,4,7.825,31.7
2017,ISERE,Pontcharra,883,254,629,15,614,1,PCF,17,7.825,31.7
2017,ISERE,Pontcharra,883,254,629,15,614,1,REC,27,7.825,31.7
2017,ISERE,Pontcharra,883,254,629,15,614,1,RES,12,7.825,31.7
2017,ISERE,Moirans,884,274,610,10,600,1,EELV,33,7.825,31.7
2017,ISERE,Moirans,884,274,610,10,600,1,FN,135,7.825,31.7
2017,ISERE,Moirans,884,274,610,10,600,1,LFI,175,7.825,31.7
2017,ISERE,Moirans,884,274,610,10,600,1,LO,3,7.825,31.7
2017,ISERE,Moirans,884,274,610,10,600,1,LR,15,7.825,31.7
2017,ISERE,Moirans,884,274,610,10,600,1,LREM,142,7.825,31.7
2017,ISERE,Moirans,884,274,610,10,600,1,NPA,7,7.825,31.7
2017,ISERE,Moirans,884,274,610,10,600,1,PCF,13,7.825,31.7
2017,ISERE,Moirans,884,274,610,10,600,1,REC,34,7.825,31.7
2017,ISERE,Moirans,884,274,610,10,600,1,RES,20,7.825,31.7
2017,ISERE,Grenoble,884,340,544,5,539,1,EELV,16,7.825,31.7
2017,ISERE,Grenoble,884,340,544,5,539,1,FN,71,7.825,31.7
2017,ISERE,Grenoble,884,340,544,5,539,1,LFI,287,7.825,31.7
2017,ISERE,Grenoble,884,340,544,5,539,1,LO,6,7.825,31.7
2017,ISERE,Grenoble,884,340,544,5,539,1,LR,8,7.825,31.7
2017,ISERE,Grenoble,884,340,544,5,539,1,LREM,97,7.825,31.7
2017,ISERE,Grenoble,884,340,544,5,539,1,NPA,7,7.825,31.7
2017,ISERE,Grenoble,884,340,544,5,539,1,PCF,7,7.825,31.7
2017,ISERE,Grenoble,884,340,544,5,539,1,REC,23,7.825,31.7
2017,ISERE,Grenoble,884,340,544,5,539,1,RES,7,7.825,31.7
2017,ISERE,Saint-Egrève,885,167,718,11,707,1,EELV,36,7.825,31.7
2017,ISERE,Saint-Egrève,885,167,718,11,707,1,FN,144,7.825,31.7
2017,ISERE,Saint-Egrève,885,167,718,11,707,1,LFI,137,7.825,31.7
2017,ISERE,Saint-Egrève,885,167,718,11,707,1,LO,3,7.825,31.7
2017,ISERE,Saint-Egrève,885,167,718,11,707,1,LR,31,7.825,31.7
2017,ISERE,Saint-Egrève,885,167,718,11,707,1,LREM,249,7.825,31.7
2017,ISERE,Saint-Egrève,885,167,718,11,707,1,NPA,3,7.825,31.7
2017,ISERE,Saint-Egrève,885,167,718,11,707,1,PCF,21,7.825,31.7
2017,ISERE,Saint-Egrève,885,167,718,11,707,1,REC,51,7.825,31.7
2017,ISERE,Saint-Egrève,885,167,718,11,707,1,RES,13,7.825,31.7
2017,ISERE,Chuzelles,886,147,739,25,714,1,EELV,48,7.825,31.7
2017,ISERE,Chuzelles,886,147,739,25,714,1,FN,206,7.825,31.7
2017,ISERE,Chuzelles,886,147,739,25,714,1,LFI,84,7.825,31.7
2017,ISERE,Chuzelles,886,147,739,25,714,1,LO,1,7.825,31.7
2017,ISERE,Chuzelles,886,147,739,25,714,1,LR,30,7.825,31.7
2017,ISERE,Chuzelles,886,147,739,25,714,1,LREM,206,7.825,31.7
2017,ISERE,Chuzelles,886,147,739,25,714,1,NPA,4,7.825,31.7
2017,ISERE,Chuzelles,886,147,739,25,714,1,PCF,15,7.825,31.7
2017,ISERE,Chuzelles,886,147,739,25,714,1,REC,70,7.825,31.7
2017,ISERE,Chuzelles,886,147,739,25,714,1,RES,16,7.825,31.7
2017,ISERE,Les Avenières Veyrins-Thuellin,886,232,654,12,642,1,EELV,20,7.825,31.7
2017,ISERE,Les Avenières Veyrins-Thuellin,886,232,654,12,642,1,FN,200,7.825,31.7
2017,ISERE,Les Avenières Veyrins-Thuellin,886,232,654,12,642,1,LFI,72,7.825,31.7
2017,ISERE,Les Avenières Veyrins-Thuellin,886,232,654,12,642,1,LO,4,7.825,31.7
2017,ISERE,Les Avenières Veyrins-Thuellin,886,232,654,12,642,1,LR,33,7.825,31.7
2017,ISERE,Les Avenières Veyrins-Thuellin,886,232,654,12,642,1,LREM,176,7.825,31.7
2017,ISERE,Les Avenières Veyrins-Thuellin,886,232,654,12,642,1,NPA,5,7.825,31.7
2017,ISERE,Les Avenières Veyrins-Thuellin,886,232,654,12,642,1,PCF,11,7.825,31.7
2017,ISERE,Les Avenières Veyrins-Thuellin,886,232,654,12,642,1,REC,62,7.825,31.7
2017,ISERE,Les Avenières Veyrins-Thuellin,886,232,654,12,642,1,RES,23,7.825,31.7
2017,ISERE,Seyssins,887,148,739,18,721,1,EELV,69,7.825,31.7
2017,ISERE,Seyssins,887,148,739,18,721,1,FN,115,7.825,31.7
2017,ISERE,Seyssins,887,148,739,18,721,1,LFI,135,7.825,31.7
2017,ISERE,Seyssins,887,148,739,18,721,1,LO,1,7.825,31.7
2017,ISERE,Seyssins,887,148,739,18,721,1,LR,29,7.825,31.7
2017,ISERE,Seyssins,887,148,739,18,721,1,LREM,265,7.825,31.7
2017,ISERE,Seyssins,887,148,739,18,721,1,NPA,4,7.825,31.7
2017,ISERE,Seyssins,887,148,739,18,721,1,PCF,16,7.825,31.7
2017,ISERE,Seyssins,887,148,739,18,721,1,REC,43,7.825,31.7
2017,ISERE,Seyssins,887,148,739,18,721,1,RES,13,7.825,31.7
2017,ISERE,Meylan,887,152,735,10,725,1,EELV,50,7.825,31.7
2017,ISERE,Meylan,887,152,735,10,725,1,FN,77,7.825,31.7
2017,ISERE,Meylan,887,152,735,10,725,1,LFI,94,7.825,31.7
2017,ISERE,Meylan,887,152,735,10,725,1,LO,1,7.825,31.7
2017,ISERE,Meylan,887,152,735,10,725,1,LR,55,7.825,31.7
2017,ISERE,Meylan,887,152,735,10,725,1,LREM,312,7.825,31.7
2017,ISERE,Meylan,887,152,735,10,725,1,NPA,1,7.825,31.7
2017,ISERE,Meylan,887,152,735,10,725,1,PCF,4,7.825,31.7
2017,ISERE,Meylan,887,152,735,10,725,1,REC,92,7.825,31.7
2017,ISERE,Meylan,887,152,735,10,725,1,RES,14,7.825,31.7
2017,ISERE,Rives,887,191,696,21,675,1,EELV,41,7.825,31.7
2017,ISERE,Rives,887,191,696,21,675,1,FN,155,7.825,31.7
2017,ISERE,Rives,887,191,696,21,675,1,LFI,131,7.825,31.7
2017,ISERE,Rives,887,191,696,21,675,1,LO,4,7.825,31.7
2017,ISERE,Rives,887,191,696,21,675,1,LR,39,7.825,31.7
2017,ISERE,Rives,887,191,696,21,675,1,LREM,202,7.825,31.7
2017,ISERE,Rives,887,191,696,21,675,1,NPA,3,7.825,31.7
2017,ISERE,Rives,887,191,696,21,675,1,PCF,18,7.825,31.7
2017,ISERE,Rives,887,191,696,21,675,1,REC,32,7.825,31.7
2017,ISERE,Rives,887,191,696,21,675,1,RES,17,7.825,31.7
2017,ISERE,Saint-Martin-le-Vinoux,888,257,631,8,623,1,EELV,32,7.825,31.7
2017,ISERE,Saint-Martin-le-Vinoux,888,257,631,8,623,1,FN,104,7.825,31.7
2017,ISERE,Saint-Martin-le-Vinoux,888,257,631,8,623,1,LFI,244,7.825,31.7
2017,ISERE,Saint-Martin-le-Vinoux,888,257,631,8,623,1,LO,6,7.825,31.7
2017,ISERE,Saint-Martin-le-Vinoux,888,257,631,8,623,1,LR,13,7.825,31.7
2017,ISERE,Saint-Martin-le-Vinoux,888,257,631,8,623,1,LREM,109,7.825,31.7
2017,ISERE,Saint-Martin-le-Vinoux,888,257,631,8,623,1,NPA,11,7.825,31.7
2017,ISERE,Saint-Martin-le-Vinoux,888,257,631,8,623,1,PCF,13,7.825,31.7
2017,ISERE,Saint-Martin-le-Vinoux,888,257,631,8,623,1,REC,45,7.825,31.7
2017,ISERE,Saint-Martin-le-Vinoux,888,257,631,8,623,1,RES,19,7.825,31.7
2017,ISERE,Saint-Martin-d'Hères,889,203,686,16,670,1,EELV,41,7.825,31.7
2017,ISERE,Saint-Martin-d'Hères,889,203,686,16,670,1,FN,102,7.825,31.7
2017,ISERE,Saint-Martin-d'Hères,889,203,686,16,670,1,LFI,225,7.825,31.7
2017,ISERE,Saint-Martin-d'Hères,889,203,686,16,670,1,LO,2,7.825,31.7
2017,ISERE,Saint-Martin-d'Hères,889,203,686,16,670,1,LR,20,7.825,31.7
2017,ISERE,Saint-Martin-d'Hères,889,203,686,16,670,1,LREM,190,7.825,31.7
2017,ISERE,Saint-Martin-d'Hères,889,203,686,16,670,1,NPA,8,7.825,31.7
2017,ISERE,Saint-Martin-d'Hères,889,203,686,16,670,1,PCF,28,7.825,31.7
2017,ISERE,Saint-Martin-d'Hères,889,203,686,16,670,1,REC,31,7.825,31.7
2017,ISERE,Saint-Martin-d'Hères,889,203,686,16,670,1,RES,10,7.825,31.7
2017,ISERE,Saint-Chef,890,194,696,18,678,1,EELV,23,7.825,31.7
2017,ISERE,Saint-Chef,890,194,696,18,678,1,FN,248,7.825,31.7
2017,ISERE,Saint-Chef,890,194,696,18,678,1,LFI,79,7.825,31.7
2017,ISERE,Saint-Chef,890,194,696,18,678,1,LO,4,7.825,31.7
2017,ISERE,Saint-Chef,890,194,696,18,678,1,LR,42,7.825,31.7
2017,ISERE,Saint-Chef,890,194,696,18,678,1,LREM,185,7.825,31.7
2017,ISERE,Saint-Chef,890,194,696,18,678,1,NPA,1,7.825,31.7
2017,ISERE,Saint-Chef,890,194,696,18,678,1,PCF,7,7.825,31.7
2017,ISERE,Saint-Chef,890,194,696,18,678,1,REC,50,7.825,31.7
2017,ISERE,Saint-Chef,890,194,696,18,678,1,RES,20,7.825,31.7
2017,ISERE,Le Pont-de-Claix,890,266,624,11,613,1,EELV,22,7.825,31.7
2017,ISERE,Le Pont-de-Claix,890,266,624,11,613,1,FN,152,7.825,31.7
2017,ISERE,Le Pont-de-Claix,890,266,624,11,613,1,LFI,183,7.825,31.7
2017,ISERE,Le Pont-de-Claix,890,266,624,11,613,1,LO,6,7.825,31.7
2017,ISERE,Le Pont-de-Claix,890,266,624,11,613,1,LR,20,7.825,31.7
2017,ISERE,Le Pont-de-Claix,890,266,624,11,613,1,LREM,132,7.825,31.7
2017,ISERE,Le Pont-de-Claix,890,266,624,11,613,1,NPA,4,7.825,31.7
2017,ISERE,Le Pont-de-Claix,890,266,624,11,613,1,PCF,17,7.825,31.7
2017,ISERE,Le Pont-de-Claix,890,266,624,11,613,1,REC,41,7.825,31.7
2017,ISERE,Le Pont-de-Claix,890,266,624,11,613,1,RES,12,7.825,31.7
2017,ISERE,Ruy-Montceau,891,167,724,21,703,1,EELV,28,7.825,31.7
2017,ISERE,Ruy-Montceau,891,167,724,21,703,1,FN,197,7.825,31.7
2017,ISERE,Ruy-Montceau,891,167,724,21,703,1,LFI,91,7.825,31.7
2017,ISERE,Ruy-Montceau,891,167,724,21,703,1,LO,4,7.825,31.7
2017,ISERE,Ruy-Montceau,891,167,724,21,703,1,LR,49,7.825,31.7
2017,ISERE,Ruy-Montceau,891,167,724,21,703,1,LREM,210,7.825,31.7
2017,ISERE,Ruy-Montceau,891,167,724,21,703,1,NPA,4,7.825,31.7
2017,ISERE,Ruy-Montceau,891,167,724,21,703,1,PCF,11,7.825,31.7
2017,ISERE,Ruy-Montceau,891,167,724,21,703,1,REC,52,7.825,31.7
2017,ISERE,Ruy-Montceau,891,167,724,21,703,1,RES,27,7.825,31.7
2017,ISERE,Arandon-Passins,891,214,677,11,666,1,EELV,22,7.825,31.7
2017,ISERE,Arandon-Passins,891,214,677,11,666,1,FN,245,7.825,31.7
2017,ISERE,Arandon-Passins,891,214,677,11,666,1,LFI,89,7.825,31.7
2017,ISERE,Arandon-Passins,891,214,677,11,666,1,LO,6,7.825,31.7
2017,ISERE,Arandon-Passins,891,214,677,11,666,1,LR,33,7.825,31.7
2017,ISERE,Arandon-Passins,891,214,677,11,666,1,LREM,132,7.825,31.7
2017,ISERE,Arandon-Passins,891,214,677,11,666,1,NPA,4,7.825,31.7
2017,ISERE,Arandon-Passins,891,214,677,11,666,1,PCF,12,7.825,31.7
2017,ISERE,Arandon-Passins,891,214,677,11,666,1,REC,64,7.825,31.7
2017,ISERE,Arandon-Passins,891,214,677,11,666,1,RES,20,7.825,31.7
2017,ISERE,Salaise-sur-Sanne,891,257,634,18,616,1,EELV,18,7.825,31.7
2017,ISERE,Salaise-sur-Sanne,891,257,634,18,616,1,FN,177,7.825,31.7
2017,ISERE,Salaise-sur-Sanne,891,257,634,18,616,1,LFI,124,7.825,31.7
2017,ISERE,Salaise-sur-Sanne,891,257,634,18,616,1,LO,1,7.825,31.7
2017,ISERE,Salaise-sur-Sanne,891,257,634,18,616,1,LR,28,7.825,31.7
2017,ISERE,Salaise-sur-Sanne,891,257,634,18,616,1,LREM,153,7.825,31.7
2017,ISERE,Salaise-sur-Sanne,891,257,634,18,616,1,NPA,4,7.825,31.7
2017,ISERE,Salaise-sur-Sanne,891,257,634,18,616,1,PCF,27,7.825,31.7
2017,ISERE,Salaise-sur-Sanne,891,257,634,18,616,1,REC,48,7.825,31.7
2017,ISERE,Salaise-sur-Sanne,891,257,634,18,616,1,RES,12,7.825,31.7
2017,ISERE,Grenoble,891,285,606,12,594,1,EELV,33,7.825,31.7
2017,ISERE,Grenoble,891,285,606,12,594,1,FN,108,7.825,31.7
2017,ISERE,Grenoble,891,285,606,12,594,1,LFI,180,7.825,31.7
2017,ISERE,Grenoble,891,285,606,12,594,1,LO,1,7.825,31.7
2017,ISERE,Grenoble,891,285,606,12,594,1,LR,17,7.825,31.7
2017,ISERE,Grenoble,891,285,606,12,594,1,LREM,163,7.825,31.7
2017,ISERE,Grenoble,891,285,606,12,594,1,NPA,3,7.825,31.7
2017,ISERE,Grenoble,891,285,606,12,594,1,PCF,10,7.825,31.7
2017,ISERE,Grenoble,891,285,606,12,594,1,REC,53,7.825,31.7
2017,ISERE,Grenoble,891,285,606,12,594,1,RES,4,7.825,31.7
2017,ISERE,Saint-Martin-d'Uriage,892,126,766,13,753,1,EELV,94,7.825,31.7
2017,ISERE,Saint-Martin-d'Uriage,892,126,766,13,753,1,FN,74,7.825,31.7
2017,ISERE,Saint-Martin-d'Uriage,892,126,766,13,753,1,LFI,134,7.825,31.7
2017,ISERE,Saint-Martin-d'Uriage,892,126,766,13,753,1,LO,1,7.825,31.7
2017,ISERE,Saint-Martin-d'Uriage,892,126,766,13,753,1,LR,42,7.825,31.7
2017,ISERE,Saint-Martin-d'Uriage,892,126,766,13,753,1,LREM,287,7.825,31.7
2017,ISERE,Saint-Martin-d'Uriage,892,126,766,13,753,1,NPA,6,7.825,31.7
2017,ISERE,Saint-Martin-d'Uriage,892,126,766,13,753,1,PCF,17,7.825,31.7
2017,ISERE,Saint-Martin-d'Uriage,892,126,766,13,753,1,REC,46,7.825,31.7
2017,ISERE,Saint-Martin-d'Uriage,892,126,766,13,753,1,RES,17,7.825,31.7
2017,ISERE,Saint-Ismier,892,161,731,16,715,1,EELV,42,7.825,31.7
2017,ISERE,Saint-Ismier,892,161,731,16,715,1,FN,76,7.825,31.7
2017,ISERE,Saint-Ismier,892,161,731,16,715,1,LFI,83,7.825,31.7
2017,ISERE,Saint-Ismier,892,161,731,16,715,1,LO,1,7.825,31.7
2017,ISERE,Saint-Ismier,892,161,731,16,715,1,LR,76,7.825,31.7
2017,ISERE,Saint-Ismier,892,161,731,16,715,1,LREM,329,7.825,31.7
2017,ISERE,Saint-Ismier,892,161,731,16,715,1,NPA,1,7.825,31.7
2017,ISERE,Saint-Ismier,892,161,731,16,715,1,PCF,6,7.825,31.7
2017,ISERE,Saint-Ismier,892,161,731,16,715,1,REC,48,7.825,31.7
2017,ISERE,Saint-Ismier,892,161,731,16,715,1,RES,15,7.825,31.7
2017,ISERE,Saint-Egrève,892,183,709,14,695,1,EELV,43,7.825,31.7
2017,ISERE,Saint-Egrève,892,183,709,14,695,1,FN,136,7.825,31.7
2017,ISERE,Saint-Egrève,892,183,709,14,695,1,LFI,200,7.825,31.7
2017,ISERE,Saint-Egrève,892,183,709,14,695,1,LO,7,7.825,31.7
2017,ISERE,Saint-Egrève,892,183,709,14,695,1,LR,25,7.825,31.7
2017,ISERE,Saint-Egrève,892,183,709,14,695,1,LREM,170,7.825,31.7
2017,ISERE,Saint-Egrève,892,183,709,14,695,1,NPA,7,7.825,31.7
2017,ISERE,Saint-Egrève,892,183,709,14,695,1,PCF,18,7.825,31.7
2017,ISERE,Saint-Egrève,892,183,709,14,695,1,REC,36,7.825,31.7
2017,ISERE,Saint-Egrève,892,183,709,14,695,1,RES,16,7.825,31.7
2017,ISERE,Saint-Egrève,893,166,727,6,721,1,EELV,57,7.825,31.7
2017,ISERE,Saint-Egrève,893,166,727,6,721,1,FN,93,7.825,31.7
2017,ISERE,Saint-Egrève,893,166,727,6,721,1,LFI,184,7.825,31.7
2017,ISERE,Saint-Egrève,893,166,727,6,721,1,LO,6,7.825,31.7
2017,ISERE,Saint-Egrève,893,166,727,6,721,1,LR,34,7.825,31.7
2017,ISERE,Saint-Egrève,893,166,727,6,721,1,LREM,240,7.825,31.7
2017,ISERE,Saint-Egrève,893,166,727,6,721,1,NPA,4,7.825,31.7
2017,ISERE,Saint-Egrève,893,166,727,6,721,1,PCF,17,7.825,31.7
2017,ISERE,Saint-Egrève,893,166,727,6,721,1,REC,45,7.825,31.7
2017,ISERE,Saint-Egrève,893,166,727,6,721,1,RES,13,7.825,31.7
2017,ISERE,Anthon,893,179,714,18,696,1,EELV,33,7.825,31.7
2017,ISERE,Anthon,893,179,714,18,696,1,FN,217,7.825,31.7
2017,ISERE,Anthon,893,179,714,18,696,1,LFI,86,7.825,31.7
2017,ISERE,Anthon,893,179,714,18,696,1,LO,4,7.825,31.7
2017,ISERE,Anthon,893,179,714,18,696,1,LR,33,7.825,31.7
2017,ISERE,Anthon,893,179,714,18,696,1,LREM,199,7.825,31.7
2017,ISERE,Anthon,893,179,714,18,696,1,NPA,5,7.825,31.7
2017,ISERE,Anthon,893,179,714,18,696,1,PCF,10,7.825,31.7
2017,ISERE,Anthon,893,179,714,18,696,1,REC,59,7.825,31.7
2017,ISERE,Anthon,893,179,714,18,696,1,RES,22,7.825,31.7
2017,ISERE,Pontcharra,893,209,684,19,665,1,EELV,50,7.825,31.7
2017,ISERE,Pontcharra,893,209,684,19,665,1,FN,175,7.825,31.7
2017,ISERE,Pontcharra,893,209,684,19,665,1,LFI,164,7.825,31.7
2017,ISERE,Pontcharra,893,209,684,19,665,1,LO,2,7.825,31.7
2017,ISERE,Pontcharra,893,209,684,19,665,1,LR,9,7.825,31.7
2017,ISERE,Pontcharra,893,209,684,19,665,1,LREM,141,7.825,31.7
2017,ISERE,Pontcharra,893,209,684,19,665,1,NPA,2,7.825,31.7
2017,ISERE,Pontcharra,893,209,684,19,665,1,PCF,16,7.825,31.7
2017,ISERE,Pontcharra,893,209,684,19,665,1,REC,47,7.825,31.7
2017,ISERE,Pontcharra,893,209,684,19,665,1,RES,18,7.825,31.7
2017,ISERE,Jardin,894,145,749,19,730,1,EELV,31,7.825,31.7
2017,ISERE,Jardin,894,145,749,19,730,1,FN,148,7.825,31.7
2017,ISERE,Jardin,894,145,749,19,730,1,LFI,109,7.825,31.7
2017,ISERE,Jardin,894,145,749,19,730,1,LO,5,7.825,31.7
2017,ISERE,Jardin,894,145,749,19,730,1,LR,41,7.825,31.7
2017,ISERE,Jardin,894,145,749,19,730,1,LREM,269,7.825,31.7
2017,ISERE,Jardin,894,145,749,19,730,1,NPA,6,7.825,31.7
2017,ISERE,Jardin,894,145,749,19,730,1,PCF,16,7.825,31.7
2017,ISERE,Jardin,894,145,749,19,730,1,REC,58,7.825,31.7
2017,ISERE,Jardin,894,145,749,19,730,1,RES,16,7.825,31.7
2017,ISERE,Sassenage,896,204,692,14,678,1,EELV,29,7.825,31.7
2017,ISERE,Sassenage,896,204,692,14,678,1,FN,168,7.825,31.7
2017,ISERE,Sassenage,896,204,692,14,678,1,LFI,124,7.825,31.7
2017,ISERE,Sassenage,896,204,692,14,678,1,LO,1,7.825,31.7
2017,ISERE,Sassenage,896,204,692,14,678,1,LR,37,7.825,31.7
2017,ISERE,Sassenage,896,204,692,14,678,1,LREM,226,7.825,31.7
2017,ISERE,Sassenage,896,204,692,14,678,1,NPA,0,7.825,31.7
2017,ISERE,Sassenage,896,204,692,14,678,1,PCF,21,7.825,31.7
2017,ISERE,Sassenage,896,204,692,14,678,1,REC,31,7.825,31.7
2017,ISERE,Sassenage,896,204,692,14,678,1,RES,16,7.825,31.7
2017,ISERE,Echirolles,896,255,641,8,633,1,EELV,35,7.825,31.7
2017,ISERE,Echirolles,896,255,641,8,633,1,FN,134,7.825,31.7
2017,ISERE,Echirolles,896,255,641,8,633,1,LFI,199,7.825,31.7
2017,ISERE,Echirolles,896,255,641,8,633,1,LO,6,7.825,31.7
2017,ISERE,Echirolles,896,255,641,8,633,1,LR,14,7.825,31.7
2017,ISERE,Echirolles,896,255,641,8,633,1,LREM,146,7.825,31.7
2017,ISERE,Echirolles,896,255,641,8,633,1,NPA,2,7.825,31.7
2017,ISERE,Echirolles,896,255,641,8,633,1,PCF,22,7.825,31.7
2017,ISERE,Echirolles,896,255,641,8,633,1,REC,37,7.825,31.7
2017,ISERE,Echirolles,896,255,641,8,633,1,RES,11,7.825,31.7
2017,ISERE,Grenoble,896,308,588,5,583,1,EELV,28,7.825,31.7
2017,ISERE,Grenoble,896,308,588,5,583,1,FN,45,7.825,31.7
2017,ISERE,Grenoble,896,308,588,5,583,1,LFI,332,7.825,31.7
2017,ISERE,Grenoble,896,308,588,5,583,1,LO,5,7.825,31.7
2017,ISERE,Grenoble,896,308,588,5,583,1,LR,16,7.825,31.7
2017,ISERE,Grenoble,896,308,588,5,583,1,LREM,99,7.825,31.7
2017,ISERE,Grenoble,896,308,588,5,583,1,NPA,5,7.825,31.7
2017,ISERE,Grenoble,896,308,588,5,583,1,PCF,19,7.825,31.7
2017,ISERE,Grenoble,896,308,588,5,583,1,REC,13,7.825,31.7
2017,ISERE,Grenoble,896,308,588,5,583,1,RES,9,7.825,31.7
2017,ISERE,Vaulnaveys-le-Haut,897,175,722,14,708,1,EELV,65,7.825,31.7
2017,ISERE,Vaulnaveys-le-Haut,897,175,722,14,708,1,FN,103,7.825,31.7
2017,ISERE,Vaulnaveys-le-Haut,897,175,722,14,708,1,LFI,118,7.825,31.7
2017,ISERE,Vaulnaveys-le-Haut,897,175,722,14,708,1,LO,3,7.825,31.7
2017,ISERE,Vaulnaveys-le-Haut,897,175,722,14,708,1,LR,46,7.825,31.7
2017,ISERE,Vaulnaveys-le-Haut,897,175,722,14,708,1,LREM,246,7.825,31.7
2017,ISERE,Vaulnaveys-le-Haut,897,175,722,14,708,1,NPA,1,7.825,31.7
2017,ISERE,Vaulnaveys-le-Haut,897,175,722,14,708,1,PCF,12,7.825,31.7
2017,ISERE,Vaulnaveys-le-Haut,897,175,722,14,708,1,REC,74,7.825,31.7
2017,ISERE,Vaulnaveys-le-Haut,897,175,722,14,708,1,RES,14,7.825,31.7
2017,ISERE,Bonnefamille,897,194,703,14,689,1,EELV,40,7.825,31.7
2017,ISERE,Bonnefamille,897,194,703,14,689,1,FN,210,7.825,31.7
2017,ISERE,Bonnefamille,897,194,703,14,689,1,LFI,112,7.825,31.7
2017,ISERE,Bonnefamille,897,194,703,14,689,1,LO,8,7.825,31.7
2017,ISERE,Bonnefamille,897,194,703,14,689,1,LR,17,7.825,31.7
2017,ISERE,Bonnefamille,897,194,703,14,689,1,LREM,182,7.825,31.7
2017,ISERE,Bonnefamille,897,194,703,14,689,1,NPA,5,7.825,31.7
2017,ISERE,Bonnefamille,897,194,703,14,689,1,PCF,13,7.825,31.7
2017,ISERE,Bonnefamille,897,194,703,14,689,1,REC,52,7.825,31.7
2017,ISERE,Bonnefamille,897,194,703,14,689,1,RES,23,7.825,31.7
2017,ISERE,Grenoble,897,245,652,10,642,1,EELV,61,7.825,31.7
2017,ISERE,Grenoble,897,245,652,10,642,1,FN,60,7.825,31.7
2017,ISERE,Grenoble,897,245,652,10,642,1,LFI,265,7.825,31.7
2017,ISERE,Grenoble,897,245,652,10,642,1,LO,4,7.825,31.7
2017,ISERE,Grenoble,897,245,652,10,642,1,LR,10,7.825,31.7
2017,ISERE,Grenoble,897,245,652,10,642,1,LREM,155,7.825,31.7
2017,ISERE,Grenoble,897,245,652,10,642,1,NPA,7,7.825,31.7
2017,ISERE,Grenoble,897,245,652,10,642,1,PCF,22,7.825,31.7
2017,ISERE,Grenoble,897,245,652,10,642,1,REC,27,7.825,31.7
2017,ISERE,Grenoble,897,245,652,10,642,1,RES,11,7.825,31.7
2017,ISERE,Vienne,898,187,711,25,686,1,EELV,37,7.825,31.7
2017,ISERE,Vienne,898,187,711,25,686,1,FN,141,7.825,31.7
2017,ISERE,Vienne,898,187,711,25,686,1,LFI,117,7.825,31.7
2017,ISERE,Vienne,898,187,711,25,686,1,LO,3,7.825,31.7
2017,ISERE,Vienne,898,187,711,25,686,1,LR,35,7.825,31.7
2017,ISERE,Vienne,898,187,711,25,686,1,LREM,215,7.825,31.7
2017,ISERE,Vienne,898,187,711,25,686,1,NPA,2,7.825,31.7
2017,ISERE,Vienne,898,187,711,25,686,1,PCF,14,7.825,31.7
2017,ISERE,Vienne,898,187,711,25,686,1,REC,67,7.825,31.7
2017,ISERE,Vienne,898,187,711,25,686,1,RES,16,7.825,31.7
2017,ISERE,Theys,900,124,776,10,766,1,EELV,67,7.825,31.7
2017,ISERE,Theys,900,124,776,10,766,1,FN,161,7.825,31.7
2017,ISERE,Theys,900,124,776,10,766,1,LFI,188,7.825,31.7
2017,ISERE,Theys,900,124,776,10,766,1,LO,1,7.825,31.7
2017,ISERE,Theys,900,124,776,10,766,1,LR,30,7.825,31.7
2017,ISERE,Theys,900,124,776,10,766,1,LREM,198,7.825,31.7
2017,ISERE,Theys,900,124,776,10,766,1,NPA,2,7.825,31.7
2017,ISERE,Theys,900,124,776,10,766,1,PCF,5,7.825,31.7
2017,ISERE,Theys,900,124,776,10,766,1,REC,43,7.825,31.7
2017,ISERE,Theys,900,124,776,10,766,1,RES,35,7.825,31.7
2017,ISERE,La Terrasse,900,137,763,16,747,1,EELV,64,7.825,31.7
2017,ISERE,La Terrasse,900,137,763,16,747,1,FN,175,7.825,31.7
2017,ISERE,La Terrasse,900,137,763,16,747,1,LFI,157,7.825,31.7
2017,ISERE,La Terrasse,900,137,763,16,747,1,LO,3,7.825,31.7
2017,ISERE,La Terrasse,900,137,763,16,747,1,LR,28,7.825,31.7
2017,ISERE,La Terrasse,900,137,763,16,747,1,LREM,192,7.825,31.7
2017,ISERE,La Terrasse,900,137,763,16,747,1,NPA,4,7.825,31.7
2017,ISERE,La Terrasse,900,137,763,16,747,1,PCF,18,7.825,31.7
2017,ISERE,La Terrasse,900,137,763,16,747,1,REC,57,7.825,31.7
2017,ISERE,La Terrasse,900,137,763,16,747,1,RES,25,7.825,31.7
2017,ISERE,Saint-Paul-de-Varces,901,150,751,12,739,1,EELV,52,7.825,31.7
2017,ISERE,Saint-Paul-de-Varces,901,150,751,12,739,1,FN,168,7.825,31.7
2017,ISERE,Saint-Paul-de-Varces,901,150,751,12,739,1,LFI,126,7.825,31.7
2017,ISERE,Saint-Paul-de-Varces,901,150,751,12,739,1,LO,2,7.825,31.7
2017,ISERE,Saint-Paul-de-Varces,901,150,751,12,739,1,LR,29,7.825,31.7
2017,ISERE,Saint-Paul-de-Varces,901,150,751,12,739,1,LREM,252,7.825,31.7
2017,ISERE,Saint-Paul-de-Varces,901,150,751,12,739,1,NPA,6,7.825,31.7
2017,ISERE,Saint-Paul-de-Varces,901,150,751,12,739,1,PCF,15,7.825,31.7
2017,ISERE,Saint-Paul-de-Varces,901,150,751,12,739,1,REC,57,7.825,31.7
2017,ISERE,Saint-Paul-de-Varces,901,150,751,12,739,1,RES,16,7.825,31.7
2017,ISERE,Roche,902,147,755,11,744,1,EELV,37,7.825,31.7
2017,ISERE,Roche,902,147,755,11,744,1,FN,209,7.825,31.7
2017,ISERE,Roche,902,147,755,11,744,1,LFI,107,7.825,31.7
2017,ISERE,Roche,902,147,755,11,744,1,LO,3,7.825,31.7
2017,ISERE,Roche,902,147,755,11,744,1,LR,45,7.825,31.7
2017,ISERE,Roche,902,147,755,11,744,1,LREM,216,7.825,31.7
2017,ISERE,Roche,902,147,755,11,744,1,NPA,4,7.825,31.7
2017,ISERE,Roche,902,147,755,11,744,1,PCF,17,7.825,31.7
2017,ISERE,Roche,902,147,755,11,744,1,REC,64,7.825,31.7
2017,ISERE,Roche,902,147,755,11,744,1,RES,17,7.825,31.7
2017,ISERE,Saint-Jean-de-Moirans,903,143,760,15,745,1,EELV,59,7.825,31.7
2017,ISERE,Saint-Jean-de-Moirans,903,143,760,15,745,1,FN,139,7.825,31.7
2017,ISERE,Saint-Jean-de-Moirans,903,143,760,15,745,1,LFI,203,7.825,31.7
2017,ISERE,Saint-Jean-de-Moirans,903,143,760,15,745,1,LO,3,7.825,31.7
2017,ISERE,Saint-Jean-de-Moirans,903,143,760,15,745,1,LR,20,7.825,31.7
2017,ISERE,Saint-Jean-de-Moirans,903,143,760,15,745,1,LREM,210,7.825,31.7
2017,ISERE,Saint-Jean-de-Moirans,903,143,760,15,745,1,NPA,4,7.825,31.7
2017,ISERE,Saint-Jean-de-Moirans,903,143,760,15,745,1,PCF,21,7.825,31.7
2017,ISERE,Saint-Jean-de-Moirans,903,143,760,15,745,1,REC,31,7.825,31.7
2017,ISERE,Saint-Jean-de-Moirans,903,143,760,15,745,1,RES,11,7.825,31.7
2017,ISERE,Montagnieu,903,173,730,19,711,1,EELV,22,7.825,31.7
2017,ISERE,Montagnieu,903,173,730,19,711,1,FN,269,7.825,31.7
2017,ISERE,Montagnieu,903,173,730,19,711,1,LFI,116,7.825,31.7
2017,ISERE,Montagnieu,903,173,730,19,711,1,LO,4,7.825,31.7
2017,ISERE,Montagnieu,903,173,730,19,711,1,LR,36,7.825,31.7
2017,ISERE,Montagnieu,903,173,730,19,711,1,LREM,140,7.825,31.7
2017,ISERE,Montagnieu,903,173,730,19,711,1,NPA,4,7.825,31.7
2017,ISERE,Montagnieu,903,173,730,19,711,1,PCF,8,7.825,31.7
2017,ISERE,Montagnieu,903,173,730,19,711,1,REC,47,7.825,31.7
2017,ISERE,Montagnieu,903,173,730,19,711,1,RES,29,7.825,31.7
2017,ISERE,Tignieu-Jameyzieu,905,206,699,12,687,1,EELV,30,7.825,31.7
2017,ISERE,Tignieu-Jameyzieu,905,206,699,12,687,1,FN,213,7.825,31.7
2017,ISERE,Tignieu-Jameyzieu,905,206,699,12,687,1,LFI,153,7.825,31.7
2017,ISERE,Tignieu-Jameyzieu,905,206,699,12,687,1,LO,1,7.825,31.7
2017,ISERE,Tignieu-Jameyzieu,905,206,699,12,687,1,LR,15,7.825,31.7
2017,ISERE,Tignieu-Jameyzieu,905,206,699,12,687,1,LREM,145,7.825,31.7
2017,ISERE,Tignieu-Jameyzieu,905,206,699,12,687,1,NPA,3,7.825,31.7
2017,ISERE,Tignieu-Jameyzieu,905,206,699,12,687,1,PCF,14,7.825,31.7
2017,ISERE,Tignieu-Jameyzieu,905,206,699,12,687,1,REC,61,7.825,31.7
2017,ISERE,Tignieu-Jameyzieu,905,206,699,12,687,1,RES,19,7.825,31.7
2017,ISERE,Estrablin,908,163,745,13,732,1,EELV,32,7.825,31.7
2017,ISERE,Estrablin,908,163,745,13,732,1,FN,177,7.825,31.7
2017,ISERE,Estrablin,908,163,745,13,732,1,LFI,146,7.825,31.7
2017,ISERE,Estrablin,908,163,745,13,732,1,LO,4,7.825,31.7
2017,ISERE,Estrablin,908,163,745,13,732,1,LR,34,7.825,31.7
2017,ISERE,Estrablin,908,163,745,13,732,1,LREM,204,7.825,31.7
2017,ISERE,Estrablin,908,163,745,13,732,1,NPA,5,7.825,31.7
2017,ISERE,Estrablin,908,163,745,13,732,1,PCF,18,7.825,31.7
2017,ISERE,Estrablin,908,163,745,13,732,1,REC,56,7.825,31.7
2017,ISERE,Estrablin,908,163,745,13,732,1,RES,24,7.825,31.7
2017,ISERE,Saint-Aupre,909,132,777,23,754,1,EELV,65,7.825,31.7
2017,ISERE,Saint-Aupre,909,132,777,23,754,1,FN,158,7.825,31.7
2017,ISERE,Saint-Aupre,909,132,777,23,754,1,LFI,128,7.825,31.7
2017,ISERE,Saint-Aupre,909,132,777,23,754,1,LO,4,7.825,31.7
2017,ISERE,Saint-Aupre,909,132,777,23,754,1,LR,24,7.825,31.7
2017,ISERE,Saint-Aupre,909,132,777,23,754,1,LREM,243,7.825,31.7
2017,ISERE,Saint-Aupre,909,132,777,23,754,1,NPA,1,7.825,31.7
2017,ISERE,Saint-Aupre,909,132,777,23,754,1,PCF,10,7.825,31.7
2017,ISERE,Saint-Aupre,909,132,777,23,754,1,REC,51,7.825,31.7
2017,ISERE,Saint-Aupre,909,132,777,23,754,1,RES,31,7.825,31.7
2017,ISERE,La Tronche,909,173,736,11,725,1,EELV,79,7.825,31.7
2017,ISERE,La Tronche,909,173,736,11,725,1,FN,76,7.825,31.7
2017,ISERE,La Tronche,909,173,736,11,725,1,LFI,172,7.825,31.7
2017,ISERE,La Tronche,909,173,736,11,725,1,LO,1,7.825,31.7
2017,ISERE,La Tronche,909,173,736,11,725,1,LR,44,7.825,31.7
2017,ISERE,La Tronche,909,173,736,11,725,1,LREM,262,7.825,31.7
2017,ISERE,La Tronche,909,173,736,11,725,1,NPA,6,7.825,31.7
2017,ISERE,La Tronche,909,173,736,11,725,1,PCF,11,7.825,31.7
2017,ISERE,La Tronche,909,173,736,11,725,1,REC,38,7.825,31.7
2017,ISERE,La Tronche,909,173,736,11,725,1,RES,5,7.825,31.7
2017,ISERE,Chuzelles,909,180,729,18,711,1,EELV,32,7.825,31.7
2017,ISERE,Chuzelles,909,180,729,18,711,1,FN,203,7.825,31.7
2017,ISERE,Chuzelles,909,180,729,18,711,1,LFI,113,7.825,31.7
2017,ISERE,Chuzelles,909,180,729,18,711,1,LO,4,7.825,31.7
2017,ISERE,Chuzelles,909,180,729,18,711,1,LR,39,7.825,31.7
2017,ISERE,Chuzelles,909,180,729,18,711,1,LREM,196,7.825,31.7
2017,ISERE,Chuzelles,909,180,729,18,711,1,NPA,2,7.825,31.7
2017,ISERE,Chuzelles,909,180,729,18,711,1,PCF,13,7.825,31.7
2017,ISERE,Chuzelles,909,180,729,18,711,1,REC,61,7.825,31.7
2017,ISERE,Chuzelles,909,180,729,18,711,1,RES,22,7.825,31.7
2017,ISERE,Saint-Martin-le-Vinoux,910,157,753,13,740,1,EELV,88,7.825,31.7
2017,ISERE,Saint-Martin-le-Vinoux,910,157,753,13,740,1,FN,64,7.825,31.7
2017,ISERE,Saint-Martin-le-Vinoux,910,157,753,13,740,1,LFI,205,7.825,31.7
2017,ISERE,Saint-Martin-le-Vinoux,910,157,753,13,740,1,LO,3,7.825,31.7
2017,ISERE,Saint-Martin-le-Vinoux,910,157,753,13,740,1,LR,37,7.825,31.7
2017,ISERE,Saint-Martin-le-Vinoux,910,157,753,13,740,1,LREM,226,7.825,31.7
2017,ISERE,Saint-Martin-le-Vinoux,910,157,753,13,740,1,NPA,4,7.825,31.7
2017,ISERE,Saint-Martin-le-Vinoux,910,157,753,13,740,1,PCF,15,7.825,31.7
2017,ISERE,Saint-Martin-le-Vinoux,910,157,753,13,740,1,REC,59,7.825,31.7
2017,ISERE,Saint-Martin-le-Vinoux,910,157,753,13,740,1,RES,14,7.825,31.7
2017,ISERE,L'Isle-d'Abeau,912,220,692,18,674,1,EELV,31,7.825,31.7
2017,ISERE,L'Isle-d'Abeau,912,220,692,18,674,1,FN,177,7.825,31.7
2017,ISERE,L'Isle-d'Abeau,912,220,692,18,674,1,LFI,167,7.825,31.7
2017,ISERE,L'Isle-d'Abeau,912,220,692,18,674,1,LO,2,7.825,31.7
2017,ISERE,L'Isle-d'Abeau,912,220,692,18,674,1,LR,28,7.825,31.7
2017,ISERE,L'Isle-d'Abeau,912,220,692,18,674,1,LREM,175,7.825,31.7
2017,ISERE,L'Isle-d'Abeau,912,220,692,18,674,1,NPA,5,7.825,31.7
2017,ISERE,L'Isle-d'Abeau,912,220,692,18,674,1,PCF,10,7.825,31.7
2017,ISERE,L'Isle-d'Abeau,912,220,692,18,674,1,REC,42,7.825,31.7
2017,ISERE,L'Isle-d'Abeau,912,220,692,18,674,1,RES,11,7.825,31.7
2017,ISERE,Saint-Jean-de-Bournay,912,221,691,21,670,1,EELV,20,7.825,31.7
2017,ISERE,Saint-Jean-de-Bournay,912,221,691,21,670,1,FN,258,7.825,31.7
2017,ISERE,Saint-Jean-de-Bournay,912,221,691,21,670,1,LFI,83,7.825,31.7
2017,ISERE,Saint-Jean-de-Bournay,912,221,691,21,670,1,LO,2,7.825,31.7
2017,ISERE,Saint-Jean-de-Bournay,912,221,691,21,670,1,LR,32,7.825,31.7
2017,ISERE,Saint-Jean-de-Bournay,912,221,691,21,670,1,LREM,153,7.825,31.7
2017,ISERE,Saint-Jean-de-Bournay,912,221,691,21,670,1,NPA,2,7.825,31.7
2017,ISERE,Saint-Jean-de-Bournay,912,221,691,21,670,1,PCF,20,7.825,31.7
2017,ISERE,Saint-Jean-de-Bournay,912,221,691,21,670,1,REC,47,7.825,31.7
2017,ISERE,Saint-Jean-de-Bournay,912,221,691,21,670,1,RES,23,7.825,31.7
2017,ISERE,Frontonas,913,133,780,12,768,1,EELV,40,7.825,31.7
2017,ISERE,Frontonas,913,133,780,12,768,1,FN,205,7.825,31.7
2017,ISERE,Frontonas,913,133,780,12,768,1,LFI,95,7.825,31.7
2017,ISERE,Frontonas,913,133,780,12,768,1,LO,4,7.825,31.7
2017,ISERE,Frontonas,913,133,780,12,768,1,LR,51,7.825,31.7
2017,ISERE,Frontonas,913,133,780,12,768,1,LREM,236,7.825,31.7
2017,ISERE,Frontonas,913,133,780,12,768,1,NPA,4,7.825,31.7
2017,ISERE,Frontonas,913,133,780,12,768,1,PCF,12,7.825,31.7
2017,ISERE,Frontonas,913,133,780,12,768,1,REC,72,7.825,31.7
2017,ISERE,Frontonas,913,133,780,12,768,1,RES,18,7.825,31.7
2017,ISERE,Meylan,914,182,732,12,720,1,EELV,97,7.825,31.7
2017,ISERE,Meylan,914,182,732,12,720,1,FN,75,7.825,31.7
2017,ISERE,Meylan,914,182,732,12,720,1,LFI,226,7.825,31.7
2017,ISERE,Meylan,914,182,732,12,720,1,LO,4,7.825,31.7
2017,ISERE,Meylan,914,182,732,12,720,1,LR,33,7.825,31.7
2017,ISERE,Meylan,914,182,732,12,720,1,LREM,178,7.825,31.7
2017,ISERE,Meylan,914,182,732,12,720,1,NPA,5,7.825,31.7
2017,ISERE,Meylan,914,182,732,12,720,1,PCF,12,7.825,31.7
2017,ISERE,Meylan,914,182,732,12,720,1,REC,40,7.825,31.7
2017,ISERE,Meylan,914,182,732,12,720,1,RES,10,7.825,31.7
2017,ISERE,Fontaine,916,274,642,10,632,1,EELV,12,7.825,31.7
2017,ISERE,Fontaine,916,274,642,10,632,1,FN,107,7.825,31.7
2017,ISERE,Fontaine,916,274,642,10,632,1,LFI,264,7.825,31.7
2017,ISERE,Fontaine,916,274,642,10,632,1,LO,4,7.825,31.7
2017,ISERE,Fontaine,916,274,642,10,632,1,LR,11,7.825,31.7
2017,ISERE,Fontaine,916,274,642,10,632,1,LREM,139,7.825,31.7
2017,ISERE,Fontaine,916,274,642,10,632,1,NPA,5,7.825,31.7
2017,ISERE,Fontaine,916,274,642,10,632,1,PCF,28,7.825,31.7
2017,ISERE,Fontaine,916,274,642,10,632,1,REC,27,7.825,31.7
2017,ISERE,Fontaine,916,274,642,10,632,1,RES,10,7.825,31.7
2017,ISERE,Eybens,917,178,739,22,717,1,EELV,34,7.825,31.7
2017,ISERE,Eybens,917,178,739,22,717,1,FN,164,7.825,31.7
2017,ISERE,Eybens,917,178,739,22,717,1,LFI,140,7.825,31.7
2017,ISERE,Eybens,917,178,739,22,717,1,LO,6,7.825,31.7
2017,ISERE,Eybens,917,178,739,22,717,1,LR,36,7.825,31.7
2017,ISERE,Eybens,917,178,739,22,717,1,LREM,191,7.825,31.7
2017,ISERE,Eybens,917,178,739,22,717,1,NPA,4,7.825,31.7
2017,ISERE,Eybens,917,178,739,22,717,1,PCF,17,7.825,31.7
2017,ISERE,Eybens,917,178,739,22,717,1,REC,67,7.825,31.7
2017,ISERE,Eybens,917,178,739,22,717,1,RES,19,7.825,31.7
2017,ISERE,Bourgoin-Jallieu,918,305,613,12,601,1,EELV,27,7.825,31.7
2017,ISERE,Bourgoin-Jallieu,918,305,613,12,601,1,FN,140,7.825,31.7
2017,ISERE,Bourgoin-Jallieu,918,305,613,12,601,1,LFI,145,7.825,31.7
2017,ISERE,Bourgoin-Jallieu,918,305,613,12,601,1,LO,5,7.825,31.7
2017,ISERE,Bourgoin-Jallieu,918,305,613,12,601,1,LR,26,7.825,31.7
2017,ISERE,Bourgoin-Jallieu,918,305,613,12,601,1,LREM,171,7.825,31.7
2017,ISERE,Bourgoin-Jallieu,918,305,613,12,601,1,NPA,3,7.825,31.7
2017,ISERE,Bourgoin-Jallieu,918,305,613,12,601,1,PCF,9,7.825,31.7
2017,ISERE,Bourgoin-Jallieu,918,305,613,12,601,1,REC,40,7.825,31.7
2017,ISERE,Bourgoin-Jallieu,918,305,613,12,601,1,RES,11,7.825,31.7
2017,ISERE,Echirolles,919,273,646,14,632,1,EELV,36,7.825,31.7
2017,ISERE,Echirolles,919,273,646,14,632,1,FN,128,7.825,31.7
2017,ISERE,Echirolles,919,273,646,14,632,1,LFI,178,7.825,31.7
2017,ISERE,Echirolles,919,273,646,14,632,1,LO,4,7.825,31.7
2017,ISERE,Echirolles,919,273,646,14,632,1,LR,19,7.825,31.7
2017,ISERE,Echirolles,919,273,646,14,632,1,LREM,183,7.825,31.7
2017,ISERE,Echirolles,919,273,646,14,632,1,NPA,0,7.825,31.7
2017,ISERE,Echirolles,919,273,646,14,632,1,PCF,22,7.825,31.7
2017,ISERE,Echirolles,919,273,646,14,632,1,REC,31,7.825,31.7
2017,ISERE,Echirolles,919,273,646,14,632,1,RES,16,7.825,31.7
2017,ISERE,Domène,921,257,664,10,654,1,EELV,25,7.825,31.7
2017,ISERE,Domène,921,257,664,10,654,1,FN,152,7.825,31.7
2017,ISERE,Domène,921,257,664,10,654,1,LFI,191,7.825,31.7
2017,ISERE,Domène,921,257,664,10,654,1,LO,4,7.825,31.7
2017,ISERE,Domène,921,257,664,10,654,1,LR,15,7.825,31.7
2017,ISERE,Domène,921,257,664,10,654,1,LREM,174,7.825,31.7
2017,ISERE,Domène,921,257,664,10,654,1,NPA,1,7.825,31.7
2017,ISERE,Domène,921,257,664,10,654,1,PCF,15,7.825,31.7
2017,ISERE,Domène,921,257,664,10,654,1,REC,45,7.825,31.7
2017,ISERE,Domène,921,257,664,10,654,1,RES,14,7.825,31.7
2017,ISERE,Coublevie,923,154,769,24,745,1,EELV,78,7.825,31.7
2017,ISERE,Coublevie,923,154,769,24,745,1,FN,103,7.825,31.7
2017,ISERE,Coublevie,923,154,769,24,745,1,LFI,166,7.825,31.7
2017,ISERE,Coublevie,923,154,769,24,745,1,LO,0,7.825,31.7
2017,ISERE,Coublevie,923,154,769,24,745,1,LR,51,7.825,31.7
2017,ISERE,Coublevie,923,154,769,24,745,1,LREM,246,7.825,31.7
2017,ISERE,Coublevie,923,154,769,24,745,1,NPA,1,7.825,31.7
2017,ISERE,Coublevie,923,154,769,24,745,1,PCF,8,7.825,31.7
2017,ISERE,Coublevie,923,154,769,24,745,1,REC,46,7.825,31.7
2017,ISERE,Coublevie,923,154,769,24,745,1,RES,14,7.825,31.7
2017,ISERE,Echirolles,923,272,651,18,633,1,EELV,14,7.825,31.7
2017,ISERE,Echirolles,923,272,651,18,633,1,FN,156,7.825,31.7
2017,ISERE,Echirolles,923,272,651,18,633,1,LFI,204,7.825,31.7
2017,ISERE,Echirolles,923,272,651,18,633,1,LO,5,7.825,31.7
2017,ISERE,Echirolles,923,272,651,18,633,1,LR,18,7.825,31.7
2017,ISERE,Echirolles,923,272,651,18,633,1,LREM,133,7.825,31.7
2017,ISERE,Echirolles,923,272,651,18,633,1,NPA,3,7.825,31.7
2017,ISERE,Echirolles,923,272,651,18,633,1,PCF,23,7.825,31.7
2017,ISERE,Echirolles,923,272,651,18,633,1,REC,45,7.825,31.7
2017,ISERE,Echirolles,923,272,651,18,633,1,RES,10,7.825,31.7
2017,ISERE,Saint-Ismier,924,151,773,11,762,1,EELV,70,7.825,31.7
2017,ISERE,Saint-Ismier,924,151,773,11,762,1,FN,74,7.825,31.7
2017,ISERE,Saint-Ismier,924,151,773,11,762,1,LFI,76,7.825,31.7
2017,ISERE,Saint-Ismier,924,151,773,11,762,1,LO,2,7.825,31.7
2017,ISERE,Saint-Ismier,924,151,773,11,762,1,LR,58,7.825,31.7
2017,ISERE,Saint-Ismier,924,151,773,11,762,1,LREM,394,7.825,31.7
2017,ISERE,Saint-Ismier,924,151,773,11,762,1,NPA,4,7.825,31.7
2017,ISERE,Saint-Ismier,924,151,773,11,762,1,PCF,7,7.825,31.7
2017,ISERE,Saint-Ismier,924,151,773,11,762,1,REC,46,7.825,31.7
2017,ISERE,Saint-Ismier,924,151,773,11,762,1,RES,12,7.825,31.7
2017,ISERE,Ville-sous-Anjou,924,173,751,19,732,1,EELV,33,7.825,31.7
2017,ISERE,Ville-sous-Anjou,924,173,751,19,732,1,FN,239,7.825,31.7
2017,ISERE,Ville-sous-Anjou,924,173,751,19,732,1,LFI,100,7.825,31.7
2017,ISERE,Ville-sous-Anjou,924,173,751,19,732,1,LO,4,7.825,31.7
2017,ISERE,Ville-sous-Anjou,924,173,751,19,732,1,LR,35,7.825,31.7
2017,ISERE,Ville-sous-Anjou,924,173,751,19,732,1,LREM,208,7.825,31.7
2017,ISERE,Ville-sous-Anjou,924,173,751,19,732,1,NPA,3,7.825,31.7
2017,ISERE,Ville-sous-Anjou,924,173,751,19,732,1,PCF,4,7.825,31.7
2017,ISERE,Ville-sous-Anjou,924,173,751,19,732,1,REC,67,7.825,31.7
2017,ISERE,Ville-sous-Anjou,924,173,751,19,732,1,RES,20,7.825,31.7
2017,ISERE,Courtenay,924,192,732,19,713,1,EELV,22,7.825,31.7
2017,ISERE,Courtenay,924,192,732,19,713,1,FN,248,7.825,31.7
2017,ISERE,Courtenay,924,192,732,19,713,1,LFI,82,7.825,31.7
2017,ISERE,Courtenay,924,192,732,19,713,1,LO,0,7.825,31.7
2017,ISERE,Courtenay,924,192,732,19,713,1,LR,33,7.825,31.7
2017,ISERE,Courtenay,924,192,732,19,713,1,LREM,160,7.825,31.7
2017,ISERE,Courtenay,924,192,732,19,713,1,NPA,2,7.825,31.7
2017,ISERE,Courtenay,924,192,732,19,713,1,PCF,16,7.825,31.7
2017,ISERE,Courtenay,924,192,732,19,713,1,REC,80,7.825,31.7
2017,ISERE,Courtenay,924,192,732,19,713,1,RES,31,7.825,31.7
2017,ISERE,Pressins,925,161,764,10,754,1,EELV,35,7.825,31.7
2017,ISERE,Pressins,925,161,764,10,754,1,FN,249,7.825,31.7
2017,ISERE,Pressins,925,161,764,10,754,1,LFI,121,7.825,31.7
2017,ISERE,Pressins,925,161,764,10,754,1,LO,7,7.825,31.7
2017,ISERE,Pressins,925,161,764,10,754,1,LR,25,7.825,31.7
2017,ISERE,Pressins,925,161,764,10,754,1,LREM,166,7.825,31.7
2017,ISERE,Pressins,925,161,764,10,754,1,NPA,8,7.825,31.7
2017,ISERE,Pressins,925,161,764,10,754,1,PCF,12,7.825,31.7
2017,ISERE,Pressins,925,161,764,10,754,1,REC,75,7.825,31.7
2017,ISERE,Pressins,925,161,764,10,754,1,RES,21,7.825,31.7
2017,ISERE,Eyzin-Pinet,925,194,731,21,710,1,EELV,35,7.825,31.7
2017,ISERE,Eyzin-Pinet,925,194,731,21,710,1,FN,199,7.825,31.7
2017,ISERE,Eyzin-Pinet,925,194,731,21,710,1,LFI,97,7.825,31.7
2017,ISERE,Eyzin-Pinet,925,194,731,21,710,1,LO,2,7.825,31.7
2017,ISERE,Eyzin-Pinet,925,194,731,21,710,1,LR,31,7.825,31.7
2017,ISERE,Eyzin-Pinet,925,194,731,21,710,1,LREM,214,7.825,31.7
2017,ISERE,Eyzin-Pinet,925,194,731,21,710,1,NPA,3,7.825,31.7
2017,ISERE,Eyzin-Pinet,925,194,731,21,710,1,PCF,8,7.825,31.7
2017,ISERE,Eyzin-Pinet,925,194,731,21,710,1,REC,66,7.825,31.7
2017,ISERE,Eyzin-Pinet,925,194,731,21,710,1,RES,22,7.825,31.7
2017,ISERE,Les Avenières Veyrins-Thuellin,926,203,723,21,702,1,EELV,22,7.825,31.7
2017,ISERE,Les Avenières Veyrins-Thuellin,926,203,723,21,702,1,FN,241,7.825,31.7
2017,ISERE,Les Avenières Veyrins-Thuellin,926,203,723,21,702,1,LFI,97,7.825,31.7
2017,ISERE,Les Avenières Veyrins-Thuellin,926,203,723,21,702,1,LO,7,7.825,31.7
2017,ISERE,Les Avenières Veyrins-Thuellin,926,203,723,21,702,1,LR,26,7.825,31.7
2017,ISERE,Les Avenières Veyrins-Thuellin,926,203,723,21,702,1,LREM,150,7.825,31.7
2017,ISERE,Les Avenières Veyrins-Thuellin,926,203,723,21,702,1,NPA,2,7.825,31.7
2017,ISERE,Les Avenières Veyrins-Thuellin,926,203,723,21,702,1,PCF,17,7.825,31.7
2017,ISERE,Les Avenières Veyrins-Thuellin,926,203,723,21,702,1,REC,70,7.825,31.7
2017,ISERE,Les Avenières Veyrins-Thuellin,926,203,723,21,702,1,RES,41,7.825,31.7
2017,ISERE,Echirolles,926,338,588,13,575,1,EELV,13,7.825,31.7
2017,ISERE,Echirolles,926,338,588,13,575,1,FN,113,7.825,31.7
2017,ISERE,Echirolles,926,338,588,13,575,1,LFI,278,7.825,31.7
2017,ISERE,Echirolles,926,338,588,13,575,1,LO,3,7.825,31.7
2017,ISERE,Echirolles,926,338,588,13,575,1,LR,10,7.825,31.7
2017,ISERE,Echirolles,926,338,588,13,575,1,LREM,88,7.825,31.7
2017,ISERE,Echirolles,926,338,588,13,575,1,NPA,5,7.825,31.7
2017,ISERE,Echirolles,926,338,588,13,575,1,PCF,20,7.825,31.7
2017,ISERE,Echirolles,926,338,588,13,575,1,REC,22,7.825,31.7
2017,ISERE,Echirolles,926,338,588,13,575,1,RES,8,7.825,31.7
2017,ISERE,Saint-Nizier-du-Moucherotte,927,158,769,15,754,1,EELV,102,7.825,31.7
2017,ISERE,Saint-Nizier-du-Moucherotte,927,158,769,15,754,1,FN,77,7.825,31.7
2017,ISERE,Saint-Nizier-du-Moucherotte,927,158,769,15,754,1,LFI,231,7.825,31.7
2017,ISERE,Saint-Nizier-du-Moucherotte,927,158,769,15,754,1,LO,4,7.825,31.7
2017,ISERE,Saint-Nizier-du-Moucherotte,927,158,769,15,754,1,LR,23,7.825,31.7
2017,ISERE,Saint-Nizier-du-Moucherotte,927,158,769,15,754,1,LREM,200,7.825,31.7
2017,ISERE,Saint-Nizier-du-Moucherotte,927,158,769,15,754,1,NPA,6,7.825,31.7
2017,ISERE,Saint-Nizier-du-Moucherotte,927,158,769,15,754,1,PCF,17,7.825,31.7
2017,ISERE,Saint-Nizier-du-Moucherotte,927,158,769,15,754,1,REC,34,7.825,31.7
2017,ISERE,Saint-Nizier-du-Moucherotte,927,158,769,15,754,1,RES,26,7.825,31.7
2017,ISERE,Salaise-sur-Sanne,928,231,697,17,680,1,EELV,24,7.825,31.7
2017,ISERE,Salaise-sur-Sanne,928,231,697,17,680,1,FN,214,7.825,31.7
2017,ISERE,Salaise-sur-Sanne,928,231,697,17,680,1,LFI,131,7.825,31.7
2017,ISERE,Salaise-sur-Sanne,928,231,697,17,680,1,LO,6,7.825,31.7
2017,ISERE,Salaise-sur-Sanne,928,231,697,17,680,1,LR,19,7.825,31.7
2017,ISERE,Salaise-sur-Sanne,928,231,697,17,680,1,LREM,166,7.825,31.7
2017,ISERE,Salaise-sur-Sanne,928,231,697,17,680,1,NPA,1,7.825,31.7
2017,ISERE,Salaise-sur-Sanne,928,231,697,17,680,1,PCF,21,7.825,31.7
2017,ISERE,Salaise-sur-Sanne,928,231,697,17,680,1,REC,55,7.825,31.7
2017,ISERE,Salaise-sur-Sanne,928,231,697,17,680,1,RES,20,7.825,31.7
2017,ISERE,Saint-Martin-le-Vinoux,928,247,681,15,666,1,EELV,27,7.825,31.7
2017,ISERE,Saint-Martin-le-Vinoux,928,247,681,15,666,1,FN,105,7.825,31.7
2017,ISERE,Saint-Martin-le-Vinoux,928,247,681,15,666,1,LFI,242,7.825,31.7
2017,ISERE,Saint-Martin-le-Vinoux,928,247,681,15,666,1,LO,6,7.825,31.7
2017,ISERE,Saint-Martin-le-Vinoux,928,247,681,15,666,1,LR,24,7.825,31.7
2017,ISERE,Saint-Martin-le-Vinoux,928,247,681,15,666,1,LREM,158,7.825,31.7
2017,ISERE,Saint-Martin-le-Vinoux,928,247,681,15,666,1,NPA,6,7.825,31.7
2017,ISERE,Saint-Martin-le-Vinoux,928,247,681,15,666,1,PCF,18,7.825,31.7
2017,ISERE,Saint-Martin-le-Vinoux,928,247,681,15,666,1,REC,43,7.825,31.7
2017,ISERE,Saint-Martin-le-Vinoux,928,247,681,15,666,1,RES,14,7.825,31.7
2017,ISERE,Saint-Martin-d'Hères,928,327,601,10,591,1,EELV,22,7.825,31.7
2017,ISERE,Saint-Martin-d'Hères,928,327,601,10,591,1,FN,165,7.825,31.7
2017,ISERE,Saint-Martin-d'Hères,928,327,601,10,591,1,LFI,180,7.825,31.7
2017,ISERE,Saint-Martin-d'Hères,928,327,601,10,591,1,LO,5,7.825,31.7
2017,ISERE,Saint-Martin-d'Hères,928,327,601,10,591,1,LR,11,7.825,31.7
2017,ISERE,Saint-Martin-d'Hères,928,327,601,10,591,1,LREM,120,7.825,31.7
2017,ISERE,Saint-Martin-d'Hères,928,327,601,10,591,1,NPA,2,7.825,31.7
2017,ISERE,Saint-Martin-d'Hères,928,327,601,10,591,1,PCF,18,7.825,31.7
2017,ISERE,Saint-Martin-d'Hères,928,327,601,10,591,1,REC,42,7.825,31.7
2017,ISERE,Saint-Martin-d'Hères,928,327,601,10,591,1,RES,8,7.825,31.7
2017,ISERE,Saint-Martin-d'Uriage,930,170,760,12,748,1,EELV,70,7.825,31.7
2017,ISERE,Saint-Martin-d'Uriage,930,170,760,12,748,1,FN,119,7.825,31.7
2017,ISERE,Saint-Martin-d'Uriage,930,170,760,12,748,1,LFI,155,7.825,31.7
2017,ISERE,Saint-Martin-d'Uriage,930,170,760,12,748,1,LO,2,7.825,31.7
2017,ISERE,Saint-Martin-d'Uriage,930,170,760,12,748,1,LR,34,7.825,31.7
2017,ISERE,Saint-Martin-d'Uriage,930,170,760,12,748,1,LREM,249,7.825,31.7
2017,ISERE,Saint-Martin-d'Uriage,930,170,760,12,748,1,NPA,3,7.825,31.7
2017,ISERE,Saint-Martin-d'Uriage,930,170,760,12,748,1,PCF,9,7.825,31.7
2017,ISERE,Saint-Martin-d'Uriage,930,170,760,12,748,1,REC,63,7.825,31.7
2017,ISERE,Saint-Martin-d'Uriage,930,170,760,12,748,1,RES,13,7.825,31.7
2017,ISERE,Tignieu-Jameyzieu,930,191,739,22,717,1,EELV,11,7.825,31.7
2017,ISERE,Tignieu-Jameyzieu,930,191,739,22,717,1,FN,215,7.825,31.7
2017,ISERE,Tignieu-Jameyzieu,930,191,739,22,717,1,LFI,151,7.825,31.7
2017,ISERE,Tignieu-Jameyzieu,930,191,739,22,717,1,LO,2,7.825,31.7
2017,ISERE,Tignieu-Jameyzieu,930,191,739,22,717,1,LR,19,7.825,31.7
2017,ISERE,Tignieu-Jameyzieu,930,191,739,22,717,1,LREM,198,7.825,31.7
2017,ISERE,Tignieu-Jameyzieu,930,191,739,22,717,1,NPA,4,7.825,31.7
2017,ISERE,Tignieu-Jameyzieu,930,191,739,22,717,1,PCF,13,7.825,31.7
2017,ISERE,Tignieu-Jameyzieu,930,191,739,22,717,1,REC,64,7.825,31.7
2017,ISERE,Tignieu-Jameyzieu,930,191,739,22,717,1,RES,16,7.825,31.7
2017,ISERE,Roussillon,930,320,610,10,600,1,EELV,7,7.825,31.7
2017,ISERE,Roussillon,930,320,610,10,600,1,FN,204,7.825,31.7
2017,ISERE,Roussillon,930,320,610,10,600,1,LFI,164,7.825,31.7
2017,ISERE,Roussillon,930,320,610,10,600,1,LO,11,7.825,31.7
2017,ISERE,Roussillon,930,320,610,10,600,1,LR,12,7.825,31.7
2017,ISERE,Roussillon,930,320,610,10,600,1,LREM,122,7.825,31.7
2017,ISERE,Roussillon,930,320,610,10,600,1,NPA,6,7.825,31.7
2017,ISERE,Roussillon,930,320,610,10,600,1,PCF,25,7.825,31.7
2017,ISERE,Roussillon,930,320,610,10,600,1,REC,24,7.825,31.7
2017,ISERE,Roussillon,930,320,610,10,600,1,RES,10,7.825,31.7
2017,ISERE,La Buisse,931,171,760,26,734,1,EELV,52,7.825,31.7
2017,ISERE,La Buisse,931,171,760,26,734,1,FN,116,7.825,31.7
2017,ISERE,La Buisse,931,171,760,26,734,1,LFI,159,7.825,31.7
2017,ISERE,La Buisse,931,171,760,26,734,1,LO,3,7.825,31.7
2017,ISERE,La Buisse,931,171,760,26,734,1,LR,32,7.825,31.7
2017,ISERE,La Buisse,931,171,760,26,734,1,LREM,271,7.825,31.7
2017,ISERE,La Buisse,931,171,760,26,734,1,NPA,2,7.825,31.7
2017,ISERE,La Buisse,931,171,760,26,734,1,PCF,21,7.825,31.7
2017,ISERE,La Buisse,931,171,760,26,734,1,REC,40,7.825,31.7
2017,ISERE,La Buisse,931,171,760,26,734,1,RES,13,7.825,31.7
2017,ISERE,Tignieu-Jameyzieu,931,203,728,15,713,1,EELV,31,7.825,31.7
2017,ISERE,Tignieu-Jameyzieu,931,203,728,15,713,1,FN,196,7.825,31.7
2017,ISERE,Tignieu-Jameyzieu,931,203,728,15,713,1,LFI,119,7.825,31.7
2017,ISERE,Tignieu-Jameyzieu,931,203,728,15,713,1,LO,3,7.825,31.7
2017,ISERE,Tignieu-Jameyzieu,931,203,728,15,713,1,LR,35,7.825,31.7
2017,ISERE,Tignieu-Jameyzieu,931,203,728,15,713,1,LREM,190,7.825,31.7
2017,ISERE,Tignieu-Jameyzieu,931,203,728,15,713,1,NPA,6,7.825,31.7
2017,ISERE,Tignieu-Jameyzieu,931,203,728,15,713,1,PCF,14,7.825,31.7
2017,ISERE,Tignieu-Jameyzieu,931,203,728,15,713,1,REC,67,7.825,31.7
2017,ISERE,Tignieu-Jameyzieu,931,203,728,15,713,1,RES,22,7.825,31.7
2017,ISERE,La Mure,931,253,678,21,657,1,EELV,17,7.825,31.7
2017,ISERE,La Mure,931,253,678,21,657,1,FN,153,7.825,31.7
2017,ISERE,La Mure,931,253,678,21,657,1,LFI,158,7.825,31.7
2017,ISERE,La Mure,931,253,678,21,657,1,LO,6,7.825,31.7
2017,ISERE,La Mure,931,253,678,21,657,1,LR,23,7.825,31.7
2017,ISERE,La Mure,931,253,678,21,657,1,LREM,164,7.825,31.7
2017,ISERE,La Mure,931,253,678,21,657,1,NPA,13,7.825,31.7
2017,ISERE,La Mure,931,253,678,21,657,1,PCF,18,7.825,31.7
2017,ISERE,La Mure,931,253,678,21,657,1,REC,63,7.825,31.7
2017,ISERE,La Mure,931,253,678,21,657,1,RES,16,7.825,31.7
2017,ISERE,Seyssuel,932,158,774,10,764,1,EELV,49,7.825,31.7
2017,ISERE,Seyssuel,932,158,774,10,764,1,FN,155,7.825,31.7
2017,ISERE,Seyssuel,932,158,774,10,764,1,LFI,99,7.825,31.7
2017,ISERE,Seyssuel,932,158,774,10,764,1,LO,1,7.825,31.7
2017,ISERE,Seyssuel,932,158,774,10,764,1,LR,48,7.825,31.7
2017,ISERE,Seyssuel,932,158,774,10,764,1,LREM,274,7.825,31.7
2017,ISERE,Seyssuel,932,158,774,10,764,1,NPA,6,7.825,31.7
2017,ISERE,Seyssuel,932,158,774,10,764,1,PCF,15,7.825,31.7
2017,ISERE,Seyssuel,932,158,774,10,764,1,REC,60,7.825,31.7
2017,ISERE,Seyssuel,932,158,774,10,764,1,RES,21,7.825,31.7
2017,ISERE,Bourgoin-Jallieu,932,278,654,20,634,1,EELV,23,7.825,31.7
2017,ISERE,Bourgoin-Jallieu,932,278,654,20,634,1,FN,115,7.825,31.7
2017,ISERE,Bourgoin-Jallieu,932,278,654,20,634,1,LFI,158,7.825,31.7
2017,ISERE,Bourgoin-Jallieu,932,278,654,20,634,1,LO,5,7.825,31.7
2017,ISERE,Bourgoin-Jallieu,932,278,654,20,634,1,LR,30,7.825,31.7
2017,ISERE,Bourgoin-Jallieu,932,278,654,20,634,1,LREM,178,7.825,31.7
2017,ISERE,Bourgoin-Jallieu,932,278,654,20,634,1,NPA,2,7.825,31.7
2017,ISERE,Bourgoin-Jallieu,932,278,654,20,634,1,PCF,16,7.825,31.7
2017,ISERE,Bourgoin-Jallieu,932,278,654,20,634,1,REC,50,7.825,31.7
2017,ISERE,Bourgoin-Jallieu,932,278,654,20,634,1,RES,27,7.825,31.7
2017,ISERE,Seyssins,933,205,728,13,715,1,EELV,43,7.825,31.7
2017,ISERE,Seyssins,933,205,728,13,715,1,FN,186,7.825,31.7
2017,ISERE,Seyssins,933,205,728,13,715,1,LFI,136,7.825,31.7
2017,ISERE,Seyssins,933,205,728,13,715,1,LO,4,7.825,31.7
2017,ISERE,Seyssins,933,205,728,13,715,1,LR,18,7.825,31.7
2017,ISERE,Seyssins,933,205,728,13,715,1,LREM,204,7.825,31.7
2017,ISERE,Seyssins,933,205,728,13,715,1,NPA,8,7.825,31.7
2017,ISERE,Seyssins,933,205,728,13,715,1,PCF,17,7.825,31.7
2017,ISERE,Seyssins,933,205,728,13,715,1,REC,53,7.825,31.7
2017,ISERE,Seyssins,933,205,728,13,715,1,RES,20,7.825,31.7
2017,ISERE,Saint-Egrève,933,212,721,8,713,1,EELV,59,7.825,31.7
2017,ISERE,Saint-Egrève,933,212,721,8,713,1,FN,111,7.825,31.7
2017,ISERE,Saint-Egrève,933,212,721,8,713,1,LFI,193,7.825,31.7
2017,ISERE,Saint-Egrève,933,212,721,8,713,1,LO,4,7.825,31.7
2017,ISERE,Saint-Egrève,933,212,721,8,713,1,LR,34,7.825,31.7
2017,ISERE,Saint-Egrève,933,212,721,8,713,1,LREM,202,7.825,31.7
2017,ISERE,Saint-Egrève,933,212,721,8,713,1,NPA,5,7.825,31.7
2017,ISERE,Saint-Egrève,933,212,721,8,713,1,PCF,22,7.825,31.7
2017,ISERE,Saint-Egrève,933,212,721,8,713,1,REC,33,7.825,31.7
2017,ISERE,Saint-Egrève,933,212,721,8,713,1,RES,17,7.825,31.7
2017,ISERE,Grenoble,934,252,682,7,675,1,EELV,57,7.825,31.7
2017,ISERE,Grenoble,934,252,682,7,675,1,FN,60,7.825,31.7
2017,ISERE,Grenoble,934,252,682,7,675,1,LFI,259,7.825,31.7
2017,ISERE,Grenoble,934,252,682,7,675,1,LO,2,7.825,31.7
2017,ISERE,Grenoble,934,252,682,7,675,1,LR,23,7.825,31.7
2017,ISERE,Grenoble,934,252,682,7,675,1,LREM,188,7.825,31.7
2017,ISERE,Grenoble,934,252,682,7,675,1,NPA,6,7.825,31.7
2017,ISERE,Grenoble,934,252,682,7,675,1,PCF,18,7.825,31.7
2017,ISERE,Grenoble,934,252,682,7,675,1,REC,26,7.825,31.7
2017,ISERE,Grenoble,934,252,682,7,675,1,RES,11,7.825,31.7
2017,ISERE,Chavanoz,935,260,675,14,661,1,EELV,11,7.825,31.7
2017,ISERE,Chavanoz,935,260,675,14,661,1,FN,185,7.825,31.7
2017,ISERE,Chavanoz,935,260,675,14,661,1,LFI,246,7.825,31.7
2017,ISERE,Chavanoz,935,260,675,14,661,1,LO,2,7.825,31.7
2017,ISERE,Chavanoz,935,260,675,14,661,1,LR,18,7.825,31.7
2017,ISERE,Chavanoz,935,260,675,14,661,1,LREM,102,7.825,31.7
2017,ISERE,Chavanoz,935,260,675,14,661,1,NPA,1,7.825,31.7
2017,ISERE,Chavanoz,935,260,675,14,661,1,PCF,8,7.825,31.7
2017,ISERE,Chavanoz,935,260,675,14,661,1,REC,50,7.825,31.7
2017,ISERE,Chavanoz,935,260,675,14,661,1,RES,12,7.825,31.7
2017,ISERE,Saint-Egrève,938,217,721,17,704,1,EELV,46,7.825,31.7
2017,ISERE,Saint-Egrève,938,217,721,17,704,1,FN,104,7.825,31.7
2017,ISERE,Saint-Egrève,938,217,721,17,704,1,LFI,196,7.825,31.7
2017,ISERE,Saint-Egrève,938,217,721,17,704,1,LO,1,7.825,31.7
2017,ISERE,Saint-Egrève,938,217,721,17,704,1,LR,25,7.825,31.7
2017,ISERE,Saint-Egrève,938,217,721,17,704,1,LREM,203,7.825,31.7
2017,ISERE,Saint-Egrève,938,217,721,17,704,1,NPA,4,7.825,31.7
2017,ISERE,Saint-Egrève,938,217,721,17,704,1,PCF,18,7.825,31.7
2017,ISERE,Saint-Egrève,938,217,721,17,704,1,REC,54,7.825,31.7
2017,ISERE,Saint-Egrève,938,217,721,17,704,1,RES,18,7.825,31.7
2017,ISERE,Echirolles,941,272,669,9,660,1,EELV,22,7.825,31.7
2017,ISERE,Echirolles,941,272,669,9,660,1,FN,124,7.825,31.7
2017,ISERE,Echirolles,941,272,669,9,660,1,LFI,255,7.825,31.7
2017,ISERE,Echirolles,941,272,669,9,660,1,LO,2,7.825,31.7
2017,ISERE,Echirolles,941,272,669,9,660,1,LR,7,7.825,31.7
2017,ISERE,Echirolles,941,272,669,9,660,1,LREM,152,7.825,31.7
2017,ISERE,Echirolles,941,272,669,9,660,1,NPA,5,7.825,31.7
2017,ISERE,Echirolles,941,272,669,9,660,1,PCF,24,7.825,31.7
2017,ISERE,Echirolles,941,272,669,9,660,1,REC,37,7.825,31.7
2017,ISERE,Echirolles,941,272,669,9,660,1,RES,10,7.825,31.7
2017,ISERE,Rochetoirin,942,180,762,15,747,1,EELV,53,7.825,31.7
2017,ISERE,Rochetoirin,942,180,762,15,747,1,FN,234,7.825,31.7
2017,ISERE,Rochetoirin,942,180,762,15,747,1,LFI,127,7.825,31.7
2017,ISERE,Rochetoirin,942,180,762,15,747,1,LO,1,7.825,31.7
2017,ISERE,Rochetoirin,942,180,762,15,747,1,LR,36,7.825,31.7
2017,ISERE,Rochetoirin,942,180,762,15,747,1,LREM,154,7.825,31.7
2017,ISERE,Rochetoirin,942,180,762,15,747,1,NPA,5,7.825,31.7
2017,ISERE,Rochetoirin,942,180,762,15,747,1,PCF,17,7.825,31.7
2017,ISERE,Rochetoirin,942,180,762,15,747,1,REC,61,7.825,31.7
2017,ISERE,Rochetoirin,942,180,762,15,747,1,RES,35,7.825,31.7
2017,ISERE,La Tour-du-Pin,942,324,618,8,610,1,EELV,27,7.825,31.7
2017,ISERE,La Tour-du-Pin,942,324,618,8,610,1,FN,150,7.825,31.7
2017,ISERE,La Tour-du-Pin,942,324,618,8,610,1,LFI,139,7.825,31.7
2017,ISERE,La Tour-du-Pin,942,324,618,8,610,1,LO,3,7.825,31.7
2017,ISERE,La Tour-du-Pin,942,324,618,8,610,1,LR,45,7.825,31.7
2017,ISERE,La Tour-du-Pin,942,324,618,8,610,1,LREM,141,7.825,31.7
2017,ISERE,La Tour-du-Pin,942,324,618,8,610,1,NPA,3,7.825,31.7
2017,ISERE,La Tour-du-Pin,942,324,618,8,610,1,PCF,11,7.825,31.7
2017,ISERE,La Tour-du-Pin,942,324,618,8,610,1,REC,44,7.825,31.7
2017,ISERE,La Tour-du-Pin,942,324,618,8,610,1,RES,20,7.825,31.7
2017,ISERE,Saint-Chef,943,199,744,20,724,1,EELV,29,7.825,31.7
2017,ISERE,Saint-Chef,943,199,744,20,724,1,FN,240,7.825,31.7
2017,ISERE,Saint-Chef,943,199,744,20,724,1,LFI,107,7.825,31.7
2017,ISERE,Saint-Chef,943,199,744,20,724,1,LO,0,7.825,31.7
2017,ISERE,Saint-Chef,943,199,744,20,724,1,LR,42,7.825,31.7
2017,ISERE,Saint-Chef,943,199,744,20,724,1,LREM,179,7.825,31.7
2017,ISERE,Saint-Chef,943,199,744,20,724,1,NPA,4,7.825,31.7
2017,ISERE,Saint-Chef,943,199,744,20,724,1,PCF,15,7.825,31.7
2017,ISERE,Saint-Chef,943,199,744,20,724,1,REC,56,7.825,31.7
2017,ISERE,Saint-Chef,943,199,744,20,724,1,RES,23,7.825,31.7
2017,ISERE,Le Versoud,944,146,798,26,772,1,EELV,51,7.825,31.7
2017,ISERE,Le Versoud,944,146,798,26,772,1,FN,188,7.825,31.7
2017,ISERE,Le Versoud,944,146,798,26,772,1,LFI,181,7.825,31.7
2017,ISERE,Le Versoud,944,146,798,26,772,1,LO,4,7.825,31.7
2017,ISERE,Le Versoud,944,146,798,26,772,1,LR,31,7.825,31.7
2017,ISERE,Le Versoud,944,146,798,26,772,1,LREM,187,7.825,31.7
2017,ISERE,Le Versoud,944,146,798,26,772,1,NPA,7,7.825,31.7
2017,ISERE,Le Versoud,944,146,798,26,772,1,PCF,30,7.825,31.7
2017,ISERE,Le Versoud,944,146,798,26,772,1,REC,51,7.825,31.7
2017,ISERE,Le Versoud,944,146,798,26,772,1,RES,13,7.825,31.7
2017,ISERE,Vaulnaveys-le-Bas,944,152,792,16,776,1,EELV,53,7.825,31.7
2017,ISERE,Vaulnaveys-le-Bas,944,152,792,16,776,1,FN,187,7.825,31.7
2017,ISERE,Vaulnaveys-le-Bas,944,152,792,16,776,1,LFI,147,7.825,31.7
2017,ISERE,Vaulnaveys-le-Bas,944,152,792,16,776,1,LO,3,7.825,31.7
2017,ISERE,Vaulnaveys-le-Bas,944,152,792,16,776,1,LR,21,7.825,31.7
2017,ISERE,Vaulnaveys-le-Bas,944,152,792,16,776,1,LREM,232,7.825,31.7
2017,ISERE,Vaulnaveys-le-Bas,944,152,792,16,776,1,NPA,5,7.825,31.7
2017,ISERE,Vaulnaveys-le-Bas,944,152,792,16,776,1,PCF,15,7.825,31.7
2017,ISERE,Vaulnaveys-le-Bas,944,152,792,16,776,1,REC,59,7.825,31.7
2017,ISERE,Vaulnaveys-le-Bas,944,152,792,16,776,1,RES,29,7.825,31.7
2017,ISERE,Grenoble,944,153,791,7,784,1,EELV,96,7.825,31.7
2017,ISERE,Grenoble,944,153,791,7,784,1,FN,55,7.825,31.7
2017,ISERE,Grenoble,944,153,791,7,784,1,LFI,229,7.825,31.7
2017,ISERE,Grenoble,944,153,791,7,784,1,LO,0,7.825,31.7
2017,ISERE,Grenoble,944,153,791,7,784,1,LR,34,7.825,31.7
2017,ISERE,Grenoble,944,153,791,7,784,1,LREM,262,7.825,31.7
2017,ISERE,Grenoble,944,153,791,7,784,1,NPA,0,7.825,31.7
2017,ISERE,Grenoble,944,153,791,7,784,1,PCF,24,7.825,31.7
2017,ISERE,Grenoble,944,153,791,7,784,1,REC,49,7.825,31.7
2017,ISERE,Grenoble,944,153,791,7,784,1,RES,10,7.825,31.7
2017,ISERE,Sassenage,947,154,793,14,779,1,EELV,55,7.825,31.7
2017,ISERE,Sassenage,947,154,793,14,779,1,FN,192,7.825,31.7
2017,ISERE,Sassenage,947,154,793,14,779,1,LFI,139,7.825,31.7
2017,ISERE,Sassenage,947,154,793,14,779,1,LO,6,7.825,31.7
2017,ISERE,Sassenage,947,154,793,14,779,1,LR,30,7.825,31.7
2017,ISERE,Sassenage,947,154,793,14,779,1,LREM,215,7.825,31.7
2017,ISERE,Sassenage,947,154,793,14,779,1,NPA,3,7.825,31.7
2017,ISERE,Sassenage,947,154,793,14,779,1,PCF,19,7.825,31.7
2017,ISERE,Sassenage,947,154,793,14,779,1,REC,51,7.825,31.7
2017,ISERE,Sassenage,947,154,793,14,779,1,RES,20,7.825,31.7
2017,ISERE,Saint-Martin-d'Hères,947,233,714,17,697,1,EELV,68,7.825,31.7
2017,ISERE,Saint-Martin-d'Hères,947,233,714,17,697,1,FN,107,7.825,31.7
2017,ISERE,Saint-Martin-d'Hères,947,233,714,17,697,1,LFI,258,7.825,31.7
2017,ISERE,Saint-Martin-d'Hères,947,233,714,17,697,1,LO,3,7.825,31.7
2017,ISERE,Saint-Martin-d'Hères,947,233,714,17,697,1,LR,16,7.825,31.7
2017,ISERE,Saint-Martin-d'Hères,947,233,714,17,697,1,LREM,144,7.825,31.7
2017,ISERE,Saint-Martin-d'Hères,947,233,714,17,697,1,NPA,4,7.825,31.7
2017,ISERE,Saint-Martin-d'Hères,947,233,714,17,697,1,PCF,12,7.825,31.7
2017,ISERE,Saint-Martin-d'Hères,947,233,714,17,697,1,REC,45,7.825,31.7
2017,ISERE,Saint-Martin-d'Hères,947,233,714,17,697,1,RES,13,7.825,31.7
2017,ISERE,Morestel,948,236,712,18,694,1,EELV,22,7.825,31.7
2017,ISERE,Morestel,948,236,712,18,694,1,FN,183,7.825,31.7
2017,ISERE,Morestel,948,236,712,18,694,1,LFI,125,7.825,31.7
2017,ISERE,Morestel,948,236,712,18,694,1,LO,2,7.825,31.7
2017,ISERE,Morestel,948,236,712,18,694,1,LR,37,7.825,31.7
2017,ISERE,Morestel,948,236,712,18,694,1,LREM,192,7.825,31.7
2017,ISERE,Morestel,948,236,712,18,694,1,NPA,6,7.825,31.7
2017,ISERE,Morestel,948,236,712,18,694,1,PCF,13,7.825,31.7
2017,ISERE,Morestel,948,236,712,18,694,1,REC,63,7.825,31.7
2017,ISERE,Morestel,948,236,712,18,694,1,RES,20,7.825,31.7
2017,ISERE,Notre-Dame-de-Mésage,949,181,768,26,742,1,EELV,48,7.825,31.7
2017,ISERE,Notre-Dame-de-Mésage,949,181,768,26,742,1,FN,177,7.825,31.7
2017,ISERE,Notre-Dame-de-Mésage,949,181,768,26,742,1,LFI,170,7.825,31.7
2017,ISERE,Notre-Dame-de-Mésage,949,181,768,26,742,1,LO,5,7.825,31.7
2017,ISERE,Notre-Dame-de-Mésage,949,181,768,26,742,1,LR,18,7.825,31.7
2017,ISERE,Notre-Dame-de-Mésage,949,181,768,26,742,1,LREM,191,7.825,31.7
2017,ISERE,Notre-Dame-de-Mésage,949,181,768,26,742,1,NPA,6,7.825,31.7
2017,ISERE,Notre-Dame-de-Mésage,949,181,768,26,742,1,PCF,16,7.825,31.7
2017,ISERE,Notre-Dame-de-Mésage,949,181,768,26,742,1,REC,59,7.825,31.7
2017,ISERE,Notre-Dame-de-Mésage,949,181,768,26,742,1,RES,17,7.825,31.7
2017,ISERE,Saint-Cassien,950,175,775,17,758,1,EELV,50,7.825,31.7
2017,ISERE,Saint-Cassien,950,175,775,17,758,1,FN,162,7.825,31.7
2017,ISERE,Saint-Cassien,950,175,775,17,758,1,LFI,131,7.825,31.7
2017,ISERE,Saint-Cassien,950,175,775,17,758,1,LO,4,7.825,31.7
2017,ISERE,Saint-Cassien,950,175,775,17,758,1,LR,37,7.825,31.7
2017,ISERE,Saint-Cassien,950,175,775,17,758,1,LREM,251,7.825,31.7
2017,ISERE,Saint-Cassien,950,175,775,17,758,1,NPA,1,7.825,31.7
2017,ISERE,Saint-Cassien,950,175,775,17,758,1,PCF,7,7.825,31.7
2017,ISERE,Saint-Cassien,950,175,775,17,758,1,REC,77,7.825,31.7
2017,ISERE,Saint-Cassien,950,175,775,17,758,1,RES,20,7.825,31.7
2017,ISERE,Eybens,950,208,742,16,726,1,EELV,64,7.825,31.7
2017,ISERE,Eybens,950,208,742,16,726,1,FN,125,7.825,31.7
2017,ISERE,Eybens,950,208,742,16,726,1,LFI,182,7.825,31.7
2017,ISERE,Eybens,950,208,742,16,726,1,LO,4,7.825,31.7
2017,ISERE,Eybens,950,208,742,16,726,1,LR,30,7.825,31.7
2017,ISERE,Eybens,950,208,742,16,726,1,LREM,215,7.825,31.7
2017,ISERE,Eybens,950,208,742,16,726,1,NPA,2,7.825,31.7
2017,ISERE,Eybens,950,208,742,16,726,1,PCF,17,7.825,31.7
2017,ISERE,Eybens,950,208,742,16,726,1,REC,39,7.825,31.7
2017,ISERE,Eybens,950,208,742,16,726,1,RES,14,7.825,31.7
2017,ISERE,Bernin,951,186,765,7,758,1,EELV,71,7.825,31.7
2017,ISERE,Bernin,951,186,765,7,758,1,FN,98,7.825,31.7
2017,ISERE,Bernin,951,186,765,7,758,1,LFI,137,7.825,31.7
2017,ISERE,Bernin,951,186,765,7,758,1,LO,3,7.825,31.7
2017,ISERE,Bernin,951,186,765,7,758,1,LR,42,7.825,31.7
2017,ISERE,Bernin,951,186,765,7,758,1,LREM,313,7.825,31.7
2017,ISERE,Bernin,951,186,765,7,758,1,NPA,4,7.825,31.7
2017,ISERE,Bernin,951,186,765,7,758,1,PCF,9,7.825,31.7
2017,ISERE,Bernin,951,186,765,7,758,1,REC,39,7.825,31.7
2017,ISERE,Bernin,951,186,765,7,758,1,RES,14,7.825,31.7
2017,ISERE,Bernin,952,180,772,20,752,1,EELV,72,7.825,31.7
2017,ISERE,Bernin,952,180,772,20,752,1,FN,92,7.825,31.7
2017,ISERE,Bernin,952,180,772,20,752,1,LFI,128,7.825,31.7
2017,ISERE,Bernin,952,180,772,20,752,1,LO,2,7.825,31.7
2017,ISERE,Bernin,952,180,772,20,752,1,LR,41,7.825,31.7
2017,ISERE,Bernin,952,180,772,20,752,1,LREM,295,7.825,31.7
2017,ISERE,Bernin,952,180,772,20,752,1,NPA,4,7.825,31.7
2017,ISERE,Bernin,952,180,772,20,752,1,PCF,11,7.825,31.7
2017,ISERE,Bernin,952,180,772,20,752,1,REC,62,7.825,31.7
2017,ISERE,Bernin,952,180,772,20,752,1,RES,18,7.825,31.7
2017,ISERE,Sassenage,952,207,745,16,729,1,EELV,20,7.825,31.7
2017,ISERE,Sassenage,952,207,745,16,729,1,FN,235,7.825,31.7
2017,ISERE,Sassenage,952,207,745,16,729,1,LFI,171,7.825,31.7
2017,ISERE,Sassenage,952,207,745,16,729,1,LO,4,7.825,31.7
2017,ISERE,Sassenage,952,207,745,16,729,1,LR,18,7.825,31.7
2017,ISERE,Sassenage,952,207,745,16,729,1,LREM,163,7.825,31.7
2017,ISERE,Sassenage,952,207,745,16,729,1,NPA,5,7.825,31.7
2017,ISERE,Sassenage,952,207,745,16,729,1,PCF,21,7.825,31.7
2017,ISERE,Sassenage,952,207,745,16,729,1,REC,45,7.825,31.7
2017,ISERE,Sassenage,952,207,745,16,729,1,RES,17,7.825,31.7
2017,ISERE,Meyrié,953,130,823,26,797,1,EELV,63,7.825,31.7
2017,ISERE,Meyrié,953,130,823,26,797,1,FN,159,7.825,31.7
2017,ISERE,Meyrié,953,130,823,26,797,1,LFI,137,7.825,31.7
2017,ISERE,Meyrié,953,130,823,26,797,1,LO,1,7.825,31.7
2017,ISERE,Meyrié,953,130,823,26,797,1,LR,34,7.825,31.7
2017,ISERE,Meyrié,953,130,823,26,797,1,LREM,255,7.825,31.7
2017,ISERE,Meyrié,953,130,823,26,797,1,NPA,9,7.825,31.7
2017,ISERE,Meyrié,953,130,823,26,797,1,PCF,19,7.825,31.7
2017,ISERE,Meyrié,953,130,823,26,797,1,REC,68,7.825,31.7
2017,ISERE,Meyrié,953,130,823,26,797,1,RES,24,7.825,31.7
2017,ISERE,Bourgoin-Jallieu,953,315,638,9,629,1,EELV,23,7.825,31.7
2017,ISERE,Bourgoin-Jallieu,953,315,638,9,629,1,FN,151,7.825,31.7
2017,ISERE,Bourgoin-Jallieu,953,315,638,9,629,1,LFI,160,7.825,31.7
2017,ISERE,Bourgoin-Jallieu,953,315,638,9,629,1,LO,2,7.825,31.7
2017,ISERE,Bourgoin-Jallieu,953,315,638,9,629,1,LR,31,7.825,31.7
2017,ISERE,Bourgoin-Jallieu,953,315,638,9,629,1,LREM,155,7.825,31.7
2017,ISERE,Bourgoin-Jallieu,953,315,638,9,629,1,NPA,3,7.825,31.7
2017,ISERE,Bourgoin-Jallieu,953,315,638,9,629,1,PCF,14,7.825,31.7
2017,ISERE,Bourgoin-Jallieu,953,315,638,9,629,1,REC,50,7.825,31.7
2017,ISERE,Bourgoin-Jallieu,953,315,638,9,629,1,RES,16,7.825,31.7
2017,ISERE,L'Albenc,954,212,742,21,721,1,EELV,35,7.825,31.7
2017,ISERE,L'Albenc,954,212,742,21,721,1,FN,195,7.825,31.7
2017,ISERE,L'Albenc,954,212,742,21,721,1,LFI,153,7.825,31.7
2017,ISERE,L'Albenc,954,212,742,21,721,1,LO,5,7.825,31.7
2017,ISERE,L'Albenc,954,212,742,21,721,1,LR,27,7.825,31.7
2017,ISERE,L'Albenc,954,212,742,21,721,1,LREM,173,7.825,31.7
2017,ISERE,L'Albenc,954,212,742,21,721,1,NPA,8,7.825,31.7
2017,ISERE,L'Albenc,954,212,742,21,721,1,PCF,23,7.825,31.7
2017,ISERE,L'Albenc,954,212,742,21,721,1,REC,53,7.825,31.7
2017,ISERE,L'Albenc,954,212,742,21,721,1,RES,19,7.825,31.7
2017,ISERE,Saint-Victor-de-Morestel,954,238,716,22,694,1,EELV,27,7.825,31.7
2017,ISERE,Saint-Victor-de-Morestel,954,238,716,22,694,1,FN,249,7.825,31.7
2017,ISERE,Saint-Victor-de-Morestel,954,238,716,22,694,1,LFI,124,7.825,31.7
2017,ISERE,Saint-Victor-de-Morestel,954,238,716,22,694,1,LO,8,7.825,31.7
2017,ISERE,Saint-Victor-de-Morestel,954,238,716,22,694,1,LR,28,7.825,31.7
2017,ISERE,Saint-Victor-de-Morestel,954,238,716,22,694,1,LREM,135,7.825,31.7
2017,ISERE,Saint-Victor-de-Morestel,954,238,716,22,694,1,NPA,6,7.825,31.7
2017,ISERE,Saint-Victor-de-Morestel,954,238,716,22,694,1,PCF,8,7.825,31.7
2017,ISERE,Saint-Victor-de-Morestel,954,238,716,22,694,1,REC,59,7.825,31.7
2017,ISERE,Saint-Victor-de-Morestel,954,238,716,22,694,1,RES,25,7.825,31.7
2017,ISERE,Eybens,955,268,687,22,665,1,EELV,34,7.825,31.7
2017,ISERE,Eybens,955,268,687,22,665,1,FN,143,7.825,31.7
2017,ISERE,Eybens,955,268,687,22,665,1,LFI,216,7.825,31.7
2017,ISERE,Eybens,955,268,687,22,665,1,LO,9,7.825,31.7
2017,ISERE,Eybens,955,268,687,22,665,1,LR,12,7.825,31.7
2017,ISERE,Eybens,955,268,687,22,665,1,LREM,134,7.825,31.7
2017,ISERE,Eybens,955,268,687,22,665,1,NPA,5,7.825,31.7
2017,ISERE,Eybens,955,268,687,22,665,1,PCF,21,7.825,31.7
2017,ISERE,Eybens,955,268,687,22,665,1,REC,41,7.825,31.7
2017,ISERE,Eybens,955,268,687,22,665,1,RES,19,7.825,31.7
2017,ISERE,Grenoble,956,193,763,13,750,1,EELV,70,7.825,31.7
2017,ISERE,Grenoble,956,193,763,13,750,1,FN,67,7.825,31.7
2017,ISERE,Grenoble,956,193,763,13,750,1,LFI,252,7.825,31.7
2017,ISERE,Grenoble,956,193,763,13,750,1,LO,5,7.825,31.7
2017,ISERE,Grenoble,956,193,763,13,750,1,LR,30,7.825,31.7
2017,ISERE,Grenoble,956,193,763,13,750,1,LREM,224,7.825,31.7
2017,ISERE,Grenoble,956,193,763,13,750,1,NPA,7,7.825,31.7
2017,ISERE,Grenoble,956,193,763,13,750,1,PCF,21,7.825,31.7
2017,ISERE,Grenoble,956,193,763,13,750,1,REC,45,7.825,31.7
2017,ISERE,Grenoble,956,193,763,13,750,1,RES,8,7.825,31.7
2017,ISERE,Tullins,956,233,723,7,716,1,EELV,42,7.825,31.7
2017,ISERE,Tullins,956,233,723,7,716,1,FN,144,7.825,31.7
2017,ISERE,Tullins,956,233,723,7,716,1,LFI,204,7.825,31.7
2017,ISERE,Tullins,956,233,723,7,716,1,LO,4,7.825,31.7
2017,ISERE,Tullins,956,233,723,7,716,1,LR,19,7.825,31.7
2017,ISERE,Tullins,956,233,723,7,716,1,LREM,189,7.825,31.7
2017,ISERE,Tullins,956,233,723,7,716,1,NPA,9,7.825,31.7
2017,ISERE,Tullins,956,233,723,7,716,1,PCF,15,7.825,31.7
2017,ISERE,Tullins,956,233,723,7,716,1,REC,46,7.825,31.7
2017,ISERE,Tullins,956,233,723,7,716,1,RES,23,7.825,31.7
2017,ISERE,Moirans,957,272,685,18,667,1,EELV,51,7.825,31.7
2017,ISERE,Moirans,957,272,685,18,667,1,FN,149,7.825,31.7
2017,ISERE,Moirans,957,272,685,18,667,1,LFI,215,7.825,31.7
2017,ISERE,Moirans,957,272,685,18,667,1,LO,4,7.825,31.7
2017,ISERE,Moirans,957,272,685,18,667,1,LR,19,7.825,31.7
2017,ISERE,Moirans,957,272,685,18,667,1,LREM,148,7.825,31.7
2017,ISERE,Moirans,957,272,685,18,667,1,NPA,6,7.825,31.7
2017,ISERE,Moirans,957,272,685,18,667,1,PCF,10,7.825,31.7
2017,ISERE,Moirans,957,272,685,18,667,1,REC,30,7.825,31.7
2017,ISERE,Moirans,957,272,685,18,667,1,RES,15,7.825,31.7
2017,ISERE,Saint-Martin-d'Uriage,958,154,804,10,794,1,EELV,75,7.825,31.7
2017,ISERE,Saint-Martin-d'Uriage,958,154,804,10,794,1,FN,83,7.825,31.7
2017,ISERE,Saint-Martin-d'Uriage,958,154,804,10,794,1,LFI,171,7.825,31.7
2017,ISERE,Saint-Martin-d'Uriage,958,154,804,10,794,1,LO,1,7.825,31.7
2017,ISERE,Saint-Martin-d'Uriage,958,154,804,10,794,1,LR,34,7.825,31.7
2017,ISERE,Saint-Martin-d'Uriage,958,154,804,10,794,1,LREM,329,7.825,31.7
2017,ISERE,Saint-Martin-d'Uriage,958,154,804,10,794,1,NPA,5,7.825,31.7
2017,ISERE,Saint-Martin-d'Uriage,958,154,804,10,794,1,PCF,12,7.825,31.7
2017,ISERE,Saint-Martin-d'Uriage,958,154,804,10,794,1,REC,41,7.825,31.7
2017,ISERE,Saint-Martin-d'Uriage,958,154,804,10,794,1,RES,13,7.825,31.7
2017,ISERE,Bernin,958,156,802,11,791,1,EELV,83,7.825,31.7
2017,ISERE,Bernin,958,156,802,11,791,1,FN,99,7.825,31.7
2017,ISERE,Bernin,958,156,802,11,791,1,LFI,133,7.825,31.7
2017,ISERE,Bernin,958,156,802,11,791,1,LO,5,7.825,31.7
2017,ISERE,Bernin,958,156,802,11,791,1,LR,43,7.825,31.7
2017,ISERE,Bernin,958,156,802,11,791,1,LREM,319,7.825,31.7
2017,ISERE,Bernin,958,156,802,11,791,1,NPA,1,7.825,31.7
2017,ISERE,Bernin,958,156,802,11,791,1,PCF,9,7.825,31.7
2017,ISERE,Bernin,958,156,802,11,791,1,REC,58,7.825,31.7
2017,ISERE,Bernin,958,156,802,11,791,1,RES,11,7.825,31.7
2017,ISERE,Plateau des Petites Roches,958,181,777,8,769,1,EELV,122,7.825,31.7
2017,ISERE,Plateau des Petites Roches,958,181,777,8,769,1,FN,62,7.825,31.7
2017,ISERE,Plateau des Petites Roches,958,181,777,8,769,1,LFI,340,7.825,31.7
2017,ISERE,Plateau des Petites Roches,958,181,777,8,769,1,LO,2,7.825,31.7
2017,ISERE,Plateau des Petites Roches,958,181,777,8,769,1,LR,23,7.825,31.7
2017,ISERE,Plateau des Petites Roches,958,181,777,8,769,1,LREM,133,7.825,31.7
2017,ISERE,Plateau des Petites Roches,958,181,777,8,769,1,NPA,4,7.825,31.7
2017,ISERE,Plateau des Petites Roches,958,181,777,8,769,1,PCF,12,7.825,31.7
2017,ISERE,Plateau des Petites Roches,958,181,777,8,769,1,REC,31,7.825,31.7
2017,ISERE,Plateau des Petites Roches,958,181,777,8,769,1,RES,13,7.825,31.7
2017,ISERE,Sassenage,960,125,835,19,816,1,EELV,78,7.825,31.7
2017,ISERE,Sassenage,960,125,835,19,816,1,FN,120,7.825,31.7
2017,ISERE,Sassenage,960,125,835,19,816,1,LFI,155,7.825,31.7
2017,ISERE,Sassenage,960,125,835,19,816,1,LO,4,7.825,31.7
2017,ISERE,Sassenage,960,125,835,19,816,1,LR,44,7.825,31.7
2017,ISERE,Sassenage,960,125,835,19,816,1,LREM,281,7.825,31.7
2017,ISERE,Sassenage,960,125,835,19,816,1,NPA,3,7.825,31.7
2017,ISERE,Sassenage,960,125,835,19,816,1,PCF,22,7.825,31.7
2017,ISERE,Sassenage,960,125,835,19,816,1,REC,63,7.825,31.7
2017,ISERE,Sassenage,960,125,835,19,816,1,RES,13,7.825,31.7
2017,ISERE,Grenoble,961,195,766,7,759,1,EELV,78,7.825,31.7
2017,ISERE,Grenoble,961,195,766,7,759,1,FN,39,7.825,31.7
2017,ISERE,Grenoble,961,195,766,7,759,1,LFI,276,7.825,31.7
2017,ISERE,Grenoble,961,195,766,7,759,1,LO,2,7.825,31.7
2017,ISERE,Grenoble,961,195,766,7,759,1,LR,24,7.825,31.7
2017,ISERE,Grenoble,961,195,766,7,759,1,LREM,237,7.825,31.7
2017,ISERE,Grenoble,961,195,766,7,759,1,NPA,6,7.825,31.7
2017,ISERE,Grenoble,961,195,766,7,759,1,PCF,9,7.825,31.7
2017,ISERE,Grenoble,961,195,766,7,759,1,REC,58,7.825,31.7
2017,ISERE,Grenoble,961,195,766,7,759,1,RES,9,7.825,31.7
2017,ISERE,Echirolles,961,210,751,16,735,1,EELV,59,7.825,31.7
2017,ISERE,Echirolles,961,210,751,16,735,1,FN,148,7.825,31.7
2017,ISERE,Echirolles,961,210,751,16,735,1,LFI,164,7.825,31.7
2017,ISERE,Echirolles,961,210,751,16,735,1,LO,4,7.825,31.7
2017,ISERE,Echirolles,961,210,751,16,735,1,LR,29,7.825,31.7
2017,ISERE,Echirolles,961,210,751,16,735,1,LREM,204,7.825,31.7
2017,ISERE,Echirolles,961,210,751,16,735,1,NPA,4,7.825,31.7
2017,ISERE,Echirolles,961,210,751,16,735,1,PCF,21,7.825,31.7
2017,ISERE,Echirolles,961,210,751,16,735,1,REC,63,7.825,31.7
2017,ISERE,Echirolles,961,210,751,16,735,1,RES,14,7.825,31.7
2017,ISERE,Domène,962,216,746,19,727,1,EELV,48,7.825,31.7
2017,ISERE,Domène,962,216,746,19,727,1,FN,175,7.825,31.7
2017,ISERE,Domène,962,216,746,19,727,1,LFI,164,7.825,31.7
2017,ISERE,Domène,962,216,746,19,727,1,LO,2,7.825,31.7
2017,ISERE,Domène,962,216,746,19,727,1,LR,25,7.825,31.7
2017,ISERE,Domène,962,216,746,19,727,1,LREM,195,7.825,31.7
2017,ISERE,Domène,962,216,746,19,727,1,NPA,5,7.825,31.7
2017,ISERE,Domène,962,216,746,19,727,1,PCF,26,7.825,31.7
2017,ISERE,Domène,962,216,746,19,727,1,REC,39,7.825,31.7
2017,ISERE,Domène,962,216,746,19,727,1,RES,22,7.825,31.7
2017,ISERE,Saint-Martin-d'Hères,962,229,733,15,718,1,EELV,34,7.825,31.7
2017,ISERE,Saint-Martin-d'Hères,962,229,733,15,718,1,FN,170,7.825,31.7
2017,ISERE,Saint-Martin-d'Hères,962,229,733,15,718,1,LFI,223,7.825,31.7
2017,ISERE,Saint-Martin-d'Hères,962,229,733,15,718,1,LO,2,7.825,31.7
2017,ISERE,Saint-Martin-d'Hères,962,229,733,15,718,1,LR,14,7.825,31.7
2017,ISERE,Saint-Martin-d'Hères,962,229,733,15,718,1,LREM,157,7.825,31.7
2017,ISERE,Saint-Martin-d'Hères,962,229,733,15,718,1,NPA,7,7.825,31.7
2017,ISERE,Saint-Martin-d'Hères,962,229,733,15,718,1,PCF,25,7.825,31.7
2017,ISERE,Saint-Martin-d'Hères,962,229,733,15,718,1,REC,49,7.825,31.7
2017,ISERE,Saint-Martin-d'Hères,962,229,733,15,718,1,RES,14,7.825,31.7
2017,ISERE,Grenoble,962,386,576,5,571,1,EELV,33,7.825,31.7
2017,ISERE,Grenoble,962,386,576,5,571,1,FN,32,7.825,31.7
2017,ISERE,Grenoble,962,386,576,5,571,1,LFI,379,7.825,31.7
2017,ISERE,Grenoble,962,386,576,5,571,1,LO,4,7.825,31.7
2017,ISERE,Grenoble,962,386,576,5,571,1,LR,3,7.825,31.7
2017,ISERE,Grenoble,962,386,576,5,571,1,LREM,77,7.825,31.7
2017,ISERE,Grenoble,962,386,576,5,571,1,NPA,7,7.825,31.7
2017,ISERE,Grenoble,962,386,576,5,571,1,PCF,14,7.825,31.7
2017,ISERE,Grenoble,962,386,576,5,571,1,REC,6,7.825,31.7
2017,ISERE,Grenoble,962,386,576,5,571,1,RES,4,7.825,31.7
2017,ISERE,Grenoble,963,297,666,17,649,1,EELV,38,7.825,31.7
2017,ISERE,Grenoble,963,297,666,17,649,1,FN,101,7.825,31.7
2017,ISERE,Grenoble,963,297,666,17,649,1,LFI,207,7.825,31.7
2017,ISERE,Grenoble,963,297,666,17,649,1,LO,2,7.825,31.7
2017,ISERE,Grenoble,963,297,666,17,649,1,LR,27,7.825,31.7
2017,ISERE,Grenoble,963,297,666,17,649,1,LREM,167,7.825,31.7
2017,ISERE,Grenoble,963,297,666,17,649,1,NPA,8,7.825,31.7
2017,ISERE,Grenoble,963,297,666,17,649,1,PCF,21,7.825,31.7
2017,ISERE,Grenoble,963,297,666,17,649,1,REC,43,7.825,31.7
2017,ISERE,Grenoble,963,297,666,17,649,1,RES,11,7.825,31.7
2017,ISERE,La Tour-du-Pin,963,356,607,15,592,1,EELV,29,7.825,31.7
2017,ISERE,La Tour-du-Pin,963,356,607,15,592,1,FN,136,7.825,31.7
2017,ISERE,La Tour-du-Pin,963,356,607,15,592,1,LFI,177,7.825,31.7
2017,ISERE,La Tour-du-Pin,963,356,607,15,592,1,LO,0,7.825,31.7
2017,ISERE,La Tour-du-Pin,963,356,607,15,592,1,LR,25,7.825,31.7
2017,ISERE,La Tour-du-Pin,963,356,607,15,592,1,LREM,144,7.825,31.7
2017,ISERE,La Tour-du-Pin,963,356,607,15,592,1,NPA,1,7.825,31.7
2017,ISERE,La Tour-du-Pin,963,356,607,15,592,1,PCF,6,7.825,31.7
2017,ISERE,La Tour-du-Pin,963,356,607,15,592,1,REC,47,7.825,31.7
2017,ISERE,La Tour-du-Pin,963,356,607,15,592,1,RES,10,7.825,31.7
2017,ISERE,Le Sappey-en-Chartreuse,964,127,837,5,832,1,EELV,122,7.825,31.7
2017,ISERE,Le Sappey-en-Chartreuse,964,127,837,5,832,1,FN,77,7.825,31.7
2017,ISERE,Le Sappey-en-Chartreuse,964,127,837,5,832,1,LFI,257,7.825,31.7
2017,ISERE,Le Sappey-en-Chartreuse,964,127,837,5,832,1,LO,2,7.825,31.7
2017,ISERE,Le Sappey-en-Chartreuse,964,127,837,5,832,1,LR,28,7.825,31.7
2017,ISERE,Le Sappey-en-Chartreuse,964,127,837,5,832,1,LREM,249,7.825,31.7
2017,ISERE,Le Sappey-en-Chartreuse,964,127,837,5,832,1,NPA,5,7.825,31.7
2017,ISERE,Le Sappey-en-Chartreuse,964,127,837,5,832,1,PCF,10,7.825,31.7
2017,ISERE,Le Sappey-en-Chartreuse,964,127,837,5,832,1,REC,33,7.825,31.7
2017,ISERE,Le Sappey-en-Chartreuse,964,127,837,5,832,1,RES,18,7.825,31.7
2017,ISERE,Le Grand-Lemps,965,179,786,11,775,1,EELV,37,7.825,31.7
2017,ISERE,Le Grand-Lemps,965,179,786,11,775,1,FN,220,7.825,31.7
2017,ISERE,Le Grand-Lemps,965,179,786,11,775,1,LFI,146,7.825,31.7
2017,ISERE,Le Grand-Lemps,965,179,786,11,775,1,LO,5,7.825,31.7
2017,ISERE,Le Grand-Lemps,965,179,786,11,775,1,LR,37,7.825,31.7
2017,ISERE,Le Grand-Lemps,965,179,786,11,775,1,LREM,216,7.825,31.7
2017,ISERE,Le Grand-Lemps,965,179,786,11,775,1,NPA,1,7.825,31.7
2017,ISERE,Le Grand-Lemps,965,179,786,11,775,1,PCF,25,7.825,31.7
2017,ISERE,Le Grand-Lemps,965,179,786,11,775,1,REC,50,7.825,31.7
2017,ISERE,Le Grand-Lemps,965,179,786,11,775,1,RES,12,7.825,31.7
2017,ISERE,Domène,965,210,755,17,738,1,EELV,36,7.825,31.7
2017,ISERE,Domène,965,210,755,17,738,1,FN,193,7.825,31.7
2017,ISERE,Domène,965,210,755,17,738,1,LFI,134,7.825,31.7
2017,ISERE,Domène,965,210,755,17,738,1,LO,8,7.825,31.7
2017,ISERE,Domène,965,210,755,17,738,1,LR,28,7.825,31.7
2017,ISERE,Domène,965,210,755,17,738,1,LREM,195,7.825,31.7
2017,ISERE,Domène,965,210,755,17,738,1,NPA,6,7.825,31.7
2017,ISERE,Domène,965,210,755,17,738,1,PCF,29,7.825,31.7
2017,ISERE,Domène,965,210,755,17,738,1,REC,68,7.825,31.7
2017,ISERE,Domène,965,210,755,17,738,1,RES,13,7.825,31.7
2017,ISERE,Saint-Martin-d'Hères,965,286,679,19,660,1,EELV,36,7.825,31.7
2017,ISERE,Saint-Martin-d'Hères,965,286,679,19,660,1,FN,115,7.825,31.7
2017,ISERE,Saint-Martin-d'Hères,965,286,679,19,660,1,LFI,261,7.825,31.7
2017,ISERE,Saint-Martin-d'Hères,965,286,679,19,660,1,LO,3,7.825,31.7
2017,ISERE,Saint-Martin-d'Hères,965,286,679,19,660,1,LR,17,7.825,31.7
2017,ISERE,Saint-Martin-d'Hères,965,286,679,19,660,1,LREM,129,7.825,31.7
2017,ISERE,Saint-Martin-d'Hères,965,286,679,19,660,1,NPA,8,7.825,31.7
2017,ISERE,Saint-Martin-d'Hères,965,286,679,19,660,1,PCF,27,7.825,31.7
2017,ISERE,Saint-Martin-d'Hères,965,286,679,19,660,1,REC,37,7.825,31.7
2017,ISERE,Saint-Martin-d'Hères,965,286,679,19,660,1,RES,9,7.825,31.7
2017,ISERE,Grenoble,967,207,760,11,749,1,EELV,63,7.825,31.7
2017,ISERE,Grenoble,967,207,760,11,749,1,FN,95,7.825,31.7
2017,ISERE,Grenoble,967,207,760,11,749,1,LFI,317,7.825,31.7
2017,ISERE,Grenoble,967,207,760,11,749,1,LO,1,7.825,31.7
2017,ISERE,Grenoble,967,207,760,11,749,1,LR,27,7.825,31.7
2017,ISERE,Grenoble,967,207,760,11,749,1,LREM,164,7.825,31.7
2017,ISERE,Grenoble,967,207,760,11,749,1,NPA,6,7.825,31.7
2017,ISERE,Grenoble,967,207,760,11,749,1,PCF,13,7.825,31.7
2017,ISERE,Grenoble,967,207,760,11,749,1,REC,24,7.825,31.7
2017,ISERE,Grenoble,967,207,760,11,749,1,RES,21,7.825,31.7
2017,ISERE,Saint-Ismier,968,203,765,13,752,1,EELV,61,7.825,31.7
2017,ISERE,Saint-Ismier,968,203,765,13,752,1,FN,116,7.825,31.7
2017,ISERE,Saint-Ismier,968,203,765,13,752,1,LFI,100,7.825,31.7
2017,ISERE,Saint-Ismier,968,203,765,13,752,1,LO,1,7.825,31.7
2017,ISERE,Saint-Ismier,968,203,765,13,752,1,LR,49,7.825,31.7
2017,ISERE,Saint-Ismier,968,203,765,13,752,1,LREM,291,7.825,31.7
2017,ISERE,Saint-Ismier,968,203,765,13,752,1,NPA,4,7.825,31.7
2017,ISERE,Saint-Ismier,968,203,765,13,752,1,PCF,11,7.825,31.7
2017,ISERE,Saint-Ismier,968,203,765,13,752,1,REC,75,7.825,31.7
2017,ISERE,Saint-Ismier,968,203,765,13,752,1,RES,12,7.825,31.7
2017,ISERE,Villages du lac de Paladru,968,229,739,6,733,1,EELV,47,7.825,31.7
2017,ISERE,Villages du lac de Paladru,968,229,739,6,733,1,FN,205,7.825,31.7
2017,ISERE,Villages du lac de Paladru,968,229,739,6,733,1,LFI,144,7.825,31.7
2017,ISERE,Villages du lac de Paladru,968,229,739,6,733,1,LO,5,7.825,31.7
2017,ISERE,Villages du lac de Paladru,968,229,739,6,733,1,LR,30,7.825,31.7
2017,ISERE,Villages du lac de Paladru,968,229,739,6,733,1,LREM,163,7.825,31.7
2017,ISERE,Villages du lac de Paladru,968,229,739,6,733,1,NPA,4,7.825,31.7
2017,ISERE,Villages du lac de Paladru,968,229,739,6,733,1,PCF,17,7.825,31.7
2017,ISERE,Villages du lac de Paladru,968,229,739,6,733,1,REC,61,7.825,31.7
2017,ISERE,Villages du lac de Paladru,968,229,739,6,733,1,RES,16,7.825,31.7
2017,ISERE,Vinay,968,259,709,17,692,1,EELV,35,7.825,31.7
2017,ISERE,Vinay,968,259,709,17,692,1,FN,188,7.825,31.7
2017,ISERE,Vinay,968,259,709,17,692,1,LFI,136,7.825,31.7
2017,ISERE,Vinay,968,259,709,17,692,1,LO,3,7.825,31.7
2017,ISERE,Vinay,968,259,709,17,692,1,LR,25,7.825,31.7
2017,ISERE,Vinay,968,259,709,17,692,1,LREM,180,7.825,31.7
2017,ISERE,Vinay,968,259,709,17,692,1,NPA,6,7.825,31.7
2017,ISERE,Vinay,968,259,709,17,692,1,PCF,18,7.825,31.7
2017,ISERE,Vinay,968,259,709,17,692,1,REC,44,7.825,31.7
2017,ISERE,Vinay,968,259,709,17,692,1,RES,25,7.825,31.7
2017,ISERE,Le Versoud,970,180,790,20,770,1,EELV,56,7.825,31.7
2017,ISERE,Le Versoud,970,180,790,20,770,1,FN,195,7.825,31.7
2017,ISERE,Le Versoud,970,180,790,20,770,1,LFI,99,7.825,31.7
2017,ISERE,Le Versoud,970,180,790,20,770,1,LO,5,7.825,31.7
2017,ISERE,Le Versoud,970,180,790,20,770,1,LR,44,7.825,31.7
2017,ISERE,Le Versoud,970,180,790,20,770,1,LREM,249,7.825,31.7
2017,ISERE,Le Versoud,970,180,790,20,770,1,NPA,9,7.825,31.7
2017,ISERE,Le Versoud,970,180,790,20,770,1,PCF,16,7.825,31.7
2017,ISERE,Le Versoud,970,180,790,20,770,1,REC,49,7.825,31.7
2017,ISERE,Le Versoud,970,180,790,20,770,1,RES,15,7.825,31.7
2017,ISERE,Ruy-Montceau,971,172,799,21,778,1,EELV,39,7.825,31.7
2017,ISERE,Ruy-Montceau,971,172,799,21,778,1,FN,206,7.825,31.7
2017,ISERE,Ruy-Montceau,971,172,799,21,778,1,LFI,99,7.825,31.7
2017,ISERE,Ruy-Montceau,971,172,799,21,778,1,LO,5,7.825,31.7
2017,ISERE,Ruy-Montceau,971,172,799,21,778,1,LR,45,7.825,31.7
2017,ISERE,Ruy-Montceau,971,172,799,21,778,1,LREM,268,7.825,31.7
2017,ISERE,Ruy-Montceau,971,172,799,21,778,1,NPA,5,7.825,31.7
2017,ISERE,Ruy-Montceau,971,172,799,21,778,1,PCF,8,7.825,31.7
2017,ISERE,Ruy-Montceau,971,172,799,21,778,1,REC,56,7.825,31.7
2017,ISERE,Ruy-Montceau,971,172,799,21,778,1,RES,16,7.825,31.7
2017,ISERE,Montbonnot-Saint-Martin,971,176,795,15,780,1,EELV,54,7.825,31.7
2017,ISERE,Montbonnot-Saint-Martin,971,176,795,15,780,1,FN,134,7.825,31.7
2017,ISERE,Montbonnot-Saint-Martin,971,176,795,15,780,1,LFI,136,7.825,31.7
2017,ISERE,Montbonnot-Saint-Martin,971,176,795,15,780,1,LO,3,7.825,31.7
2017,ISERE,Montbonnot-Saint-Martin,971,176,795,15,780,1,LR,45,7.825,31.7
2017,ISERE,Montbonnot-Saint-Martin,971,176,795,15,780,1,LREM,291,7.825,31.7
2017,ISERE,Montbonnot-Saint-Martin,971,176,795,15,780,1,NPA,3,7.825,31.7
2017,ISERE,Montbonnot-Saint-Martin,971,176,795,15,780,1,PCF,8,7.825,31.7
2017,ISERE,Montbonnot-Saint-Martin,971,176,795,15,780,1,REC,59,7.825,31.7
2017,ISERE,Montbonnot-Saint-Martin,971,176,795,15,780,1,RES,19,7.825,31.7
2017,ISERE,Vienne,971,201,770,12,758,1,EELV,54,7.825,31.7
2017,ISERE,Vienne,971,201,770,12,758,1,FN,99,7.825,31.7
2017,ISERE,Vienne,971,201,770,12,758,1,LFI,187,7.825,31.7
2017,ISERE,Vienne,971,201,770,12,758,1,LO,3,7.825,31.7
2017,ISERE,Vienne,971,201,770,12,758,1,LR,46,7.825,31.7
2017,ISERE,Vienne,971,201,770,12,758,1,LREM,239,7.825,31.7
2017,ISERE,Vienne,971,201,770,12,758,1,NPA,9,7.825,31.7
2017,ISERE,Vienne,971,201,770,12,758,1,PCF,14,7.825,31.7
2017,ISERE,Vienne,971,201,770,12,758,1,REC,67,7.825,31.7
2017,ISERE,Vienne,971,201,770,12,758,1,RES,10,7.825,31.7
2017,ISERE,Saint-Martin-d'Hères,971,204,767,19,748,1,EELV,82,7.825,31.7
2017,ISERE,Saint-Martin-d'Hères,971,204,767,19,748,1,FN,118,7.825,31.7
2017,ISERE,Saint-Martin-d'Hères,971,204,767,19,748,1,LFI,298,7.825,31.7
2017,ISERE,Saint-Martin-d'Hères,971,204,767,19,748,1,LO,5,7.825,31.7
2017,ISERE,Saint-Martin-d'Hères,971,204,767,19,748,1,LR,22,7.825,31.7
2017,ISERE,Saint-Martin-d'Hères,971,204,767,19,748,1,LREM,133,7.825,31.7
2017,ISERE,Saint-Martin-d'Hères,971,204,767,19,748,1,NPA,3,7.825,31.7
2017,ISERE,Saint-Martin-d'Hères,971,204,767,19,748,1,PCF,26,7.825,31.7
2017,ISERE,Saint-Martin-d'Hères,971,204,767,19,748,1,REC,33,7.825,31.7
2017,ISERE,Saint-Martin-d'Hères,971,204,767,19,748,1,RES,5,7.825,31.7
2017,ISERE,Vienne,971,229,742,14,728,1,EELV,40,7.825,31.7
2017,ISERE,Vienne,971,229,742,14,728,1,FN,149,7.825,31.7
2017,ISERE,Vienne,971,229,742,14,728,1,LFI,142,7.825,31.7
2017,ISERE,Vienne,971,229,742,14,728,1,LO,5,7.825,31.7
2017,ISERE,Vienne,971,229,742,14,728,1,LR,60,7.825,31.7
2017,ISERE,Vienne,971,229,742,14,728,1,LREM,210,7.825,31.7
2017,ISERE,Vienne,971,229,742,14,728,1,NPA,4,7.825,31.7
2017,ISERE,Vienne,971,229,742,14,728,1,PCF,17,7.825,31.7
2017,ISERE,Vienne,971,229,742,14,728,1,REC,53,7.825,31.7
2017,ISERE,Vienne,971,229,742,14,728,1,RES,12,7.825,31.7
2017,ISERE,La Mure,972,257,715,16,699,1,EELV,27,7.825,31.7
2017,ISERE,La Mure,972,257,715,16,699,1,FN,195,7.825,31.7
2017,ISERE,La Mure,972,257,715,16,699,1,LFI,156,7.825,31.7
2017,ISERE,La Mure,972,257,715,16,699,1,LO,2,7.825,31.7
2017,ISERE,La Mure,972,257,715,16,699,1,LR,24,7.825,31.7
2017,ISERE,La Mure,972,257,715,16,699,1,LREM,180,7.825,31.7
2017,ISERE,La Mure,972,257,715,16,699,1,NPA,7,7.825,31.7
2017,ISERE,La Mure,972,257,715,16,699,1,PCF,20,7.825,31.7
2017,ISERE,La Mure,972,257,715,16,699,1,REC,51,7.825,31.7
2017,ISERE,La Mure,972,257,715,16,699,1,RES,18,7.825,31.7
2017,ISERE,Saint-Egrève,974,196,778,17,761,1,EELV,95,7.825,31.7
2017,ISERE,Saint-Egrève,974,196,778,17,761,1,FN,120,7.825,31.7
2017,ISERE,Saint-Egrève,974,196,778,17,761,1,LFI,189,7.825,31.7
2017,ISERE,Saint-Egrève,974,196,778,17,761,1,LO,8,7.825,31.7
2017,ISERE,Saint-Egrève,974,196,778,17,761,1,LR,32,7.825,31.7
2017,ISERE,Saint-Egrève,974,196,778,17,761,1,LREM,212,7.825,31.7
2017,ISERE,Saint-Egrève,974,196,778,17,761,1,NPA,7,7.825,31.7
2017,ISERE,Saint-Egrève,974,196,778,17,761,1,PCF,19,7.825,31.7
2017,ISERE,Saint-Egrève,974,196,778,17,761,1,REC,34,7.825,31.7
2017,ISERE,Saint-Egrève,974,196,778,17,761,1,RES,14,7.825,31.7
2017,ISERE,Morestel,974,264,710,25,685,1,EELV,10,7.825,31.7
2017,ISERE,Morestel,974,264,710,25,685,1,FN,237,7.825,31.7
2017,ISERE,Morestel,974,264,710,25,685,1,LFI,124,7.825,31.7
2017,ISERE,Morestel,974,264,710,25,685,1,LO,3,7.825,31.7
2017,ISERE,Morestel,974,264,710,25,685,1,LR,29,7.825,31.7
2017,ISERE,Morestel,974,264,710,25,685,1,LREM,167,7.825,31.7
2017,ISERE,Morestel,974,264,710,25,685,1,NPA,5,7.825,31.7
2017,ISERE,Morestel,974,264,710,25,685,1,PCF,14,7.825,31.7
2017,ISERE,Morestel,974,264,710,25,685,1,REC,54,7.825,31.7
2017,ISERE,Morestel,974,264,710,25,685,1,RES,13,7.825,31.7
2017,ISERE,Chanas,975,206,769,17,752,1,EELV,25,7.825,31.7
2017,ISERE,Chanas,975,206,769,17,752,1,FN,247,7.825,31.7
2017,ISERE,Chanas,975,206,769,17,752,1,LFI,107,7.825,31.7
2017,ISERE,Chanas,975,206,769,17,752,1,LO,2,7.825,31.7
2017,ISERE,Chanas,975,206,769,17,752,1,LR,44,7.825,31.7
2017,ISERE,Chanas,975,206,769,17,752,1,LREM,175,7.825,31.7
2017,ISERE,Chanas,975,206,769,17,752,1,NPA,6,7.825,31.7
2017,ISERE,Chanas,975,206,769,17,752,1,PCF,22,7.825,31.7
2017,ISERE,Chanas,975,206,769,17,752,1,REC,74,7.825,31.7
2017,ISERE,Chanas,975,206,769,17,752,1,RES,21,7.825,31.7
2017,ISERE,Meylan,975,238,737,17,720,1,EELV,60,7.825,31.7
2017,ISERE,Meylan,975,238,737,17,720,1,FN,95,7.825,31.7
2017,ISERE,Meylan,975,238,737,17,720,1,LFI,160,7.825,31.7
2017,ISERE,Meylan,975,238,737,17,720,1,LO,3,7.825,31.7
2017,ISERE,Meylan,975,238,737,17,720,1,LR,45,7.825,31.7
2017,ISERE,Meylan,975,238,737,17,720,1,LREM,266,7.825,31.7
2017,ISERE,Meylan,975,238,737,17,720,1,NPA,7,7.825,31.7
2017,ISERE,Meylan,975,238,737,17,720,1,PCF,15,7.825,31.7
2017,ISERE,Meylan,975,238,737,17,720,1,REC,36,7.825,31.7
2017,ISERE,Meylan,975,238,737,17,720,1,RES,11,7.825,31.7
2017,ISERE,Echirolles,976,382,594,12,582,1,EELV,12,7.825,31.7
2017,ISERE,Echirolles,976,382,594,12,582,1,FN,92,7.825,31.7
2017,ISERE,Echirolles,976,382,594,12,582,1,LFI,303,7.825,31.7
2017,ISERE,Echirolles,976,382,594,12,582,1,LO,5,7.825,31.7
2017,ISERE,Echirolles,976,382,594,12,582,1,LR,10,7.825,31.7
2017,ISERE,Echirolles,976,382,594,12,582,1,LREM,89,7.825,31.7
2017,ISERE,Echirolles,976,382,594,12,582,1,NPA,7,7.825,31.7
2017,ISERE,Echirolles,976,382,594,12,582,1,PCF,23,7.825,31.7
2017,ISERE,Echirolles,976,382,594,12,582,1,REC,25,7.825,31.7
2017,ISERE,Echirolles,976,382,594,12,582,1,RES,6,7.825,31.7
2017,ISERE,Villette-d'Anthon,977,149,828,17,811,1,EELV,26,7.825,31.7
2017,ISERE,Villette-d'Anthon,977,149,828,17,811,1,FN,212,7.825,31.7
2017,ISERE,Villette-d'Anthon,977,149,828,17,811,1,LFI,63,7.825,31.7
2017,ISERE,Villette-d'Anthon,977,149,828,17,811,1,LO,3,7.825,31.7
2017,ISERE,Villette-d'Anthon,977,149,828,17,811,1,LR,35,7.825,31.7
2017,ISERE,Villette-d'Anthon,977,149,828,17,811,1,LREM,297,7.825,31.7
2017,ISERE,Villette-d'Anthon,977,149,828,17,811,1,NPA,1,7.825,31.7
2017,ISERE,Villette-d'Anthon,977,149,828,17,811,1,PCF,5,7.825,31.7
2017,ISERE,Villette-d'Anthon,977,149,828,17,811,1,REC,132,7.825,31.7
2017,ISERE,Villette-d'Anthon,977,149,828,17,811,1,RES,12,7.825,31.7
2017,ISERE,Champ-sur-Drac,977,213,764,14,750,1,EELV,17,7.825,31.7
2017,ISERE,Champ-sur-Drac,977,213,764,14,750,1,FN,278,7.825,31.7
2017,ISERE,Champ-sur-Drac,977,213,764,14,750,1,LFI,150,7.825,31.7
2017,ISERE,Champ-sur-Drac,977,213,764,14,750,1,LO,4,7.825,31.7
2017,ISERE,Champ-sur-Drac,977,213,764,14,750,1,LR,16,7.825,31.7
2017,ISERE,Champ-sur-Drac,977,213,764,14,750,1,LREM,162,7.825,31.7
2017,ISERE,Champ-sur-Drac,977,213,764,14,750,1,NPA,5,7.825,31.7
2017,ISERE,Champ-sur-Drac,977,213,764,14,750,1,PCF,16,7.825,31.7
2017,ISERE,Champ-sur-Drac,977,213,764,14,750,1,REC,36,7.825,31.7
2017,ISERE,Champ-sur-Drac,977,213,764,14,750,1,RES,28,7.825,31.7
2017,ISERE,Saint-Just-de-Claix,978,216,762,6,756,1,EELV,33,7.825,31.7
2017,ISERE,Saint-Just-de-Claix,978,216,762,6,756,1,FN,257,7.825,31.7
2017,ISERE,Saint-Just-de-Claix,978,216,762,6,756,1,LFI,146,7.825,31.7
2017,ISERE,Saint-Just-de-Claix,978,216,762,6,756,1,LO,6,7.825,31.7
2017,ISERE,Saint-Just-de-Claix,978,216,762,6,756,1,LR,26,7.825,31.7
2017,ISERE,Saint-Just-de-Claix,978,216,762,6,756,1,LREM,162,7.825,31.7
2017,ISERE,Saint-Just-de-Claix,978,216,762,6,756,1,NPA,9,7.825,31.7
2017,ISERE,Saint-Just-de-Claix,978,216,762,6,756,1,PCF,14,7.825,31.7
2017,ISERE,Saint-Just-de-Claix,978,216,762,6,756,1,REC,43,7.825,31.7
2017,ISERE,Saint-Just-de-Claix,978,216,762,6,756,1,RES,27,7.825,31.7
2017,ISERE,Noyarey,980,206,774,12,762,1,EELV,28,7.825,31.7
2017,ISERE,Noyarey,980,206,774,12,762,1,FN,192,7.825,31.7
2017,ISERE,Noyarey,980,206,774,12,762,1,LFI,121,7.825,31.7
2017,ISERE,Noyarey,980,206,774,12,762,1,LO,2,7.825,31.7
2017,ISERE,Noyarey,980,206,774,12,762,1,LR,21,7.825,31.7
2017,ISERE,Noyarey,980,206,774,12,762,1,LREM,267,7.825,31.7
2017,ISERE,Noyarey,980,206,774,12,762,1,NPA,4,7.825,31.7
2017,ISERE,Noyarey,980,206,774,12,762,1,PCF,12,7.825,31.7
2017,ISERE,Noyarey,980,206,774,12,762,1,REC,61,7.825,31.7
2017,ISERE,Noyarey,980,206,774,12,762,1,RES,16,7.825,31.7
2017,ISERE,Claix,981,286,695,17,678,1,EELV,39,7.825,31.7
2017,ISERE,Claix,981,286,695,17,678,1,FN,161,7.825,31.7
2017,ISERE,Claix,981,286,695,17,678,1,LFI,153,7.825,31.7
2017,ISERE,Claix,981,286,695,17,678,1,LO,2,7.825,31.7
2017,ISERE,Claix,981,286,695,17,678,1,LR,15,7.825,31.7
2017,ISERE,Claix,981,286,695,17,678,1,LREM,174,7.825,31.7
2017,ISERE,Claix,981,286,695,17,678,1,NPA,7,7.825,31.7
2017,ISERE,Claix,981,286,695,17,678,1,PCF,20,7.825,31.7
2017,ISERE,Claix,981,286,695,17,678,1,REC,49,7.825,31.7
2017,ISERE,Claix,981,286,695,17,678,1,RES,24,7.825,31.7
2017,ISERE,Grenoble,981,310,671,19,652,1,EELV,30,7.825,31.7
2017,ISERE,Grenoble,981,310,671,19,652,1,FN,88,7.825,31.7
2017,ISERE,Grenoble,981,310,671,19,652,1,LFI,280,7.825,31.7
2017,ISERE,Grenoble,981,310,671,19,652,1,LO,5,7.825,31.7
2017,ISERE,Grenoble,981,310,671,19,652,1,LR,19,7.825,31.7
2017,ISERE,Grenoble,981,310,671,19,652,1,LREM,147,7.825,31.7
2017,ISERE,Grenoble,981,310,671,19,652,1,NPA,4,7.825,31.7
2017,ISERE,Grenoble,981,310,671,19,652,1,PCF,14,7.825,31.7
2017,ISERE,Grenoble,981,310,671,19,652,1,REC,38,7.825,31.7
2017,ISERE,Grenoble,981,310,671,19,652,1,RES,8,7.825,31.7
2017,ISERE,Monestier-de-Clermont,982,190,792,18,774,1,EELV,43,7.825,31.7
2017,ISERE,Monestier-de-Clermont,982,190,792,18,774,1,FN,209,7.825,31.7
2017,ISERE,Monestier-de-Clermont,982,190,792,18,774,1,LFI,174,7.825,31.7
2017,ISERE,Monestier-de-Clermont,982,190,792,18,774,1,LO,7,7.825,31.7
2017,ISERE,Monestier-de-Clermont,982,190,792,18,774,1,LR,45,7.825,31.7
2017,ISERE,Monestier-de-Clermont,982,190,792,18,774,1,LREM,168,7.825,31.7
2017,ISERE,Monestier-de-Clermont,982,190,792,18,774,1,NPA,4,7.825,31.7
2017,ISERE,Monestier-de-Clermont,982,190,792,18,774,1,PCF,15,7.825,31.7
2017,ISERE,Monestier-de-Clermont,982,190,792,18,774,1,REC,33,7.825,31.7
2017,ISERE,Monestier-de-Clermont,982,190,792,18,774,1,RES,37,7.825,31.7
2017,ISERE,Champier,982,195,787,23,764,1,EELV,27,7.825,31.7
2017,ISERE,Champier,982,195,787,23,764,1,FN,296,7.825,31.7
2017,ISERE,Champier,982,195,787,23,764,1,LFI,97,7.825,31.7
2017,ISERE,Champier,982,195,787,23,764,1,LO,2,7.825,31.7
2017,ISERE,Champier,982,195,787,23,764,1,LR,44,7.825,31.7
2017,ISERE,Champier,982,195,787,23,764,1,LREM,147,7.825,31.7
2017,ISERE,Champier,982,195,787,23,764,1,NPA,6,7.825,31.7
2017,ISERE,Champier,982,195,787,23,764,1,PCF,13,7.825,31.7
2017,ISERE,Champier,982,195,787,23,764,1,REC,69,7.825,31.7
2017,ISERE,Champier,982,195,787,23,764,1,RES,31,7.825,31.7
2017,ISERE,Vienne,982,221,761,12,749,1,EELV,67,7.825,31.7
2017,ISERE,Vienne,982,221,761,12,749,1,FN,127,7.825,31.7
2017,ISERE,Vienne,982,221,761,12,749,1,LFI,162,7.825,31.7
2017,ISERE,Vienne,982,221,761,12,749,1,LO,2,7.825,31.7
2017,ISERE,Vienne,982,221,761,12,749,1,LR,38,7.825,31.7
2017,ISERE,Vienne,982,221,761,12,749,1,LREM,240,7.825,31.7
2017,ISERE,Vienne,982,221,761,12,749,1,NPA,9,7.825,31.7
2017,ISERE,Vienne,982,221,761,12,749,1,PCF,14,7.825,31.7
2017,ISERE,Vienne,982,221,761,12,749,1,REC,50,7.825,31.7
2017,ISERE,Vienne,982,221,761,12,749,1,RES,13,7.825,31.7
2017,ISERE,Biviers,983,155,828,9,819,1,EELV,64,7.825,31.7
2017,ISERE,Biviers,983,155,828,9,819,1,FN,99,7.825,31.7
2017,ISERE,Biviers,983,155,828,9,819,1,LFI,111,7.825,31.7
2017,ISERE,Biviers,983,155,828,9,819,1,LO,1,7.825,31.7
2017,ISERE,Biviers,983,155,828,9,819,1,LR,85,7.825,31.7
2017,ISERE,Biviers,983,155,828,9,819,1,LREM,329,7.825,31.7
2017,ISERE,Biviers,983,155,828,9,819,1,NPA,2,7.825,31.7
2017,ISERE,Biviers,983,155,828,9,819,1,PCF,18,7.825,31.7
2017,ISERE,Biviers,983,155,828,9,819,1,REC,80,7.825,31.7
2017,ISERE,Biviers,983,155,828,9,819,1,RES,12,7.825,31.7
2017,ISERE,Vaulx-Milieu,983,165,818,14,804,1,EELV,48,7.825,31.7
2017,ISERE,Vaulx-Milieu,983,165,818,14,804,1,FN,224,7.825,31.7
2017,ISERE,Vaulx-Milieu,983,165,818,14,804,1,LFI,132,7.825,31.7
2017,ISERE,Vaulx-Milieu,983,165,818,14,804,1,LO,3,7.825,31.7
2017,ISERE,Vaulx-Milieu,983,165,818,14,804,1,LR,23,7.825,31.7
2017,ISERE,Vaulx-Milieu,983,165,818,14,804,1,LREM,215,7.825,31.7
2017,ISERE,Vaulx-Milieu,983,165,818,14,804,1,NPA,6,7.825,31.7
2017,ISERE,Vaulx-Milieu,983,165,818,14,804,1,PCF,25,7.825,31.7
2017,ISERE,Vaulx-Milieu,983,165,818,14,804,1,REC,80,7.825,31.7
2017,ISERE,Vaulx-Milieu,983,165,818,14,804,1,RES,16,7.825,31.7
2017,ISERE,Tignieu-Jameyzieu,984,226,758,15,743,1,EELV,22,7.825,31.7
2017,ISERE,Tignieu-Jameyzieu,984,226,758,15,743,1,FN,264,7.825,31.7
2017,ISERE,Tignieu-Jameyzieu,984,226,758,15,743,1,LFI,124,7.825,31.7
2017,ISERE,Tignieu-Jameyzieu,984,226,758,15,743,1,LO,2,7.825,31.7
2017,ISERE,Tignieu-Jameyzieu,984,226,758,15,743,1,LR,27,7.825,31.7
2017,ISERE,Tignieu-Jameyzieu,984,226,758,15,743,1,LREM,162,7.825,31.7
2017,ISERE,Tignieu-Jameyzieu,984,226,758,15,743,1,NPA,3,7.825,31.7
2017,ISERE,Tignieu-Jameyzieu,984,226,758,15,743,1,PCF,11,7.825,31.7
2017,ISERE,Tignieu-Jameyzieu,984,226,758,15,743,1,REC,74,7.825,31.7
2017,ISERE,Tignieu-Jameyzieu,984,226,758,15,743,1,RES,27,7.825,31.7
2017,ISERE,Lumbin,986,161,825,14,811,1,EELV,85,7.825,31.7
2017,ISERE,Lumbin,986,161,825,14,811,1,FN,140,7.825,31.7
2017,ISERE,Lumbin,986,161,825,14,811,1,LFI,173,7.825,31.7
2017,ISERE,Lumbin,986,161,825,14,811,1,LO,1,7.825,31.7
2017,ISERE,Lumbin,986,161,825,14,811,1,LR,40,7.825,31.7
2017,ISERE,Lumbin,986,161,825,14,811,1,LREM,259,7.825,31.7
2017,ISERE,Lumbin,986,161,825,14,811,1,NPA,4,7.825,31.7
2017,ISERE,Lumbin,986,161,825,14,811,1,PCF,14,7.825,31.7
2017,ISERE,Lumbin,986,161,825,14,811,1,REC,57,7.825,31.7
2017,ISERE,Lumbin,986,161,825,14,811,1,RES,13,7.825,31.7
2017,ISERE,Saint-Antoine-l'Abbaye,987,149,838,18,820,1,EELV,65,7.825,31.7
2017,ISERE,Saint-Antoine-l'Abbaye,987,149,838,18,820,1,FN,187,7.825,31.7
2017,ISERE,Saint-Antoine-l'Abbaye,987,149,838,18,820,1,LFI,209,7.825,31.7
2017,ISERE,Saint-Antoine-l'Abbaye,987,149,838,18,820,1,LO,2,7.825,31.7
2017,ISERE,Saint-Antoine-l'Abbaye,987,149,838,18,820,1,LR,34,7.825,31.7
2017,ISERE,Saint-Antoine-l'Abbaye,987,149,838,18,820,1,LREM,167,7.825,31.7
2017,ISERE,Saint-Antoine-l'Abbaye,987,149,838,18,820,1,NPA,4,7.825,31.7
2017,ISERE,Saint-Antoine-l'Abbaye,987,149,838,18,820,1,PCF,17,7.825,31.7
2017,ISERE,Saint-Antoine-l'Abbaye,987,149,838,18,820,1,REC,59,7.825,31.7
2017,ISERE,Saint-Antoine-l'Abbaye,987,149,838,18,820,1,RES,39,7.825,31.7
2017,ISERE,Vézeronce-Curtin,987,241,746,15,731,1,EELV,26,7.825,31.7
2017,ISERE,Vézeronce-Curtin,987,241,746,15,731,1,FN,278,7.825,31.7
2017,ISERE,Vézeronce-Curtin,987,241,746,15,731,1,LFI,94,7.825,31.7
2017,ISERE,Vézeronce-Curtin,987,241,746,15,731,1,LO,1,7.825,31.7
2017,ISERE,Vézeronce-Curtin,987,241,746,15,731,1,LR,31,7.825,31.7
2017,ISERE,Vézeronce-Curtin,987,241,746,15,731,1,LREM,151,7.825,31.7
2017,ISERE,Vézeronce-Curtin,987,241,746,15,731,1,NPA,6,7.825,31.7
2017,ISERE,Vézeronce-Curtin,987,241,746,15,731,1,PCF,13,7.825,31.7
2017,ISERE,Vézeronce-Curtin,987,241,746,15,731,1,REC,71,7.825,31.7
2017,ISERE,Vézeronce-Curtin,987,241,746,15,731,1,RES,32,7.825,31.7
2017,ISERE,Meylan,988,194,794,18,776,1,EELV,70,7.825,31.7
2017,ISERE,Meylan,988,194,794,18,776,1,FN,109,7.825,31.7
2017,ISERE,Meylan,988,194,794,18,776,1,LFI,159,7.825,31.7
2017,ISERE,Meylan,988,194,794,18,776,1,LO,3,7.825,31.7
2017,ISERE,Meylan,988,194,794,18,776,1,LR,43,7.825,31.7
2017,ISERE,Meylan,988,194,794,18,776,1,LREM,284,7.825,31.7
2017,ISERE,Meylan,988,194,794,18,776,1,NPA,2,7.825,31.7
2017,ISERE,Meylan,988,194,794,18,776,1,PCF,14,7.825,31.7
2017,ISERE,Meylan,988,194,794,18,776,1,REC,56,7.825,31.7
2017,ISERE,Meylan,988,194,794,18,776,1,RES,14,7.825,31.7
2017,ISERE,Saint-Siméon-de-Bressieux,988,285,703,17,686,1,EELV,23,7.825,31.7
2017,ISERE,Saint-Siméon-de-Bressieux,988,285,703,17,686,1,FN,194,7.825,31.7
2017,ISERE,Saint-Siméon-de-Bressieux,988,285,703,17,686,1,LFI,145,7.825,31.7
2017,ISERE,Saint-Siméon-de-Bressieux,988,285,703,17,686,1,LO,12,7.825,31.7
2017,ISERE,Saint-Siméon-de-Bressieux,988,285,703,17,686,1,LR,32,7.825,31.7
2017,ISERE,Saint-Siméon-de-Bressieux,988,285,703,17,686,1,LREM,169,7.825,31.7
2017,ISERE,Saint-Siméon-de-Bressieux,988,285,703,17,686,1,NPA,7,7.825,31.7
2017,ISERE,Saint-Siméon-de-Bressieux,988,285,703,17,686,1,PCF,15,7.825,31.7
2017,ISERE,Saint-Siméon-de-Bressieux,988,285,703,17,686,1,REC,42,7.825,31.7
2017,ISERE,Saint-Siméon-de-Bressieux,988,285,703,17,686,1,RES,16,7.825,31.7
2017,ISERE,Coublevie,990,190,800,17,783,1,EELV,72,7.825,31.7
2017,ISERE,Coublevie,990,190,800,17,783,1,FN,106,7.825,31.7
2017,ISERE,Coublevie,990,190,800,17,783,1,LFI,134,7.825,31.7
2017,ISERE,Coublevie,990,190,800,17,783,1,LO,1,7.825,31.7
2017,ISERE,Coublevie,990,190,800,17,783,1,LR,43,7.825,31.7
2017,ISERE,Coublevie,990,190,800,17,783,1,LREM,314,7.825,31.7
2017,ISERE,Coublevie,990,190,800,17,783,1,NPA,5,7.825,31.7
2017,ISERE,Coublevie,990,190,800,17,783,1,PCF,10,7.825,31.7
2017,ISERE,Coublevie,990,190,800,17,783,1,REC,57,7.825,31.7
2017,ISERE,Coublevie,990,190,800,17,783,1,RES,18,7.825,31.7
2017,ISERE,La Côte-Saint-André,991,232,759,15,744,1,EELV,33,7.825,31.7
2017,ISERE,La Côte-Saint-André,991,232,759,15,744,1,FN,153,7.825,31.7
2017,ISERE,La Côte-Saint-André,991,232,759,15,744,1,LFI,164,7.825,31.7
2017,ISERE,La Côte-Saint-André,991,232,759,15,744,1,LO,8,7.825,31.7
2017,ISERE,La Côte-Saint-André,991,232,759,15,744,1,LR,53,7.825,31.7
2017,ISERE,La Côte-Saint-André,991,232,759,15,744,1,LREM,191,7.825,31.7
2017,ISERE,La Côte-Saint-André,991,232,759,15,744,1,NPA,5,7.825,31.7
2017,ISERE,La Côte-Saint-André,991,232,759,15,744,1,PCF,16,7.825,31.7
2017,ISERE,La Côte-Saint-André,991,232,759,15,744,1,REC,81,7.825,31.7
2017,ISERE,La Côte-Saint-André,991,232,759,15,744,1,RES,15,7.825,31.7
2017,ISERE,Seyssinet-Pariset,992,148,844,15,829,1,EELV,90,7.825,31.7
2017,ISERE,Seyssinet-Pariset,992,148,844,15,829,1,FN,116,7.825,31.7
2017,ISERE,Seyssinet-Pariset,992,148,844,15,829,1,LFI,165,7.825,31.7
2017,ISERE,Seyssinet-Pariset,992,148,844,15,829,1,LO,2,7.825,31.7
2017,ISERE,Seyssinet-Pariset,992,148,844,15,829,1,LR,44,7.825,31.7
2017,ISERE,Seyssinet-Pariset,992,148,844,15,829,1,LREM,276,7.825,31.7
2017,ISERE,Seyssinet-Pariset,992,148,844,15,829,1,NPA,3,7.825,31.7
2017,ISERE,Seyssinet-Pariset,992,148,844,15,829,1,PCF,16,7.825,31.7
2017,ISERE,Seyssinet-Pariset,992,148,844,15,829,1,REC,59,7.825,31.7
2017,ISERE,Seyssinet-Pariset,992,148,844,15,829,1,RES,15,7.825,31.7
2017,ISERE,Saint-Marcellin,993,229,764,17,747,1,EELV,26,7.825,31.7
2017,ISERE,Saint-Marcellin,993,229,764,17,747,1,FN,141,7.825,31.7
2017,ISERE,Saint-Marcellin,993,229,764,17,747,1,LFI,175,7.825,31.7
2017,ISERE,Saint-Marcellin,993,229,764,17,747,1,LO,8,7.825,31.7
2017,ISERE,Saint-Marcellin,993,229,764,17,747,1,LR,41,7.825,31.7
2017,ISERE,Saint-Marcellin,993,229,764,17,747,1,LREM,229,7.825,31.7
2017,ISERE,Saint-Marcellin,993,229,764,17,747,1,NPA,5,7.825,31.7
2017,ISERE,Saint-Marcellin,993,229,764,17,747,1,PCF,22,7.825,31.7
2017,ISERE,Saint-Marcellin,993,229,764,17,747,1,REC,51,7.825,31.7
2017,ISERE,Saint-Marcellin,993,229,764,17,747,1,RES,20,7.825,31.7
2017,ISERE,Vienne,994,203,791,21,770,1,EELV,35,7.825,31.7
2017,ISERE,Vienne,994,203,791,21,770,1,FN,161,7.825,31.7
2017,ISERE,Vienne,994,203,791,21,770,1,LFI,136,7.825,31.7
2017,ISERE,Vienne,994,203,791,21,770,1,LO,2,7.825,31.7
2017,ISERE,Vienne,994,203,791,21,770,1,LR,60,7.825,31.7
2017,ISERE,Vienne,994,203,791,21,770,1,LREM,258,7.825,31.7
2017,ISERE,Vienne,994,203,791,21,770,1,NPA,5,7.825,31.7
2017,ISERE,Vienne,994,203,791,21,770,1,PCF,14,7.825,31.7
2017,ISERE,Vienne,994,203,791,21,770,1,REC,58,7.825,31.7
2017,ISERE,Vienne,994,203,791,21,770,1,RES,13,7.825,31.7
2017,ISERE,Saint-Joseph-de-Rivière,995,204,791,25,766,1,EELV,50,7.825,31.7
2017,ISERE,Saint-Joseph-de-Rivière,995,204,791,25,766,1,FN,189,7.825,31.7
2017,ISERE,Saint-Joseph-de-Rivière,995,204,791,25,766,1,LFI,197,7.825,31.7
2017,ISERE,Saint-Joseph-de-Rivière,995,204,791,25,766,1,LO,3,7.825,31.7
2017,ISERE,Saint-Joseph-de-Rivière,995,204,791,25,766,1,LR,18,7.825,31.7
2017,ISERE,Saint-Joseph-de-Rivière,995,204,791,25,766,1,LREM,181,7.825,31.7
2017,ISERE,Saint-Joseph-de-Rivière,995,204,791,25,766,1,NPA,8,7.825,31.7
2017,ISERE,Saint-Joseph-de-Rivière,995,204,791,25,766,1,PCF,12,7.825,31.7
2017,ISERE,Saint-Joseph-de-Rivière,995,204,791,25,766,1,REC,44,7.825,31.7
2017,ISERE,Saint-Joseph-de-Rivière,995,204,791,25,766,1,RES,30,7.825,31.7
2017,ISERE,Bourgoin-Jallieu,995,342,653,12,641,1,EELV,40,7.825,31.7
2017,ISERE,Bourgoin-Jallieu,995,342,653,12,641,1,FN,102,7.825,31.7
2017,ISERE,Bourgoin-Jallieu,995,342,653,12,641,1,LFI,177,7.825,31.7
2017,ISERE,Bourgoin-Jallieu,995,342,653,12,641,1,LO,1,7.825,31.7
2017,ISERE,Bourgoin-Jallieu,995,342,653,12,641,1,LR,47,7.825,31.7
2017,ISERE,Bourgoin-Jallieu,995,342,653,12,641,1,LREM,159,7.825,31.7
2017,ISERE,Bourgoin-Jallieu,995,342,653,12,641,1,NPA,1,7.825,31.7
2017,ISERE,Bourgoin-Jallieu,995,342,653,12,641,1,PCF,17,7.825,31.7
2017,ISERE,Bourgoin-Jallieu,995,342,653,12,641,1,REC,46,7.825,31.7
2017,ISERE,Bourgoin-Jallieu,995,342,653,12,641,1,RES,20,7.825,31.7
2017,ISERE,Saint-Laurent-du-Pont,997,204,793,24,769,1,EELV,45,7.825,31.7
2017,ISERE,Saint-Laurent-du-Pont,997,204,793,24,769,1,FN,196,7.825,31.7
2017,ISERE,Saint-Laurent-du-Pont,997,204,793,24,769,1,LFI,149,7.825,31.7
2017,ISERE,Saint-Laurent-du-Pont,997,204,793,24,769,1,LO,5,7.825,31.7
2017,ISERE,Saint-Laurent-du-Pont,997,204,793,24,769,1,LR,26,7.825,31.7
2017,ISERE,Saint-Laurent-du-Pont,997,204,793,24,769,1,LREM,209,7.825,31.7
2017,ISERE,Saint-Laurent-du-Pont,997,204,793,24,769,1,NPA,10,7.825,31.7
2017,ISERE,Saint-Laurent-du-Pont,997,204,793,24,769,1,PCF,8,7.825,31.7
2017,ISERE,Saint-Laurent-du-Pont,997,204,793,24,769,1,REC,63,7.825,31.7
2017,ISERE,Saint-Laurent-du-Pont,997,204,793,24,769,1,RES,24,7.825,31.7
2017,ISERE,Grenoble,998,233,765,15,750,1,EELV,50,7.825,31.7
2017,ISERE,Grenoble,998,233,765,15,750,1,FN,110,7.825,31.7
2017,ISERE,Grenoble,998,233,765,15,750,1,LFI,255,7.825,31.7
2017,ISERE,Grenoble,998,233,765,15,750,1,LO,2,7.825,31.7
2017,ISERE,Grenoble,998,233,765,15,750,1,LR,26,7.825,31.7
2017,ISERE,Grenoble,998,233,765,15,750,1,LREM,202,7.825,31.7
2017,ISERE,Grenoble,998,233,765,15,750,1,NPA,5,7.825,31.7
2017,ISERE,Grenoble,998,233,765,15,750,1,PCF,9,7.825,31.7
2017,ISERE,Grenoble,998,233,765,15,750,1,REC,48,7.825,31.7
2017,ISERE,Grenoble,998,233,765,15,750,1,RES,12,7.825,31.7
2017,ISERE,Aoste,999,237,762,12,750,1,EELV,22,7.825,31.7
2017,ISERE,Aoste,999,237,762,12,750,1,FN,275,7.825,31.7
2017,ISERE,Aoste,999,237,762,12,750,1,LFI,133,7.825,31.7
2017,ISERE,Aoste,999,237,762,12,750,1,LO,0,7.825,31.7
2017,ISERE,Aoste,999,237,762,12,750,1,LR,35,7.825,31.7
2017,ISERE,Aoste,999,237,762,12,750,1,LREM,159,7.825,31.7
2017,ISERE,Aoste,999,237,762,12,750,1,NPA,4,7.825,31.7
2017,ISERE,Aoste,999,237,762,12,750,1,PCF,7,7.825,31.7
2017,ISERE,Aoste,999,237,762,12,750,1,REC,58,7.825,31.7
2017,ISERE,Aoste,999,237,762,12,750,1,RES,23,7.825,31.7
2017,ISERE,Bourgoin-Jallieu,999,256,743,17,726,1,EELV,29,7.825,31.7
2017,ISERE,Bourgoin-Jallieu,999,256,743,17,726,1,FN,169,7.825,31.7
2017,ISERE,Bourgoin-Jallieu,999,256,743,17,726,1,LFI,147,7.825,31.7
2017,ISERE,Bourgoin-Jallieu,999,256,743,17,726,1,LO,1,7.825,31.7
2017,ISERE,Bourgoin-Jallieu,999,256,743,17,726,1,LR,40,7.825,31.7
2017,ISERE,Bourgoin-Jallieu,999,256,743,17,726,1,LREM,210,7.825,31.7
2017,ISERE,Bourgoin-Jallieu,999,256,743,17,726,1,NPA,5,7.825,31.7
2017,ISERE,Bourgoin-Jallieu,999,256,743,17,726,1,PCF,16,7.825,31.7
2017,ISERE,Bourgoin-Jallieu,999,256,743,17,726,1,REC,52,7.825,31.7
2017,ISERE,Bourgoin-Jallieu,999,256,743,17,726,1,RES,14,7.825,31.7
2017,ISERE,Allevard,1000,292,708,11,697,1,EELV,39,7.825,31.7
2017,ISERE,Allevard,1000,292,708,11,697,1,FN,136,7.825,31.7
2017,ISERE,Allevard,1000,292,708,11,697,1,LFI,227,7.825,31.7
2017,ISERE,Allevard,1000,292,708,11,697,1,LO,8,7.825,31.7
2017,ISERE,Allevard,1000,292,708,11,697,1,LR,21,7.825,31.7
2017,ISERE,Allevard,1000,292,708,11,697,1,LREM,142,7.825,31.7
2017,ISERE,Allevard,1000,292,708,11,697,1,NPA,6,7.825,31.7
2017,ISERE,Allevard,1000,292,708,11,697,1,PCF,15,7.825,31.7
2017,ISERE,Allevard,1000,292,708,11,697,1,REC,52,7.825,31.7
2017,ISERE,Allevard,1000,292,708,11,697,1,RES,26,7.825,31.7
2017,ISERE,Champagnier,1001,107,894,17,877,1,EELV,67,7.825,31.7
2017,ISERE,Champagnier,1001,107,894,17,877,1,FN,154,7.825,31.7
2017,ISERE,Champagnier,1001,107,894,17,877,1,LFI,172,7.825,31.7
2017,ISERE,Champagnier,1001,107,894,17,877,1,LO,6,7.825,31.7
2017,ISERE,Champagnier,1001,107,894,17,877,1,LR,44,7.825,31.7
2017,ISERE,Champagnier,1001,107,894,17,877,1,LREM,305,7.825,31.7
2017,ISERE,Champagnier,1001,107,894,17,877,1,NPA,2,7.825,31.7
2017,ISERE,Champagnier,1001,107,894,17,877,1,PCF,14,7.825,31.7
2017,ISERE,Champagnier,1001,107,894,17,877,1,REC,60,7.825,31.7
2017,ISERE,Champagnier,1001,107,894,17,877,1,RES,21,7.825,31.7
2017,ISERE,Chirens,1004,183,821,22,799,1,EELV,44,7.825,31.7
2017,ISERE,Chirens,1004,183,821,22,799,1,FN,188,7.825,31.7
2017,ISERE,Chirens,1004,183,821,22,799,1,LFI,182,7.825,31.7
2017,ISERE,Chirens,1004,183,821,22,799,1,LO,6,7.825,31.7
2017,ISERE,Chirens,1004,183,821,22,799,1,LR,33,7.825,31.7
2017,ISERE,Chirens,1004,183,821,22,799,1,LREM,214,7.825,31.7
2017,ISERE,Chirens,1004,183,821,22,799,1,NPA,8,7.825,31.7
2017,ISERE,Chirens,1004,183,821,22,799,1,PCF,24,7.825,31.7
2017,ISERE,Chirens,1004,183,821,22,799,1,REC,34,7.825,31.7
2017,ISERE,Chirens,1004,183,821,22,799,1,RES,24,7.825,31.7
2017,ISERE,Bourgoin-Jallieu,1004,315,689,16,673,1,EELV,35,7.825,31.7
2017,ISERE,Bourgoin-Jallieu,1004,315,689,16,673,1,FN,168,7.825,31.7
2017,ISERE,Bourgoin-Jallieu,1004,315,689,16,673,1,LFI,222,7.825,31.7
2017,ISERE,Bourgoin-Jallieu,1004,315,689,16,673,1,LO,8,7.825,31.7
2017,ISERE,Bourgoin-Jallieu,1004,315,689,16,673,1,LR,25,7.825,31.7
2017,ISERE,Bourgoin-Jallieu,1004,315,689,16,673,1,LREM,120,7.825,31.7
2017,ISERE,Bourgoin-Jallieu,1004,315,689,16,673,1,NPA,1,7.825,31.7
2017,ISERE,Bourgoin-Jallieu,1004,315,689,16,673,1,PCF,14,7.825,31.7
2017,ISERE,Bourgoin-Jallieu,1004,315,689,16,673,1,REC,44,7.825,31.7
2017,ISERE,Bourgoin-Jallieu,1004,315,689,16,673,1,RES,10,7.825,31.7
2017,ISERE,La Verpillière,1005,260,745,14,731,1,EELV,33,7.825,31.7
2017,ISERE,La Verpillière,1005,260,745,14,731,1,FN,190,7.825,31.7
2017,ISERE,La Verpillière,1005,260,745,14,731,1,LFI,176,7.825,31.7
2017,ISERE,La Verpillière,1005,260,745,14,731,1,LO,3,7.825,31.7
2017,ISERE,La Verpillière,1005,260,745,14,731,1,LR,32,7.825,31.7
2017,ISERE,La Verpillière,1005,260,745,14,731,1,LREM,187,7.825,31.7
2017,ISERE,La Verpillière,1005,260,745,14,731,1,NPA,6,7.825,31.7
2017,ISERE,La Verpillière,1005,260,745,14,731,1,PCF,19,7.825,31.7
2017,ISERE,La Verpillière,1005,260,745,14,731,1,REC,50,7.825,31.7
2017,ISERE,La Verpillière,1005,260,745,14,731,1,RES,19,7.825,31.7
2017,ISERE,Brié-et-Angonnes,1006,159,847,9,838,1,EELV,53,7.825,31.7
2017,ISERE,Brié-et-Angonnes,1006,159,847,9,838,1,FN,188,7.825,31.7
2017,ISERE,Brié-et-Angonnes,1006,159,847,9,838,1,LFI,125,7.825,31.7
2017,ISERE,Brié-et-Angonnes,1006,159,847,9,838,1,LO,3,7.825,31.7
2017,ISERE,Brié-et-Angonnes,1006,159,847,9,838,1,LR,52,7.825,31.7
2017,ISERE,Brié-et-Angonnes,1006,159,847,9,838,1,LREM,292,7.825,31.7
2017,ISERE,Brié-et-Angonnes,1006,159,847,9,838,1,NPA,2,7.825,31.7
2017,ISERE,Brié-et-Angonnes,1006,159,847,9,838,1,PCF,11,7.825,31.7
2017,ISERE,Brié-et-Angonnes,1006,159,847,9,838,1,REC,60,7.825,31.7
2017,ISERE,Brié-et-Angonnes,1006,159,847,9,838,1,RES,19,7.825,31.7
2017,ISERE,Fontanil-Cornillon,1006,171,835,29,806,1,EELV,43,7.825,31.7
2017,ISERE,Fontanil-Cornillon,1006,171,835,29,806,1,FN,180,7.825,31.7
2017,ISERE,Fontanil-Cornillon,1006,171,835,29,806,1,LFI,154,7.825,31.7
2017,ISERE,Fontanil-Cornillon,1006,171,835,29,806,1,LO,3,7.825,31.7
2017,ISERE,Fontanil-Cornillon,1006,171,835,29,806,1,LR,46,7.825,31.7
2017,ISERE,Fontanil-Cornillon,1006,171,835,29,806,1,LREM,252,7.825,31.7
2017,ISERE,Fontanil-Cornillon,1006,171,835,29,806,1,NPA,4,7.825,31.7
2017,ISERE,Fontanil-Cornillon,1006,171,835,29,806,1,PCF,18,7.825,31.7
2017,ISERE,Fontanil-Cornillon,1006,171,835,29,806,1,REC,64,7.825,31.7
2017,ISERE,Fontanil-Cornillon,1006,171,835,29,806,1,RES,13,7.825,31.7
2017,ISERE,Saint-Marcellin,1006,276,730,10,720,1,EELV,28,7.825,31.7
2017,ISERE,Saint-Marcellin,1006,276,730,10,720,1,FN,176,7.825,31.7
2017,ISERE,Saint-Marcellin,1006,276,730,10,720,1,LFI,185,7.825,31.7
2017,ISERE,Saint-Marcellin,1006,276,730,10,720,1,LO,8,7.825,31.7
2017,ISERE,Saint-Marcellin,1006,276,730,10,720,1,LR,34,7.825,31.7
2017,ISERE,Saint-Marcellin,1006,276,730,10,720,1,LREM,171,7.825,31.7
2017,ISERE,Saint-Marcellin,1006,276,730,10,720,1,NPA,9,7.825,31.7
2017,ISERE,Saint-Marcellin,1006,276,730,10,720,1,PCF,18,7.825,31.7
2017,ISERE,Saint-Marcellin,1006,276,730,10,720,1,REC,56,7.825,31.7
2017,ISERE,Saint-Marcellin,1006,276,730,10,720,1,RES,16,7.825,31.7
2017,ISERE,Nivolas-Vermelle,1007,194,813,21,792,1,EELV,28,7.825,31.7
2017,ISERE,Nivolas-Vermelle,1007,194,813,21,792,1,FN,227,7.825,31.7
2017,ISERE,Nivolas-Vermelle,1007,194,813,21,792,1,LFI,137,7.825,31.7
2017,ISERE,Nivolas-Vermelle,1007,194,813,21,792,1,LO,3,7.825,31.7
2017,ISERE,Nivolas-Vermelle,1007,194,813,21,792,1,LR,42,7.825,31.7
2017,ISERE,Nivolas-Vermelle,1007,194,813,21,792,1,LREM,225,7.825,31.7
2017,ISERE,Nivolas-Vermelle,1007,194,813,21,792,1,NPA,4,7.825,31.7
2017,ISERE,Nivolas-Vermelle,1007,194,813,21,792,1,PCF,16,7.825,31.7
2017,ISERE,Nivolas-Vermelle,1007,194,813,21,792,1,REC,48,7.825,31.7
2017,ISERE,Nivolas-Vermelle,1007,194,813,21,792,1,RES,24,7.825,31.7
2017,ISERE,Grenoble,1011,189,822,9,813,1,EELV,113,7.825,31.7
2017,ISERE,Grenoble,1011,189,822,9,813,1,FN,66,7.825,31.7
2017,ISERE,Grenoble,1011,189,822,9,813,1,LFI,228,7.825,31.7
2017,ISERE,Grenoble,1011,189,822,9,813,1,LO,1,7.825,31.7
2017,ISERE,Grenoble,1011,189,822,9,813,1,LR,35,7.825,31.7
2017,ISERE,Grenoble,1011,189,822,9,813,1,LREM,234,7.825,31.7
2017,ISERE,Grenoble,1011,189,822,9,813,1,NPA,4,7.825,31.7
2017,ISERE,Grenoble,1011,189,822,9,813,1,PCF,11,7.825,31.7
2017,ISERE,Grenoble,1011,189,822,9,813,1,REC,75,7.825,31.7
2017,ISERE,Grenoble,1011,189,822,9,813,1,RES,16,7.825,31.7
2017,ISERE,Grenoble,1011,236,775,13,762,1,EELV,89,7.825,31.7
2017,ISERE,Grenoble,1011,236,775,13,762,1,FN,41,7.825,31.7
2017,ISERE,Grenoble,1011,236,775,13,762,1,LFI,348,7.825,31.7
2017,ISERE,Grenoble,1011,236,775,13,762,1,LO,2,7.825,31.7
2017,ISERE,Grenoble,1011,236,775,13,762,1,LR,17,7.825,31.7
2017,ISERE,Grenoble,1011,236,775,13,762,1,LREM,169,7.825,31.7
2017,ISERE,Grenoble,1011,236,775,13,762,1,NPA,8,7.825,31.7
2017,ISERE,Grenoble,1011,236,775,13,762,1,PCF,15,7.825,31.7
2017,ISERE,Grenoble,1011,236,775,13,762,1,REC,39,7.825,31.7
2017,ISERE,Grenoble,1011,236,775,13,762,1,RES,10,7.825,31.7
2017,ISERE,Grenoble,1011,277,734,15,719,1,EELV,72,7.825,31.7
2017,ISERE,Grenoble,1011,277,734,15,719,1,FN,110,7.825,31.7
2017,ISERE,Grenoble,1011,277,734,15,719,1,LFI,250,7.825,31.7
2017,ISERE,Grenoble,1011,277,734,15,719,1,LO,7,7.825,31.7
2017,ISERE,Grenoble,1011,277,734,15,719,1,LR,21,7.825,31.7
2017,ISERE,Grenoble,1011,277,734,15,719,1,LREM,148,7.825,31.7
2017,ISERE,Grenoble,1011,277,734,15,719,1,NPA,10,7.825,31.7
2017,ISERE,Grenoble,1011,277,734,15,719,1,PCF,26,7.825,31.7
2017,ISERE,Grenoble,1011,277,734,15,719,1,REC,39,7.825,31.7
2017,ISERE,Grenoble,1011,277,734,15,719,1,RES,6,7.825,31.7
2017,ISERE,Grenoble,1012,209,803,6,797,1,EELV,82,7.825,31.7
2017,ISERE,Grenoble,1012,209,803,6,797,1,FN,50,7.825,31.7
2017,ISERE,Grenoble,1012,209,803,6,797,1,LFI,330,7.825,31.7
2017,ISERE,Grenoble,1012,209,803,6,797,1,LO,2,7.825,31.7
2017,ISERE,Grenoble,1012,209,803,6,797,1,LR,25,7.825,31.7
2017,ISERE,Grenoble,1012,209,803,6,797,1,LREM,208,7.825,31.7
2017,ISERE,Grenoble,1012,209,803,6,797,1,NPA,6,7.825,31.7
2017,ISERE,Grenoble,1012,209,803,6,797,1,PCF,16,7.825,31.7
2017,ISERE,Grenoble,1012,209,803,6,797,1,REC,42,7.825,31.7
2017,ISERE,Grenoble,1012,209,803,6,797,1,RES,10,7.825,31.7
2017,ISERE,Saint-Jean-de-Bournay,1013,185,828,25,803,1,EELV,23,7.825,31.7
2017,ISERE,Saint-Jean-de-Bournay,1013,185,828,25,803,1,FN,266,7.825,31.7
2017,ISERE,Saint-Jean-de-Bournay,1013,185,828,25,803,1,LFI,96,7.825,31.7
2017,ISERE,Saint-Jean-de-Bournay,1013,185,828,25,803,1,LO,2,7.825,31.7
2017,ISERE,Saint-Jean-de-Bournay,1013,185,828,25,803,1,LR,41,7.825,31.7
2017,ISERE,Saint-Jean-de-Bournay,1013,185,828,25,803,1,LREM,212,7.825,31.7
2017,ISERE,Saint-Jean-de-Bournay,1013,185,828,25,803,1,NPA,4,7.825,31.7
2017,ISERE,Saint-Jean-de-Bournay,1013,185,828,25,803,1,PCF,11,7.825,31.7
2017,ISERE,Saint-Jean-de-Bournay,1013,185,828,25,803,1,REC,79,7.825,31.7
2017,ISERE,Saint-Jean-de-Bournay,1013,185,828,25,803,1,RES,38,7.825,31.7
2017,ISERE,La Tour-du-Pin,1014,322,692,12,680,1,EELV,31,7.825,31.7
2017,ISERE,La Tour-du-Pin,1014,322,692,12,680,1,FN,191,7.825,31.7
2017,ISERE,La Tour-du-Pin,1014,322,692,12,680,1,LFI,132,7.825,31.7
2017,ISERE,La Tour-du-Pin,1014,322,692,12,680,1,LO,2,7.825,31.7
2017,ISERE,La Tour-du-Pin,1014,322,692,12,680,1,LR,32,7.825,31.7
2017,ISERE,La Tour-du-Pin,1014,322,692,12,680,1,LREM,182,7.825,31.7
2017,ISERE,La Tour-du-Pin,1014,322,692,12,680,1,NPA,3,7.825,31.7
2017,ISERE,La Tour-du-Pin,1014,322,692,12,680,1,PCF,8,7.825,31.7
2017,ISERE,La Tour-du-Pin,1014,322,692,12,680,1,REC,52,7.825,31.7
2017,ISERE,La Tour-du-Pin,1014,322,692,12,680,1,RES,17,7.825,31.7
2017,ISERE,Bourgoin-Jallieu,1016,293,723,13,710,1,EELV,43,7.825,31.7
2017,ISERE,Bourgoin-Jallieu,1016,293,723,13,710,1,FN,119,7.825,31.7
2017,ISERE,Bourgoin-Jallieu,1016,293,723,13,710,1,LFI,180,7.825,31.7
2017,ISERE,Bourgoin-Jallieu,1016,293,723,13,710,1,LO,2,7.825,31.7
2017,ISERE,Bourgoin-Jallieu,1016,293,723,13,710,1,LR,51,7.825,31.7
2017,ISERE,Bourgoin-Jallieu,1016,293,723,13,710,1,LREM,197,7.825,31.7
2017,ISERE,Bourgoin-Jallieu,1016,293,723,13,710,1,NPA,1,7.825,31.7
2017,ISERE,Bourgoin-Jallieu,1016,293,723,13,710,1,PCF,19,7.825,31.7
2017,ISERE,Bourgoin-Jallieu,1016,293,723,13,710,1,REC,64,7.825,31.7
2017,ISERE,Bourgoin-Jallieu,1016,293,723,13,710,1,RES,10,7.825,31.7
2017,ISERE,Bourgoin-Jallieu,1016,307,709,12,697,1,EELV,31,7.825,31.7
2017,ISERE,Bourgoin-Jallieu,1016,307,709,12,697,1,FN,146,7.825,31.7
2017,ISERE,Bourgoin-Jallieu,1016,307,709,12,697,1,LFI,176,7.825,31.7
2017,ISERE,Bourgoin-Jallieu,1016,307,709,12,697,1,LO,3,7.825,31.7
2017,ISERE,Bourgoin-Jallieu,1016,307,709,12,697,1,LR,27,7.825,31.7
2017,ISERE,Bourgoin-Jallieu,1016,307,709,12,697,1,LREM,189,7.825,31.7
2017,ISERE,Bourgoin-Jallieu,1016,307,709,12,697,1,NPA,5,7.825,31.7
2017,ISERE,Bourgoin-Jallieu,1016,307,709,12,697,1,PCF,22,7.825,31.7
2017,ISERE,Bourgoin-Jallieu,1016,307,709,12,697,1,REC,58,7.825,31.7
2017,ISERE,Bourgoin-Jallieu,1016,307,709,12,697,1,RES,12,7.825,31.7
2017,ISERE,Saint-André-le-Gaz,1017,208,809,23,786,1,EELV,32,7.825,31.7
2017,ISERE,Saint-André-le-Gaz,1017,208,809,23,786,1,FN,258,7.825,31.7
2017,ISERE,Saint-André-le-Gaz,1017,208,809,23,786,1,LFI,154,7.825,31.7
2017,ISERE,Saint-André-le-Gaz,1017,208,809,23,786,1,LO,3,7.825,31.7
2017,ISERE,Saint-André-le-Gaz,1017,208,809,23,786,1,LR,36,7.825,31.7
2017,ISERE,Saint-André-le-Gaz,1017,208,809,23,786,1,LREM,169,7.825,31.7
2017,ISERE,Saint-André-le-Gaz,1017,208,809,23,786,1,NPA,4,7.825,31.7
2017,ISERE,Saint-André-le-Gaz,1017,208,809,23,786,1,PCF,21,7.825,31.7
2017,ISERE,Saint-André-le-Gaz,1017,208,809,23,786,1,REC,55,7.825,31.7
2017,ISERE,Saint-André-le-Gaz,1017,208,809,23,786,1,RES,20,7.825,31.7
2017,ISERE,Biviers,1022,129,893,10,883,1,EELV,66,7.825,31.7
2017,ISERE,Biviers,1022,129,893,10,883,1,FN,65,7.825,31.7
2017,ISERE,Biviers,1022,129,893,10,883,1,LFI,114,7.825,31.7
2017,ISERE,Biviers,1022,129,893,10,883,1,LO,3,7.825,31.7
2017,ISERE,Biviers,1022,129,893,10,883,1,LR,103,7.825,31.7
2017,ISERE,Biviers,1022,129,893,10,883,1,LREM,391,7.825,31.7
2017,ISERE,Biviers,1022,129,893,10,883,1,NPA,0,7.825,31.7
2017,ISERE,Biviers,1022,129,893,10,883,1,PCF,5,7.825,31.7
2017,ISERE,Biviers,1022,129,893,10,883,1,REC,92,7.825,31.7
2017,ISERE,Biviers,1022,129,893,10,883,1,RES,11,7.825,31.7
2017,ISERE,Crolles,1022,201,821,14,807,1,EELV,65,7.825,31.7
2017,ISERE,Crolles,1022,201,821,14,807,1,FN,132,7.825,31.7
2017,ISERE,Crolles,1022,201,821,14,807,1,LFI,206,7.825,31.7
2017,ISERE,Crolles,1022,201,821,14,807,1,LO,3,7.825,31.7
2017,ISERE,Crolles,1022,201,821,14,807,1,LR,25,7.825,31.7
2017,ISERE,Crolles,1022,201,821,14,807,1,LREM,257,7.825,31.7
2017,ISERE,Crolles,1022,201,821,14,807,1,NPA,1,7.825,31.7
2017,ISERE,Crolles,1022,201,821,14,807,1,PCF,20,7.825,31.7
2017,ISERE,Crolles,1022,201,821,14,807,1,REC,53,7.825,31.7
2017,ISERE,Crolles,1022,201,821,14,807,1,RES,19,7.825,31.7
2017,ISERE,Diémoz,1022,204,818,25,793,1,EELV,26,7.825,31.7
2017,ISERE,Diémoz,1022,204,818,25,793,1,FN,288,7.825,31.7
2017,ISERE,Diémoz,1022,204,818,25,793,1,LFI,119,7.825,31.7
2017,ISERE,Diémoz,1022,204,818,25,793,1,LO,7,7.825,31.7
2017,ISERE,Diémoz,1022,204,818,25,793,1,LR,33,7.825,31.7
2017,ISERE,Diémoz,1022,204,818,25,793,1,LREM,158,7.825,31.7
2017,ISERE,Diémoz,1022,204,818,25,793,1,NPA,6,7.825,31.7
2017,ISERE,Diémoz,1022,204,818,25,793,1,PCF,16,7.825,31.7
2017,ISERE,Diémoz,1022,204,818,25,793,1,REC,74,7.825,31.7
2017,ISERE,Diémoz,1022,204,818,25,793,1,RES,19,7.825,31.7
2017,ISERE,Grenoble,1022,255,767,15,752,1,EELV,69,7.825,31.7
2017,ISERE,Grenoble,1022,255,767,15,752,1,FN,84,7.825,31.7
2017,ISERE,Grenoble,1022,255,767,15,752,1,LFI,300,7.825,31.7
2017,ISERE,Grenoble,1022,255,767,15,752,1,LO,3,7.825,31.7
2017,ISERE,Grenoble,1022,255,767,15,752,1,LR,25,7.825,31.7
2017,ISERE,Grenoble,1022,255,767,15,752,1,LREM,167,7.825,31.7
2017,ISERE,Grenoble,1022,255,767,15,752,1,NPA,8,7.825,31.7
2017,ISERE,Grenoble,1022,255,767,15,752,1,PCF,28,7.825,31.7
2017,ISERE,Grenoble,1022,255,767,15,752,1,REC,28,7.825,31.7
2017,ISERE,Grenoble,1022,255,767,15,752,1,RES,8,7.825,31.7
2017,ISERE,Saint-Hilaire-du-Rosier,1023,247,776,20,756,1,EELV,37,7.825,31.7
2017,ISERE,Saint-Hilaire-du-Rosier,1023,247,776,20,756,1,FN,262,7.825,31.7
2017,ISERE,Saint-Hilaire-du-Rosier,1023,247,776,20,756,1,LFI,117,7.825,31.7
2017,ISERE,Saint-Hilaire-du-Rosier,1023,247,776,20,756,1,LO,6,7.825,31.7
2017,ISERE,Saint-Hilaire-du-Rosier,1023,247,776,20,756,1,LR,28,7.825,31.7
2017,ISERE,Saint-Hilaire-du-Rosier,1023,247,776,20,756,1,LREM,162,7.825,31.7
2017,ISERE,Saint-Hilaire-du-Rosier,1023,247,776,20,756,1,NPA,8,7.825,31.7
2017,ISERE,Saint-Hilaire-du-Rosier,1023,247,776,20,756,1,PCF,20,7.825,31.7
2017,ISERE,Saint-Hilaire-du-Rosier,1023,247,776,20,756,1,REC,50,7.825,31.7
2017,ISERE,Saint-Hilaire-du-Rosier,1023,247,776,20,756,1,RES,22,7.825,31.7
2017,ISERE,Le Pont-de-Claix,1023,265,758,17,741,1,EELV,39,7.825,31.7
2017,ISERE,Le Pont-de-Claix,1023,265,758,17,741,1,FN,187,7.825,31.7
2017,ISERE,Le Pont-de-Claix,1023,265,758,17,741,1,LFI,201,7.825,31.7
2017,ISERE,Le Pont-de-Claix,1023,265,758,17,741,1,LO,3,7.825,31.7
2017,ISERE,Le Pont-de-Claix,1023,265,758,17,741,1,LR,27,7.825,31.7
2017,ISERE,Le Pont-de-Claix,1023,265,758,17,741,1,LREM,184,7.825,31.7
2017,ISERE,Le Pont-de-Claix,1023,265,758,17,741,1,NPA,2,7.825,31.7
2017,ISERE,Le Pont-de-Claix,1023,265,758,17,741,1,PCF,18,7.825,31.7
2017,ISERE,Le Pont-de-Claix,1023,265,758,17,741,1,REC,47,7.825,31.7
2017,ISERE,Le Pont-de-Claix,1023,265,758,17,741,1,RES,13,7.825,31.7
2017,ISERE,Fontaine,1025,276,749,12,737,1,EELV,48,7.825,31.7
2017,ISERE,Fontaine,1025,276,749,12,737,1,FN,125,7.825,31.7
2017,ISERE,Fontaine,1025,276,749,12,737,1,LFI,304,7.825,31.7
2017,ISERE,Fontaine,1025,276,749,12,737,1,LO,6,7.825,31.7
2017,ISERE,Fontaine,1025,276,749,12,737,1,LR,12,7.825,31.7
2017,ISERE,Fontaine,1025,276,749,12,737,1,LREM,140,7.825,31.7
2017,ISERE,Fontaine,1025,276,749,12,737,1,NPA,7,7.825,31.7
2017,ISERE,Fontaine,1025,276,749,12,737,1,PCF,29,7.825,31.7
2017,ISERE,Fontaine,1025,276,749,12,737,1,REC,38,7.825,31.7
2017,ISERE,Fontaine,1025,276,749,12,737,1,RES,4,7.825,31.7
2017,ISERE,Grenoble,1027,184,843,10,833,1,EELV,117,7.825,31.7
2017,ISERE,Grenoble,1027,184,843,10,833,1,FN,74,7.825,31.7
2017,ISERE,Grenoble,1027,184,843,10,833,1,LFI,279,7.825,31.7
2017,ISERE,Grenoble,1027,184,843,10,833,1,LO,1,7.825,31.7
2017,ISERE,Grenoble,1027,184,843,10,833,1,LR,23,7.825,31.7
2017,ISERE,Grenoble,1027,184,843,10,833,1,LREM,220,7.825,31.7
2017,ISERE,Grenoble,1027,184,843,10,833,1,NPA,6,7.825,31.7
2017,ISERE,Grenoble,1027,184,843,10,833,1,PCF,22,7.825,31.7
2017,ISERE,Grenoble,1027,184,843,10,833,1,REC,48,7.825,31.7
2017,ISERE,Grenoble,1027,184,843,10,833,1,RES,11,7.825,31.7
2017,ISERE,Apprieu,1028,172,856,27,829,1,EELV,39,7.825,31.7
2017,ISERE,Apprieu,1028,172,856,27,829,1,FN,205,7.825,31.7
2017,ISERE,Apprieu,1028,172,856,27,829,1,LFI,168,7.825,31.7
2017,ISERE,Apprieu,1028,172,856,27,829,1,LO,1,7.825,31.7
2017,ISERE,Apprieu,1028,172,856,27,829,1,LR,35,7.825,31.7
2017,ISERE,Apprieu,1028,172,856,27,829,1,LREM,258,7.825,31.7
2017,ISERE,Apprieu,1028,172,856,27,829,1,NPA,4,7.825,31.7
2017,ISERE,Apprieu,1028,172,856,27,829,1,PCF,18,7.825,31.7
2017,ISERE,Apprieu,1028,172,856,27,829,1,REC,49,7.825,31.7
2017,ISERE,Apprieu,1028,172,856,27,829,1,RES,27,7.825,31.7
2017,ISERE,Grenoble,1028,202,826,13,813,1,EELV,104,7.825,31.7
2017,ISERE,Grenoble,1028,202,826,13,813,1,FN,40,7.825,31.7
2017,ISERE,Grenoble,1028,202,826,13,813,1,LFI,274,7.825,31.7
2017,ISERE,Grenoble,1028,202,826,13,813,1,LO,1,7.825,31.7
2017,ISERE,Grenoble,1028,202,826,13,813,1,LR,24,7.825,31.7
2017,ISERE,Grenoble,1028,202,826,13,813,1,LREM,273,7.825,31.7
2017,ISERE,Grenoble,1028,202,826,13,813,1,NPA,10,7.825,31.7
2017,ISERE,Grenoble,1028,202,826,13,813,1,PCF,14,7.825,31.7
2017,ISERE,Grenoble,1028,202,826,13,813,1,REC,40,7.825,31.7
2017,ISERE,Grenoble,1028,202,826,13,813,1,RES,9,7.825,31.7
2017,ISERE,Echirolles,1028,232,796,18,778,1,EELV,42,7.825,31.7
2017,ISERE,Echirolles,1028,232,796,18,778,1,FN,148,7.825,31.7
2017,ISERE,Echirolles,1028,232,796,18,778,1,LFI,263,7.825,31.7
2017,ISERE,Echirolles,1028,232,796,18,778,1,LO,4,7.825,31.7
2017,ISERE,Echirolles,1028,232,796,18,778,1,LR,28,7.825,31.7
2017,ISERE,Echirolles,1028,232,796,18,778,1,LREM,165,7.825,31.7
2017,ISERE,Echirolles,1028,232,796,18,778,1,NPA,9,7.825,31.7
2017,ISERE,Echirolles,1028,232,796,18,778,1,PCF,28,7.825,31.7
2017,ISERE,Echirolles,1028,232,796,18,778,1,REC,36,7.825,31.7
2017,ISERE,Echirolles,1028,232,796,18,778,1,RES,35,7.825,31.7
2017,ISERE,Le Pont-de-Beauvoisin,1028,263,765,15,750,1,EELV,32,7.825,31.7
2017,ISERE,Le Pont-de-Beauvoisin,1028,263,765,15,750,1,FN,215,7.825,31.7
2017,ISERE,Le Pont-de-Beauvoisin,1028,263,765,15,750,1,LFI,185,7.825,31.7
2017,ISERE,Le Pont-de-Beauvoisin,1028,263,765,15,750,1,LO,5,7.825,31.7
2017,ISERE,Le Pont-de-Beauvoisin,1028,263,765,15,750,1,LR,31,7.825,31.7
2017,ISERE,Le Pont-de-Beauvoisin,1028,263,765,15,750,1,LREM,175,7.825,31.7
2017,ISERE,Le Pont-de-Beauvoisin,1028,263,765,15,750,1,NPA,5,7.825,31.7
2017,ISERE,Le Pont-de-Beauvoisin,1028,263,765,15,750,1,PCF,12,7.825,31.7
2017,ISERE,Le Pont-de-Beauvoisin,1028,263,765,15,750,1,REC,49,7.825,31.7
2017,ISERE,Le Pont-de-Beauvoisin,1028,263,765,15,750,1,RES,16,7.825,31.7
2017,ISERE,Septème,1030,190,840,25,815,1,EELV,27,7.825,31.7
2017,ISERE,Septème,1030,190,840,25,815,1,FN,287,7.825,31.7
2017,ISERE,Septème,1030,190,840,25,815,1,LFI,113,7.825,31.7
2017,ISERE,Septème,1030,190,840,25,815,1,LO,5,7.825,31.7
2017,ISERE,Septème,1030,190,840,25,815,1,LR,24,7.825,31.7
2017,ISERE,Septème,1030,190,840,25,815,1,LREM,195,7.825,31.7
2017,ISERE,Septème,1030,190,840,25,815,1,NPA,9,7.825,31.7
2017,ISERE,Septème,1030,190,840,25,815,1,PCF,14,7.825,31.7
2017,ISERE,Septème,1030,190,840,25,815,1,REC,83,7.825,31.7
2017,ISERE,Septème,1030,190,840,25,815,1,RES,26,7.825,31.7
2017,ISERE,Sonnay,1030,215,815,16,799,1,EELV,26,7.825,31.7
2017,ISERE,Sonnay,1030,215,815,16,799,1,FN,280,7.825,31.7
2017,ISERE,Sonnay,1030,215,815,16,799,1,LFI,116,7.825,31.7
2017,ISERE,Sonnay,1030,215,815,16,799,1,LO,8,7.825,31.7
2017,ISERE,Sonnay,1030,215,815,16,799,1,LR,35,7.825,31.7
2017,ISERE,Sonnay,1030,215,815,16,799,1,LREM,186,7.825,31.7
2017,ISERE,Sonnay,1030,215,815,16,799,1,NPA,11,7.825,31.7
2017,ISERE,Sonnay,1030,215,815,16,799,1,PCF,16,7.825,31.7
2017,ISERE,Sonnay,1030,215,815,16,799,1,REC,64,7.825,31.7
2017,ISERE,Sonnay,1030,215,815,16,799,1,RES,23,7.825,31.7
2017,ISERE,Charvieu-Chavagneux,1030,372,658,12,646,1,EELV,11,7.825,31.7
2017,ISERE,Charvieu-Chavagneux,1030,372,658,12,646,1,FN,159,7.825,31.7
2017,ISERE,Charvieu-Chavagneux,1030,372,658,12,646,1,LFI,230,7.825,31.7
2017,ISERE,Charvieu-Chavagneux,1030,372,658,12,646,1,LO,3,7.825,31.7
2017,ISERE,Charvieu-Chavagneux,1030,372,658,12,646,1,LR,12,7.825,31.7
2017,ISERE,Charvieu-Chavagneux,1030,372,658,12,646,1,LREM,112,7.825,31.7
2017,ISERE,Charvieu-Chavagneux,1030,372,658,12,646,1,NPA,6,7.825,31.7
2017,ISERE,Charvieu-Chavagneux,1030,372,658,12,646,1,PCF,15,7.825,31.7
2017,ISERE,Charvieu-Chavagneux,1030,372,658,12,646,1,REC,75,7.825,31.7
2017,ISERE,Charvieu-Chavagneux,1030,372,658,12,646,1,RES,6,7.825,31.7
2017,ISERE,Saint-Just-Chaleyssin,1032,193,839,9,830,1,EELV,44,7.825,31.7
2017,ISERE,Saint-Just-Chaleyssin,1032,193,839,9,830,1,FN,209,7.825,31.7
2017,ISERE,Saint-Just-Chaleyssin,1032,193,839,9,830,1,LFI,108,7.825,31.7
2017,ISERE,Saint-Just-Chaleyssin,1032,193,839,9,830,1,LO,1,7.825,31.7
2017,ISERE,Saint-Just-Chaleyssin,1032,193,839,9,830,1,LR,62,7.825,31.7
2017,ISERE,Saint-Just-Chaleyssin,1032,193,839,9,830,1,LREM,266,7.825,31.7
2017,ISERE,Saint-Just-Chaleyssin,1032,193,839,9,830,1,NPA,6,7.825,31.7
2017,ISERE,Saint-Just-Chaleyssin,1032,193,839,9,830,1,PCF,18,7.825,31.7
2017,ISERE,Saint-Just-Chaleyssin,1032,193,839,9,830,1,REC,61,7.825,31.7
2017,ISERE,Saint-Just-Chaleyssin,1032,193,839,9,830,1,RES,19,7.825,31.7
2017,ISERE,Valencin,1033,185,848,17,831,1,EELV,40,7.825,31.7
2017,ISERE,Valencin,1033,185,848,17,831,1,FN,249,7.825,31.7
2017,ISERE,Valencin,1033,185,848,17,831,1,LFI,98,7.825,31.7
2017,ISERE,Valencin,1033,185,848,17,831,1,LO,2,7.825,31.7
2017,ISERE,Valencin,1033,185,848,17,831,1,LR,34,7.825,31.7
2017,ISERE,Valencin,1033,185,848,17,831,1,LREM,267,7.825,31.7
2017,ISERE,Valencin,1033,185,848,17,831,1,NPA,9,7.825,31.7
2017,ISERE,Valencin,1033,185,848,17,831,1,PCF,9,7.825,31.7
2017,ISERE,Valencin,1033,185,848,17,831,1,REC,70,7.825,31.7
2017,ISERE,Valencin,1033,185,848,17,831,1,RES,23,7.825,31.7
2017,ISERE,Seyssinet-Pariset,1033,229,804,8,796,1,EELV,71,7.825,31.7
2017,ISERE,Seyssinet-Pariset,1033,229,804,8,796,1,FN,138,7.825,31.7
2017,ISERE,Seyssinet-Pariset,1033,229,804,8,796,1,LFI,189,7.825,31.7
2017,ISERE,Seyssinet-Pariset,1033,229,804,8,796,1,LO,3,7.825,31.7
2017,ISERE,Seyssinet-Pariset,1033,229,804,8,796,1,LR,30,7.825,31.7
2017,ISERE,Seyssinet-Pariset,1033,229,804,8,796,1,LREM,211,7.825,31.7
2017,ISERE,Seyssinet-Pariset,1033,229,804,8,796,1,NPA,2,7.825,31.7
2017,ISERE,Seyssinet-Pariset,1033,229,804,8,796,1,PCF,22,7.825,31.7
2017,ISERE,Seyssinet-Pariset,1033,229,804,8,796,1,REC,70,7.825,31.7
2017,ISERE,Seyssinet-Pariset,1033,229,804,8,796,1,RES,13,7.825,31.7
2017,ISERE,Montbonnot-Saint-Martin,1035,151,884,11,873,1,EELV,85,7.825,31.7
2017,ISERE,Montbonnot-Saint-Martin,1035,151,884,11,873,1,FN,111,7.825,31.7
2017,ISERE,Montbonnot-Saint-Martin,1035,151,884,11,873,1,LFI,124,7.825,31.7
2017,ISERE,Montbonnot-Saint-Martin,1035,151,884,11,873,1,LO,3,7.825,31.7
2017,ISERE,Montbonnot-Saint-Martin,1035,151,884,11,873,1,LR,71,7.825,31.7
2017,ISERE,Montbonnot-Saint-Martin,1035,151,884,11,873,1,LREM,364,7.825,31.7
2017,ISERE,Montbonnot-Saint-Martin,1035,151,884,11,873,1,NPA,1,7.825,31.7
2017,ISERE,Montbonnot-Saint-Martin,1035,151,884,11,873,1,PCF,6,7.825,31.7
2017,ISERE,Montbonnot-Saint-Martin,1035,151,884,11,873,1,REC,69,7.825,31.7
2017,ISERE,Montbonnot-Saint-Martin,1035,151,884,11,873,1,RES,10,7.825,31.7
2017,ISERE,Seyssins,1036,159,877,9,868,1,EELV,81,7.825,31.7
2017,ISERE,Seyssins,1036,159,877,9,868,1,FN,101,7.825,31.7
2017,ISERE,Seyssins,1036,159,877,9,868,1,LFI,149,7.825,31.7
2017,ISERE,Seyssins,1036,159,877,9,868,1,LO,1,7.825,31.7
2017,ISERE,Seyssins,1036,159,877,9,868,1,LR,65,7.825,31.7
2017,ISERE,Seyssins,1036,159,877,9,868,1,LREM,356,7.825,31.7
2017,ISERE,Seyssins,1036,159,877,9,868,1,NPA,3,7.825,31.7
2017,ISERE,Seyssins,1036,159,877,9,868,1,PCF,11,7.825,31.7
2017,ISERE,Seyssins,1036,159,877,9,868,1,REC,71,7.825,31.7
2017,ISERE,Seyssins,1036,159,877,9,868,1,RES,15,7.825,31.7
2017,ISERE,Renage,1037,245,792,27,765,1,EELV,35,7.825,31.7
2017,ISERE,Renage,1037,245,792,27,765,1,FN,172,7.825,31.7
2017,ISERE,Renage,1037,245,792,27,765,1,LFI,179,7.825,31.7
2017,ISERE,Renage,1037,245,792,27,765,1,LO,14,7.825,31.7
2017,ISERE,Renage,1037,245,792,27,765,1,LR,23,7.825,31.7
2017,ISERE,Renage,1037,245,792,27,765,1,LREM,223,7.825,31.7
2017,ISERE,Renage,1037,245,792,27,765,1,NPA,3,7.825,31.7
2017,ISERE,Renage,1037,245,792,27,765,1,PCF,31,7.825,31.7
2017,ISERE,Renage,1037,245,792,27,765,1,REC,35,7.825,31.7
2017,ISERE,Renage,1037,245,792,27,765,1,RES,18,7.825,31.7
2017,ISERE,Voiron,1038,275,763,16,747,1,EELV,49,7.825,31.7
2017,ISERE,Voiron,1038,275,763,16,747,1,FN,130,7.825,31.7
2017,ISERE,Voiron,1038,275,763,16,747,1,LFI,172,7.825,31.7
2017,ISERE,Voiron,1038,275,763,16,747,1,LO,2,7.825,31.7
2017,ISERE,Voiron,1038,275,763,16,747,1,LR,45,7.825,31.7
2017,ISERE,Voiron,1038,275,763,16,747,1,LREM,222,7.825,31.7
2017,ISERE,Voiron,1038,275,763,16,747,1,NPA,4,7.825,31.7
2017,ISERE,Voiron,1038,275,763,16,747,1,PCF,14,7.825,31.7
2017,ISERE,Voiron,1038,275,763,16,747,1,REC,54,7.825,31.7
2017,ISERE,Voiron,1038,275,763,16,747,1,RES,22,7.825,31.7
2017,ISERE,Echirolles,1039,234,805,15,790,1,EELV,39,7.825,31.7
2017,ISERE,Echirolles,1039,234,805,15,790,1,FN,159,7.825,31.7
2017,ISERE,Echirolles,1039,234,805,15,790,1,LFI,209,7.825,31.7
2017,ISERE,Echirolles,1039,234,805,15,790,1,LO,9,7.825,31.7
2017,ISERE,Echirolles,1039,234,805,15,790,1,LR,32,7.825,31.7
2017,ISERE,Echirolles,1039,234,805,15,790,1,LREM,229,7.825,31.7
2017,ISERE,Echirolles,1039,234,805,15,790,1,NPA,3,7.825,31.7
2017,ISERE,Echirolles,1039,234,805,15,790,1,PCF,14,7.825,31.7
2017,ISERE,Echirolles,1039,234,805,15,790,1,REC,51,7.825,31.7
2017,ISERE,Echirolles,1039,234,805,15,790,1,RES,15,7.825,31.7
2017,ISERE,La Verpillière,1039,236,803,11,792,1,EELV,33,7.825,31.7
2017,ISERE,La Verpillière,1039,236,803,11,792,1,FN,221,7.825,31.7
2017,ISERE,La Verpillière,1039,236,803,11,792,1,LFI,153,7.825,31.7
2017,ISERE,La Verpillière,1039,236,803,11,792,1,LO,4,7.825,31.7
2017,ISERE,La Verpillière,1039,236,803,11,792,1,LR,35,7.825,31.7
2017,ISERE,La Verpillière,1039,236,803,11,792,1,LREM,214,7.825,31.7
2017,ISERE,La Verpillière,1039,236,803,11,792,1,NPA,3,7.825,31.7
2017,ISERE,La Verpillière,1039,236,803,11,792,1,PCF,17,7.825,31.7
2017,ISERE,La Verpillière,1039,236,803,11,792,1,REC,65,7.825,31.7
2017,ISERE,La Verpillière,1039,236,803,11,792,1,RES,22,7.825,31.7
2017,ISERE,Allevard,1039,263,776,11,765,1,EELV,44,7.825,31.7
2017,ISERE,Allevard,1039,263,776,11,765,1,FN,162,7.825,31.7
2017,ISERE,Allevard,1039,263,776,11,765,1,LFI,195,7.825,31.7
2017,ISERE,Allevard,1039,263,776,11,765,1,LO,1,7.825,31.7
2017,ISERE,Allevard,1039,263,776,11,765,1,LR,39,7.825,31.7
2017,ISERE,Allevard,1039,263,776,11,765,1,LREM,202,7.825,31.7
2017,ISERE,Allevard,1039,263,776,11,765,1,NPA,8,7.825,31.7
2017,ISERE,Allevard,1039,263,776,11,765,1,PCF,13,7.825,31.7
2017,ISERE,Allevard,1039,263,776,11,765,1,REC,50,7.825,31.7
2017,ISERE,Allevard,1039,263,776,11,765,1,RES,25,7.825,31.7
2017,ISERE,Meylan,1040,207,833,19,814,1,EELV,65,7.825,31.7
2017,ISERE,Meylan,1040,207,833,19,814,1,FN,110,7.825,31.7
2017,ISERE,Meylan,1040,207,833,19,814,1,LFI,174,7.825,31.7
2017,ISERE,Meylan,1040,207,833,19,814,1,LO,1,7.825,31.7
2017,ISERE,Meylan,1040,207,833,19,814,1,LR,38,7.825,31.7
2017,ISERE,Meylan,1040,207,833,19,814,1,LREM,314,7.825,31.7
2017,ISERE,Meylan,1040,207,833,19,814,1,NPA,8,7.825,31.7
2017,ISERE,Meylan,1040,207,833,19,814,1,PCF,16,7.825,31.7
2017,ISERE,Meylan,1040,207,833,19,814,1,REC,52,7.825,31.7
2017,ISERE,Meylan,1040,207,833,19,814,1,RES,16,7.825,31.7
2017,ISERE,Jarrie,1040,222,818,19,799,1,EELV,24,7.825,31.7
2017,ISERE,Jarrie,1040,222,818,19,799,1,FN,268,7.825,31.7
2017,ISERE,Jarrie,1040,222,818,19,799,1,LFI,159,7.825,31.7
2017,ISERE,Jarrie,1040,222,818,19,799,1,LO,8,7.825,31.7
2017,ISERE,Jarrie,1040,222,818,19,799,1,LR,24,7.825,31.7
2017,ISERE,Jarrie,1040,222,818,19,799,1,LREM,175,7.825,31.7
2017,ISERE,Jarrie,1040,222,818,19,799,1,NPA,9,7.825,31.7
2017,ISERE,Jarrie,1040,222,818,19,799,1,PCF,18,7.825,31.7
2017,ISERE,Jarrie,1040,222,818,19,799,1,REC,53,7.825,31.7
2017,ISERE,Jarrie,1040,222,818,19,799,1,RES,29,7.825,31.7
2017,ISERE,Chavanoz,1040,246,794,21,773,1,EELV,22,7.825,31.7
2017,ISERE,Chavanoz,1040,246,794,21,773,1,FN,259,7.825,31.7
2017,ISERE,Chavanoz,1040,246,794,21,773,1,LFI,183,7.825,31.7
2017,ISERE,Chavanoz,1040,246,794,21,773,1,LO,3,7.825,31.7
2017,ISERE,Chavanoz,1040,246,794,21,773,1,LR,31,7.825,31.7
2017,ISERE,Chavanoz,1040,246,794,21,773,1,LREM,159,7.825,31.7
2017,ISERE,Chavanoz,1040,246,794,21,773,1,NPA,0,7.825,31.7
2017,ISERE,Chavanoz,1040,246,794,21,773,1,PCF,14,7.825,31.7
2017,ISERE,Chavanoz,1040,246,794,21,773,1,REC,72,7.825,31.7
2017,ISERE,Chavanoz,1040,246,794,21,773,1,RES,10,7.825,31.7
2017,ISERE,Saint-Paul-de-Varces,1042,153,889,16,873,1,EELV,63,7.825,31.7
2017,ISERE,Saint-Paul-de-Varces,1042,153,889,16,873,1,FN,209,7.825,31.7
2017,ISERE,Saint-Paul-de-Varces,1042,153,889,16,873,1,LFI,149,7.825,31.7
2017,ISERE,Saint-Paul-de-Varces,1042,153,889,16,873,1,LO,6,7.825,31.7
2017,ISERE,Saint-Paul-de-Varces,1042,153,889,16,873,1,LR,40,7.825,31.7
2017,ISERE,Saint-Paul-de-Varces,1042,153,889,16,873,1,LREM,276,7.825,31.7
2017,ISERE,Saint-Paul-de-Varces,1042,153,889,16,873,1,NPA,7,7.825,31.7
2017,ISERE,Saint-Paul-de-Varces,1042,153,889,16,873,1,PCF,14,7.825,31.7
2017,ISERE,Saint-Paul-de-Varces,1042,153,889,16,873,1,REC,64,7.825,31.7
2017,ISERE,Saint-Paul-de-Varces,1042,153,889,16,873,1,RES,22,7.825,31.7
2017,ISERE,Crolles,1042,180,862,9,853,1,EELV,104,7.825,31.7
2017,ISERE,Crolles,1042,180,862,9,853,1,FN,95,7.825,31.7
2017,ISERE,Crolles,1042,180,862,9,853,1,LFI,161,7.825,31.7
2017,ISERE,Crolles,1042,180,862,9,853,1,LO,1,7.825,31.7
2017,ISERE,Crolles,1042,180,862,9,853,1,LR,35,7.825,31.7
2017,ISERE,Crolles,1042,180,862,9,853,1,LREM,315,7.825,31.7
2017,ISERE,Crolles,1042,180,862,9,853,1,NPA,7,7.825,31.7
2017,ISERE,Crolles,1042,180,862,9,853,1,PCF,23,7.825,31.7
2017,ISERE,Crolles,1042,180,862,9,853,1,REC,56,7.825,31.7
2017,ISERE,Crolles,1042,180,862,9,853,1,RES,22,7.825,31.7
2017,ISERE,Bougé-Chambalud,1043,199,844,18,826,1,EELV,30,7.825,31.7
2017,ISERE,Bougé-Chambalud,1043,199,844,18,826,1,FN,289,7.825,31.7
2017,ISERE,Bougé-Chambalud,1043,199,844,18,826,1,LFI,88,7.825,31.7
2017,ISERE,Bougé-Chambalud,1043,199,844,18,826,1,LO,6,7.825,31.7
2017,ISERE,Bougé-Chambalud,1043,199,844,18,826,1,LR,34,7.825,31.7
2017,ISERE,Bougé-Chambalud,1043,199,844,18,826,1,LREM,238,7.825,31.7
2017,ISERE,Bougé-Chambalud,1043,199,844,18,826,1,NPA,4,7.825,31.7
2017,ISERE,Bougé-Chambalud,1043,199,844,18,826,1,PCF,13,7.825,31.7
2017,ISERE,Bougé-Chambalud,1043,199,844,18,826,1,REC,50,7.825,31.7
2017,ISERE,Bougé-Chambalud,1043,199,844,18,826,1,RES,34,7.825,31.7
2017,ISERE,Le Gua,1043,208,835,18,817,1,EELV,41,7.825,31.7
2017,ISERE,Le Gua,1043,208,835,18,817,1,FN,210,7.825,31.7
2017,ISERE,Le Gua,1043,208,835,18,817,1,LFI,156,7.825,31.7
2017,ISERE,Le Gua,1043,208,835,18,817,1,LO,4,7.825,31.7
2017,ISERE,Le Gua,1043,208,835,18,817,1,LR,37,7.825,31.7
2017,ISERE,Le Gua,1043,208,835,18,817,1,LREM,236,7.825,31.7
2017,ISERE,Le Gua,1043,208,835,18,817,1,NPA,5,7.825,31.7
2017,ISERE,Le Gua,1043,208,835,18,817,1,PCF,22,7.825,31.7
2017,ISERE,Le Gua,1043,208,835,18,817,1,REC,56,7.825,31.7
2017,ISERE,Le Gua,1043,208,835,18,817,1,RES,24,7.825,31.7
2017,ISERE,Chatte,1044,266,778,23,755,1,EELV,35,7.825,31.7
2017,ISERE,Chatte,1044,266,778,23,755,1,FN,191,7.825,31.7
2017,ISERE,Chatte,1044,266,778,23,755,1,LFI,119,7.825,31.7
2017,ISERE,Chatte,1044,266,778,23,755,1,LO,4,7.825,31.7
2017,ISERE,Chatte,1044,266,778,23,755,1,LR,45,7.825,31.7
2017,ISERE,Chatte,1044,266,778,23,755,1,LREM,203,7.825,31.7
2017,ISERE,Chatte,1044,266,778,23,755,1,NPA,6,7.825,31.7
2017,ISERE,Chatte,1044,266,778,23,755,1,PCF,11,7.825,31.7
2017,ISERE,Chatte,1044,266,778,23,755,1,REC,67,7.825,31.7
2017,ISERE,Chatte,1044,266,778,23,755,1,RES,39,7.825,31.7
2017,ISERE,Saint-Georges-de-Commiers,1046,184,862,25,837,1,EELV,32,7.825,31.7
2017,ISERE,Saint-Georges-de-Commiers,1046,184,862,25,837,1,FN,251,7.825,31.7
2017,ISERE,Saint-Georges-de-Commiers,1046,184,862,25,837,1,LFI,148,7.825,31.7
2017,ISERE,Saint-Georges-de-Commiers,1046,184,862,25,837,1,LO,4,7.825,31.7
2017,ISERE,Saint-Georges-de-Commiers,1046,184,862,25,837,1,LR,20,7.825,31.7
2017,ISERE,Saint-Georges-de-Commiers,1046,184,862,25,837,1,LREM,219,7.825,31.7
2017,ISERE,Saint-Georges-de-Commiers,1046,184,862,25,837,1,NPA,8,7.825,31.7
2017,ISERE,Saint-Georges-de-Commiers,1046,184,862,25,837,1,PCF,24,7.825,31.7
2017,ISERE,Saint-Georges-de-Commiers,1046,184,862,25,837,1,REC,80,7.825,31.7
2017,ISERE,Saint-Georges-de-Commiers,1046,184,862,25,837,1,RES,22,7.825,31.7
2017,ISERE,Varces-Allières-et-Risset,1046,196,850,13,837,1,EELV,47,7.825,31.7
2017,ISERE,Varces-Allières-et-Risset,1046,196,850,13,837,1,FN,187,7.825,31.7
2017,ISERE,Varces-Allières-et-Risset,1046,196,850,13,837,1,LFI,181,7.825,31.7
2017,ISERE,Varces-Allières-et-Risset,1046,196,850,13,837,1,LO,4,7.825,31.7
2017,ISERE,Varces-Allières-et-Risset,1046,196,850,13,837,1,LR,40,7.825,31.7
2017,ISERE,Varces-Allières-et-Risset,1046,196,850,13,837,1,LREM,236,7.825,31.7
2017,ISERE,Varces-Allières-et-Risset,1046,196,850,13,837,1,NPA,2,7.825,31.7
2017,ISERE,Varces-Allières-et-Risset,1046,196,850,13,837,1,PCF,17,7.825,31.7
2017,ISERE,Varces-Allières-et-Risset,1046,196,850,13,837,1,REC,69,7.825,31.7
2017,ISERE,Varces-Allières-et-Risset,1046,196,850,13,837,1,RES,21,7.825,31.7
2017,ISERE,Chatte,1048,209,839,25,814,1,EELV,51,7.825,31.7
2017,ISERE,Chatte,1048,209,839,25,814,1,FN,247,7.825,31.7
2017,ISERE,Chatte,1048,209,839,25,814,1,LFI,149,7.825,31.7
2017,ISERE,Chatte,1048,209,839,25,814,1,LO,6,7.825,31.7
2017,ISERE,Chatte,1048,209,839,25,814,1,LR,39,7.825,31.7
2017,ISERE,Chatte,1048,209,839,25,814,1,LREM,209,7.825,31.7
2017,ISERE,Chatte,1048,209,839,25,814,1,NPA,7,7.825,31.7
2017,ISERE,Chatte,1048,209,839,25,814,1,PCF,16,7.825,31.7
2017,ISERE,Chatte,1048,209,839,25,814,1,REC,45,7.825,31.7
2017,ISERE,Chatte,1048,209,839,25,814,1,RES,22,7.825,31.7
2017,ISERE,La Côte-Saint-André,1048,352,696,14,682,1,EELV,26,7.825,31.7
2017,ISERE,La Côte-Saint-André,1048,352,696,14,682,1,FN,169,7.825,31.7
2017,ISERE,La Côte-Saint-André,1048,352,696,14,682,1,LFI,119,7.825,31.7
2017,ISERE,La Côte-Saint-André,1048,352,696,14,682,1,LO,6,7.825,31.7
2017,ISERE,La Côte-Saint-André,1048,352,696,14,682,1,LR,29,7.825,31.7
2017,ISERE,La Côte-Saint-André,1048,352,696,14,682,1,LREM,197,7.825,31.7
2017,ISERE,La Côte-Saint-André,1048,352,696,14,682,1,NPA,11,7.825,31.7
2017,ISERE,La Côte-Saint-André,1048,352,696,14,682,1,PCF,20,7.825,31.7
2017,ISERE,La Côte-Saint-André,1048,352,696,14,682,1,REC,54,7.825,31.7
2017,ISERE,La Côte-Saint-André,1048,352,696,14,682,1,RES,20,7.825,31.7
2017,ISERE,Corenc,1049,166,883,8,875,1,EELV,83,7.825,31.7
2017,ISERE,Corenc,1049,166,883,8,875,1,FN,65,7.825,31.7
2017,ISERE,Corenc,1049,166,883,8,875,1,LFI,134,7.825,31.7
2017,ISERE,Corenc,1049,166,883,8,875,1,LO,1,7.825,31.7
2017,ISERE,Corenc,1049,166,883,8,875,1,LR,84,7.825,31.7
2017,ISERE,Corenc,1049,166,883,8,875,1,LREM,365,7.825,31.7
2017,ISERE,Corenc,1049,166,883,8,875,1,NPA,6,7.825,31.7
2017,ISERE,Corenc,1049,166,883,8,875,1,PCF,17,7.825,31.7
2017,ISERE,Corenc,1049,166,883,8,875,1,REC,79,7.825,31.7
2017,ISERE,Corenc,1049,166,883,8,875,1,RES,10,7.825,31.7
2017,ISERE,Valencin,1049,168,881,16,865,1,EELV,40,7.825,31.7
2017,ISERE,Valencin,1049,168,881,16,865,1,FN,289,7.825,31.7
2017,ISERE,Valencin,1049,168,881,16,865,1,LFI,108,7.825,31.7
2017,ISERE,Valencin,1049,168,881,16,865,1,LO,3,7.825,31.7
2017,ISERE,Valencin,1049,168,881,16,865,1,LR,33,7.825,31.7
2017,ISERE,Valencin,1049,168,881,16,865,1,LREM,226,7.825,31.7
2017,ISERE,Valencin,1049,168,881,16,865,1,NPA,4,7.825,31.7
2017,ISERE,Valencin,1049,168,881,16,865,1,PCF,14,7.825,31.7
2017,ISERE,Valencin,1049,168,881,16,865,1,REC,87,7.825,31.7
2017,ISERE,Valencin,1049,168,881,16,865,1,RES,18,7.825,31.7
2017,ISERE,Seyssinet-Pariset,1049,206,843,22,821,1,EELV,68,7.825,31.7
2017,ISERE,Seyssinet-Pariset,1049,206,843,22,821,1,FN,157,7.825,31.7
2017,ISERE,Seyssinet-Pariset,1049,206,843,22,821,1,LFI,144,7.825,31.7
2017,ISERE,Seyssinet-Pariset,1049,206,843,22,821,1,LO,2,7.825,31.7
2017,ISERE,Seyssinet-Pariset,1049,206,843,22,821,1,LR,39,7.825,31.7
2017,ISERE,Seyssinet-Pariset,1049,206,843,22,821,1,LREM,249,7.825,31.7
2017,ISERE,Seyssinet-Pariset,1049,206,843,22,821,1,NPA,7,7.825,31.7
2017,ISERE,Seyssinet-Pariset,1049,206,843,22,821,1,PCF,19,7.825,31.7
2017,ISERE,Seyssinet-Pariset,1049,206,843,22,821,1,REC,60,7.825,31.7
2017,ISERE,Seyssinet-Pariset,1049,206,843,22,821,1,RES,29,7.825,31.7
2017,ISERE,Crêts en Belledonne,1049,224,825,17,808,1,EELV,40,7.825,31.7
2017,ISERE,Crêts en Belledonne,1049,224,825,17,808,1,FN,223,7.825,31.7
2017,ISERE,Crêts en Belledonne,1049,224,825,17,808,1,LFI,188,7.825,31.7
2017,ISERE,Crêts en Belledonne,1049,224,825,17,808,1,LO,4,7.825,31.7
2017,ISERE,Crêts en Belledonne,1049,224,825,17,808,1,LR,30,7.825,31.7
2017,ISERE,Crêts en Belledonne,1049,224,825,17,808,1,LREM,197,7.825,31.7
2017,ISERE,Crêts en Belledonne,1049,224,825,17,808,1,NPA,6,7.825,31.7
2017,ISERE,Crêts en Belledonne,1049,224,825,17,808,1,PCF,15,7.825,31.7
2017,ISERE,Crêts en Belledonne,1049,224,825,17,808,1,REC,43,7.825,31.7
2017,ISERE,Crêts en Belledonne,1049,224,825,17,808,1,RES,21,7.825,31.7
2017,ISERE,Fontaine,1050,264,786,20,766,1,EELV,45,7.825,31.7
2017,ISERE,Fontaine,1050,264,786,20,766,1,FN,187,7.825,31.7
2017,ISERE,Fontaine,1050,264,786,20,766,1,LFI,207,7.825,31.7
2017,ISERE,Fontaine,1050,264,786,20,766,1,LO,8,7.825,31.7
2017,ISERE,Fontaine,1050,264,786,20,766,1,LR,22,7.825,31.7
2017,ISERE,Fontaine,1050,264,786,20,766,1,LREM,189,7.825,31.7
2017,ISERE,Fontaine,1050,264,786,20,766,1,NPA,8,7.825,31.7
2017,ISERE,Fontaine,1050,264,786,20,766,1,PCF,29,7.825,31.7
2017,ISERE,Fontaine,1050,264,786,20,766,1,REC,47,7.825,31.7
2017,ISERE,Fontaine,1050,264,786,20,766,1,RES,8,7.825,31.7
2017,ISERE,Fontaine,1050,314,736,8,728,1,EELV,24,7.825,31.7
2017,ISERE,Fontaine,1050,314,736,8,728,1,FN,169,7.825,31.7
2017,ISERE,Fontaine,1050,314,736,8,728,1,LFI,267,7.825,31.7
2017,ISERE,Fontaine,1050,314,736,8,728,1,LO,4,7.825,31.7
2017,ISERE,Fontaine,1050,314,736,8,728,1,LR,10,7.825,31.7
2017,ISERE,Fontaine,1050,314,736,8,728,1,LREM,149,7.825,31.7
2017,ISERE,Fontaine,1050,314,736,8,728,1,NPA,7,7.825,31.7
2017,ISERE,Fontaine,1050,314,736,8,728,1,PCF,19,7.825,31.7
2017,ISERE,Fontaine,1050,314,736,8,728,1,REC,43,7.825,31.7
2017,ISERE,Fontaine,1050,314,736,8,728,1,RES,9,7.825,31.7
2017,ISERE,Le Péage-de-Roussillon,1051,333,718,23,695,1,EELV,21,7.825,31.7
2017,ISERE,Le Péage-de-Roussillon,1051,333,718,23,695,1,FN,181,7.825,31.7
2017,ISERE,Le Péage-de-Roussillon,1051,333,718,23,695,1,LFI,215,7.825,31.7
2017,ISERE,Le Péage-de-Roussillon,1051,333,718,23,695,1,LO,2,7.825,31.7
2017,ISERE,Le Péage-de-Roussillon,1051,333,718,23,695,1,LR,22,7.825,31.7
2017,ISERE,Le Péage-de-Roussillon,1051,333,718,23,695,1,LREM,149,7.825,31.7
2017,ISERE,Le Péage-de-Roussillon,1051,333,718,23,695,1,NPA,7,7.825,31.7
2017,ISERE,Le Péage-de-Roussillon,1051,333,718,23,695,1,PCF,20,7.825,31.7
2017,ISERE,Le Péage-de-Roussillon,1051,333,718,23,695,1,REC,33,7.825,31.7
2017,ISERE,Le Péage-de-Roussillon,1051,333,718,23,695,1,RES,9,7.825,31.7
2017,ISERE,La Tronche,1052,150,902,17,885,1,EELV,114,7.825,31.7
2017,ISERE,La Tronche,1052,150,902,17,885,1,FN,55,7.825,31.7
2017,ISERE,La Tronche,1052,150,902,17,885,1,LFI,159,7.825,31.7
2017,ISERE,La Tronche,1052,150,902,17,885,1,LO,1,7.825,31.7
2017,ISERE,La Tronche,1052,150,902,17,885,1,LR,73,7.825,31.7
2017,ISERE,La Tronche,1052,150,902,17,885,1,LREM,377,7.825,31.7
2017,ISERE,La Tronche,1052,150,902,17,885,1,NPA,0,7.825,31.7
2017,ISERE,La Tronche,1052,150,902,17,885,1,PCF,12,7.825,31.7
2017,ISERE,La Tronche,1052,150,902,17,885,1,REC,65,7.825,31.7
2017,ISERE,La Tronche,1052,150,902,17,885,1,RES,12,7.825,31.7
2017,ISERE,Claix,1052,162,890,23,867,1,EELV,75,7.825,31.7
2017,ISERE,Claix,1052,162,890,23,867,1,FN,115,7.825,31.7
2017,ISERE,Claix,1052,162,890,23,867,1,LFI,222,7.825,31.7
2017,ISERE,Claix,1052,162,890,23,867,1,LO,2,7.825,31.7
2017,ISERE,Claix,1052,162,890,23,867,1,LR,36,7.825,31.7
2017,ISERE,Claix,1052,162,890,23,867,1,LREM,277,7.825,31.7
2017,ISERE,Claix,1052,162,890,23,867,1,NPA,9,7.825,31.7
2017,ISERE,Claix,1052,162,890,23,867,1,PCF,19,7.825,31.7
2017,ISERE,Claix,1052,162,890,23,867,1,REC,59,7.825,31.7
2017,ISERE,Claix,1052,162,890,23,867,1,RES,20,7.825,31.7
2017,ISERE,Villard-Bonnot,1052,232,820,17,803,1,EELV,46,7.825,31.7
2017,ISERE,Villard-Bonnot,1052,232,820,17,803,1,FN,175,7.825,31.7
2017,ISERE,Villard-Bonnot,1052,232,820,17,803,1,LFI,213,7.825,31.7
2017,ISERE,Villard-Bonnot,1052,232,820,17,803,1,LO,7,7.825,31.7
2017,ISERE,Villard-Bonnot,1052,232,820,17,803,1,LR,18,7.825,31.7
2017,ISERE,Villard-Bonnot,1052,232,820,17,803,1,LREM,191,7.825,31.7
2017,ISERE,Villard-Bonnot,1052,232,820,17,803,1,NPA,10,7.825,31.7
2017,ISERE,Villard-Bonnot,1052,232,820,17,803,1,PCF,34,7.825,31.7
2017,ISERE,Villard-Bonnot,1052,232,820,17,803,1,REC,59,7.825,31.7
2017,ISERE,Villard-Bonnot,1052,232,820,17,803,1,RES,20,7.825,31.7
2017,ISERE,La Tronche,1052,254,798,14,784,1,EELV,106,7.825,31.7
2017,ISERE,La Tronche,1052,254,798,14,784,1,FN,79,7.825,31.7
2017,ISERE,La Tronche,1052,254,798,14,784,1,LFI,194,7.825,31.7
2017,ISERE,La Tronche,1052,254,798,14,784,1,LO,6,7.825,31.7
2017,ISERE,La Tronche,1052,254,798,14,784,1,LR,53,7.825,31.7
2017,ISERE,La Tronche,1052,254,798,14,784,1,LREM,248,7.825,31.7
2017,ISERE,La Tronche,1052,254,798,14,784,1,NPA,5,7.825,31.7
2017,ISERE,La Tronche,1052,254,798,14,784,1,PCF,8,7.825,31.7
2017,ISERE,La Tronche,1052,254,798,14,784,1,REC,50,7.825,31.7
2017,ISERE,La Tronche,1052,254,798,14,784,1,RES,12,7.825,31.7
2017,ISERE,Seyssins,1053,135,918,15,903,1,EELV,81,7.825,31.7
2017,ISERE,Seyssins,1053,135,918,15,903,1,FN,125,7.825,31.7
2017,ISERE,Seyssins,1053,135,918,15,903,1,LFI,139,7.825,31.7
2017,ISERE,Seyssins,1053,135,918,15,903,1,LO,3,7.825,31.7
2017,ISERE,Seyssins,1053,135,918,15,903,1,LR,45,7.825,31.7
2017,ISERE,Seyssins,1053,135,918,15,903,1,LREM,389,7.825,31.7
2017,ISERE,Seyssins,1053,135,918,15,903,1,NPA,3,7.825,31.7
2017,ISERE,Seyssins,1053,135,918,15,903,1,PCF,15,7.825,31.7
2017,ISERE,Seyssins,1053,135,918,15,903,1,REC,47,7.825,31.7
2017,ISERE,Seyssins,1053,135,918,15,903,1,RES,16,7.825,31.7
2017,ISERE,Saint-Martin-d'Uriage,1054,134,920,16,904,1,EELV,145,7.825,31.7
2017,ISERE,Saint-Martin-d'Uriage,1054,134,920,16,904,1,FN,116,7.825,31.7
2017,ISERE,Saint-Martin-d'Uriage,1054,134,920,16,904,1,LFI,207,7.825,31.7
2017,ISERE,Saint-Martin-d'Uriage,1054,134,920,16,904,1,LO,6,7.825,31.7
2017,ISERE,Saint-Martin-d'Uriage,1054,134,920,16,904,1,LR,32,7.825,31.7
2017,ISERE,Saint-Martin-d'Uriage,1054,134,920,16,904,1,LREM,249,7.825,31.7
2017,ISERE,Saint-Martin-d'Uriage,1054,134,920,16,904,1,NPA,11,7.825,31.7
2017,ISERE,Saint-Martin-d'Uriage,1054,134,920,16,904,1,PCF,19,7.825,31.7
2017,ISERE,Saint-Martin-d'Uriage,1054,134,920,16,904,1,REC,65,7.825,31.7
2017,ISERE,Saint-Martin-d'Uriage,1054,134,920,16,904,1,RES,14,7.825,31.7
2017,ISERE,Grenay,1054,217,837,23,814,1,EELV,30,7.825,31.7
2017,ISERE,Grenay,1054,217,837,23,814,1,FN,260,7.825,31.7
2017,ISERE,Grenay,1054,217,837,23,814,1,LFI,109,7.825,31.7
2017,ISERE,Grenay,1054,217,837,23,814,1,LO,3,7.825,31.7
2017,ISERE,Grenay,1054,217,837,23,814,1,LR,42,7.825,31.7
2017,ISERE,Grenay,1054,217,837,23,814,1,LREM,222,7.825,31.7
2017,ISERE,Grenay,1054,217,837,23,814,1,NPA,4,7.825,31.7
2017,ISERE,Grenay,1054,217,837,23,814,1,PCF,11,7.825,31.7
2017,ISERE,Grenay,1054,217,837,23,814,1,REC,90,7.825,31.7
2017,ISERE,Grenay,1054,217,837,23,814,1,RES,22,7.825,31.7
2017,ISERE,L'Isle-d'Abeau,1054,430,624,13,611,1,EELV,19,7.825,31.7
2017,ISERE,L'Isle-d'Abeau,1054,430,624,13,611,1,FN,190,7.825,31.7
2017,ISERE,L'Isle-d'Abeau,1054,430,624,13,611,1,LFI,215,7.825,31.7
2017,ISERE,L'Isle-d'Abeau,1054,430,624,13,611,1,LO,1,7.825,31.7
2017,ISERE,L'Isle-d'Abeau,1054,430,624,13,611,1,LR,11,7.825,31.7
2017,ISERE,L'Isle-d'Abeau,1054,430,624,13,611,1,LREM,95,7.825,31.7
2017,ISERE,L'Isle-d'Abeau,1054,430,624,13,611,1,NPA,6,7.825,31.7
2017,ISERE,L'Isle-d'Abeau,1054,430,624,13,611,1,PCF,4,7.825,31.7
2017,ISERE,L'Isle-d'Abeau,1054,430,624,13,611,1,REC,37,7.825,31.7
2017,ISERE,L'Isle-d'Abeau,1054,430,624,13,611,1,RES,9,7.825,31.7
2017,ISERE,Grenoble,1055,203,852,14,838,1,EELV,110,7.825,31.7
2017,ISERE,Grenoble,1055,203,852,14,838,1,FN,50,7.825,31.7
2017,ISERE,Grenoble,1055,203,852,14,838,1,LFI,309,7.825,31.7
2017,ISERE,Grenoble,1055,203,852,14,838,1,LO,2,7.825,31.7
2017,ISERE,Grenoble,1055,203,852,14,838,1,LR,41,7.825,31.7
2017,ISERE,Grenoble,1055,203,852,14,838,1,LREM,212,7.825,31.7
2017,ISERE,Grenoble,1055,203,852,14,838,1,NPA,3,7.825,31.7
2017,ISERE,Grenoble,1055,203,852,14,838,1,PCF,17,7.825,31.7
2017,ISERE,Grenoble,1055,203,852,14,838,1,REC,60,7.825,31.7
2017,ISERE,Grenoble,1055,203,852,14,838,1,RES,9,7.825,31.7
2017,ISERE,Saint-Marcellin,1056,259,797,12,785,1,EELV,40,7.825,31.7
2017,ISERE,Saint-Marcellin,1056,259,797,12,785,1,FN,220,7.825,31.7
2017,ISERE,Saint-Marcellin,1056,259,797,12,785,1,LFI,197,7.825,31.7
2017,ISERE,Saint-Marcellin,1056,259,797,12,785,1,LO,10,7.825,31.7
2017,ISERE,Saint-Marcellin,1056,259,797,12,785,1,LR,26,7.825,31.7
2017,ISERE,Saint-Marcellin,1056,259,797,12,785,1,LREM,187,7.825,31.7
2017,ISERE,Saint-Marcellin,1056,259,797,12,785,1,NPA,2,7.825,31.7
2017,ISERE,Saint-Marcellin,1056,259,797,12,785,1,PCF,14,7.825,31.7
2017,ISERE,Saint-Marcellin,1056,259,797,12,785,1,REC,47,7.825,31.7
2017,ISERE,Saint-Marcellin,1056,259,797,12,785,1,RES,18,7.825,31.7
2017,ISERE,Saint-Marcellin,1056,294,762,7,755,1,EELV,19,7.825,31.7
2017,ISERE,Saint-Marcellin,1056,294,762,7,755,1,FN,207,7.825,31.7
2017,ISERE,Saint-Marcellin,1056,294,762,7,755,1,LFI,200,7.825,31.7
2017,ISERE,Saint-Marcellin,1056,294,762,7,755,1,LO,11,7.825,31.7
2017,ISERE,Saint-Marcellin,1056,294,762,7,755,1,LR,24,7.825,31.7
2017,ISERE,Saint-Marcellin,1056,294,762,7,755,1,LREM,182,7.825,31.7
2017,ISERE,Saint-Marcellin,1056,294,762,7,755,1,NPA,7,7.825,31.7
2017,ISERE,Saint-Marcellin,1056,294,762,7,755,1,PCF,22,7.825,31.7
2017,ISERE,Saint-Marcellin,1056,294,762,7,755,1,REC,42,7.825,31.7
2017,ISERE,Saint-Marcellin,1056,294,762,7,755,1,RES,19,7.825,31.7
2017,ISERE,La Tronche,1057,209,848,7,841,1,EELV,89,7.825,31.7
2017,ISERE,La Tronche,1057,209,848,7,841,1,FN,83,7.825,31.7
2017,ISERE,La Tronche,1057,209,848,7,841,1,LFI,227,7.825,31.7
2017,ISERE,La Tronche,1057,209,848,7,841,1,LO,6,7.825,31.7
2017,ISERE,La Tronche,1057,209,848,7,841,1,LR,41,7.825,31.7
2017,ISERE,La Tronche,1057,209,848,7,841,1,LREM,251,7.825,31.7
2017,ISERE,La Tronche,1057,209,848,7,841,1,NPA,5,7.825,31.7
2017,ISERE,La Tronche,1057,209,848,7,841,1,PCF,20,7.825,31.7
2017,ISERE,La Tronche,1057,209,848,7,841,1,REC,71,7.825,31.7
2017,ISERE,La Tronche,1057,209,848,7,841,1,RES,12,7.825,31.7
2017,ISERE,Le Grand-Lemps,1058,200,858,27,831,1,EELV,41,7.825,31.7
2017,ISERE,Le Grand-Lemps,1058,200,858,27,831,1,FN,182,7.825,31.7
2017,ISERE,Le Grand-Lemps,1058,200,858,27,831,1,LFI,173,7.825,31.7
2017,ISERE,Le Grand-Lemps,1058,200,858,27,831,1,LO,3,7.825,31.7
2017,ISERE,Le Grand-Lemps,1058,200,858,27,831,1,LR,48,7.825,31.7
2017,ISERE,Le Grand-Lemps,1058,200,858,27,831,1,LREM,240,7.825,31.7
2017,ISERE,Le Grand-Lemps,1058,200,858,27,831,1,NPA,3,7.825,31.7
2017,ISERE,Le Grand-Lemps,1058,200,858,27,831,1,PCF,24,7.825,31.7
2017,ISERE,Le Grand-Lemps,1058,200,858,27,831,1,REC,55,7.825,31.7
2017,ISERE,Le Grand-Lemps,1058,200,858,27,831,1,RES,25,7.825,31.7
2017,ISERE,Vinay,1058,241,817,28,789,1,EELV,36,7.825,31.7
2017,ISERE,Vinay,1058,241,817,28,789,1,FN,237,7.825,31.7
2017,ISERE,Vinay,1058,241,817,28,789,1,LFI,164,7.825,31.7
2017,ISERE,Vinay,1058,241,817,28,789,1,LO,6,7.825,31.7
2017,ISERE,Vinay,1058,241,817,28,789,1,LR,24,7.825,31.7
2017,ISERE,Vinay,1058,241,817,28,789,1,LREM,196,7.825,31.7
2017,ISERE,Vinay,1058,241,817,28,789,1,NPA,3,7.825,31.7
2017,ISERE,Vinay,1058,241,817,28,789,1,PCF,21,7.825,31.7
2017,ISERE,Vinay,1058,241,817,28,789,1,REC,53,7.825,31.7
2017,ISERE,Vinay,1058,241,817,28,789,1,RES,17,7.825,31.7
2017,ISERE,Domène,1058,244,814,18,796,1,EELV,41,7.825,31.7
2017,ISERE,Domène,1058,244,814,18,796,1,FN,175,7.825,31.7
2017,ISERE,Domène,1058,244,814,18,796,1,LFI,211,7.825,31.7
2017,ISERE,Domène,1058,244,814,18,796,1,LO,3,7.825,31.7
2017,ISERE,Domène,1058,244,814,18,796,1,LR,30,7.825,31.7
2017,ISERE,Domène,1058,244,814,18,796,1,LREM,203,7.825,31.7
2017,ISERE,Domène,1058,244,814,18,796,1,NPA,8,7.825,31.7
2017,ISERE,Domène,1058,244,814,18,796,1,PCF,28,7.825,31.7
2017,ISERE,Domène,1058,244,814,18,796,1,REC,49,7.825,31.7
2017,ISERE,Domène,1058,244,814,18,796,1,RES,19,7.825,31.7
2017,ISERE,Echirolles,1058,283,775,11,764,1,EELV,42,7.825,31.7
2017,ISERE,Echirolles,1058,283,775,11,764,1,FN,111,7.825,31.7
2017,ISERE,Echirolles,1058,283,775,11,764,1,LFI,326,7.825,31.7
2017,ISERE,Echirolles,1058,283,775,11,764,1,LO,5,7.825,31.7
2017,ISERE,Echirolles,1058,283,775,11,764,1,LR,12,7.825,31.7
2017,ISERE,Echirolles,1058,283,775,11,764,1,LREM,163,7.825,31.7
2017,ISERE,Echirolles,1058,283,775,11,764,1,NPA,10,7.825,31.7
2017,ISERE,Echirolles,1058,283,775,11,764,1,PCF,38,7.825,31.7
2017,ISERE,Echirolles,1058,283,775,11,764,1,REC,33,7.825,31.7
2017,ISERE,Echirolles,1058,283,775,11,764,1,RES,9,7.825,31.7
2017,ISERE,Grenoble,1060,245,815,8,807,1,EELV,73,7.825,31.7
2017,ISERE,Grenoble,1060,245,815,8,807,1,FN,101,7.825,31.7
2017,ISERE,Grenoble,1060,245,815,8,807,1,LFI,265,7.825,31.7
2017,ISERE,Grenoble,1060,245,815,8,807,1,LO,1,7.825,31.7
2017,ISERE,Grenoble,1060,245,815,8,807,1,LR,30,7.825,31.7
2017,ISERE,Grenoble,1060,245,815,8,807,1,LREM,240,7.825,31.7
2017,ISERE,Grenoble,1060,245,815,8,807,1,NPA,10,7.825,31.7
2017,ISERE,Grenoble,1060,245,815,8,807,1,PCF,14,7.825,31.7
2017,ISERE,Grenoble,1060,245,815,8,807,1,REC,36,7.825,31.7
2017,ISERE,Grenoble,1060,245,815,8,807,1,RES,12,7.825,31.7
2017,ISERE,Chavanoz,1061,218,843,18,825,1,EELV,40,7.825,31.7
2017,ISERE,Chavanoz,1061,218,843,18,825,1,FN,237,7.825,31.7
2017,ISERE,Chavanoz,1061,218,843,18,825,1,LFI,132,7.825,31.7
2017,ISERE,Chavanoz,1061,218,843,18,825,1,LO,4,7.825,31.7
2017,ISERE,Chavanoz,1061,218,843,18,825,1,LR,34,7.825,31.7
2017,ISERE,Chavanoz,1061,218,843,18,825,1,LREM,221,7.825,31.7
2017,ISERE,Chavanoz,1061,218,843,18,825,1,NPA,10,7.825,31.7
2017,ISERE,Chavanoz,1061,218,843,18,825,1,PCF,7,7.825,31.7
2017,ISERE,Chavanoz,1061,218,843,18,825,1,REC,80,7.825,31.7
2017,ISERE,Chavanoz,1061,218,843,18,825,1,RES,24,7.825,31.7
2017,ISERE,Morestel,1061,240,821,17,804,1,EELV,32,7.825,31.7
2017,ISERE,Morestel,1061,240,821,17,804,1,FN,223,7.825,31.7
2017,ISERE,Morestel,1061,240,821,17,804,1,LFI,115,7.825,31.7
2017,ISERE,Morestel,1061,240,821,17,804,1,LO,4,7.825,31.7
2017,ISERE,Morestel,1061,240,821,17,804,1,LR,29,7.825,31.7
2017,ISERE,Morestel,1061,240,821,17,804,1,LREM,235,7.825,31.7
2017,ISERE,Morestel,1061,240,821,17,804,1,NPA,8,7.825,31.7
2017,ISERE,Morestel,1061,240,821,17,804,1,PCF,27,7.825,31.7
2017,ISERE,Morestel,1061,240,821,17,804,1,REC,83,7.825,31.7
2017,ISERE,Morestel,1061,240,821,17,804,1,RES,16,7.825,31.7
2017,ISERE,Vernioz,1062,159,903,15,888,1,EELV,47,7.825,31.7
2017,ISERE,Vernioz,1062,159,903,15,888,1,FN,285,7.825,31.7
2017,ISERE,Vernioz,1062,159,903,15,888,1,LFI,118,7.825,31.7
2017,ISERE,Vernioz,1062,159,903,15,888,1,LO,2,7.825,31.7
2017,ISERE,Vernioz,1062,159,903,15,888,1,LR,32,7.825,31.7
2017,ISERE,Vernioz,1062,159,903,15,888,1,LREM,225,7.825,31.7
2017,ISERE,Vernioz,1062,159,903,15,888,1,NPA,4,7.825,31.7
2017,ISERE,Vernioz,1062,159,903,15,888,1,PCF,22,7.825,31.7
2017,ISERE,Vernioz,1062,159,903,15,888,1,REC,75,7.825,31.7
2017,ISERE,Vernioz,1062,159,903,15,888,1,RES,32,7.825,31.7
2017,ISERE,La Terrasse,1063,159,904,21,883,1,EELV,66,7.825,31.7
2017,ISERE,La Terrasse,1063,159,904,21,883,1,FN,132,7.825,31.7
2017,ISERE,La Terrasse,1063,159,904,21,883,1,LFI,188,7.825,31.7
2017,ISERE,La Terrasse,1063,159,904,21,883,1,LO,5,7.825,31.7
2017,ISERE,La Terrasse,1063,159,904,21,883,1,LR,45,7.825,31.7
2017,ISERE,La Terrasse,1063,159,904,21,883,1,LREM,274,7.825,31.7
2017,ISERE,La Terrasse,1063,159,904,21,883,1,NPA,9,7.825,31.7
2017,ISERE,La Terrasse,1063,159,904,21,883,1,PCF,27,7.825,31.7
2017,ISERE,La Terrasse,1063,159,904,21,883,1,REC,77,7.825,31.7
2017,ISERE,La Terrasse,1063,159,904,21,883,1,RES,21,7.825,31.7
2017,ISERE,Froges,1065,265,800,18,782,1,EELV,41,7.825,31.7
2017,ISERE,Froges,1065,265,800,18,782,1,FN,203,7.825,31.7
2017,ISERE,Froges,1065,265,800,18,782,1,LFI,161,7.825,31.7
2017,ISERE,Froges,1065,265,800,18,782,1,LO,0,7.825,31.7
2017,ISERE,Froges,1065,265,800,18,782,1,LR,30,7.825,31.7
2017,ISERE,Froges,1065,265,800,18,782,1,LREM,223,7.825,31.7
2017,ISERE,Froges,1065,265,800,18,782,1,NPA,10,7.825,31.7
2017,ISERE,Froges,1065,265,800,18,782,1,PCF,25,7.825,31.7
2017,ISERE,Froges,1065,265,800,18,782,1,REC,40,7.825,31.7
2017,ISERE,Froges,1065,265,800,18,782,1,RES,23,7.825,31.7
2017,ISERE,Tullins,1066,241,825,23,802,1,EELV,38,7.825,31.7
2017,ISERE,Tullins,1066,241,825,23,802,1,FN,210,7.825,31.7
2017,ISERE,Tullins,1066,241,825,23,802,1,LFI,154,7.825,31.7
2017,ISERE,Tullins,1066,241,825,23,802,1,LO,10,7.825,31.7
2017,ISERE,Tullins,1066,241,825,23,802,1,LR,22,7.825,31.7
2017,ISERE,Tullins,1066,241,825,23,802,1,LREM,217,7.825,31.7
2017,ISERE,Tullins,1066,241,825,23,802,1,NPA,6,7.825,31.7
2017,ISERE,Tullins,1066,241,825,23,802,1,PCF,13,7.825,31.7
2017,ISERE,Tullins,1066,241,825,23,802,1,REC,57,7.825,31.7
2017,ISERE,Tullins,1066,241,825,23,802,1,RES,28,7.825,31.7
2017,ISERE,Coublevie,1067,191,876,20,856,1,EELV,93,7.825,31.7
2017,ISERE,Coublevie,1067,191,876,20,856,1,FN,135,7.825,31.7
2017,ISERE,Coublevie,1067,191,876,20,856,1,LFI,173,7.825,31.7
2017,ISERE,Coublevie,1067,191,876,20,856,1,LO,4,7.825,31.7
2017,ISERE,Coublevie,1067,191,876,20,856,1,LR,44,7.825,31.7
2017,ISERE,Coublevie,1067,191,876,20,856,1,LREM,282,7.825,31.7
2017,ISERE,Coublevie,1067,191,876,20,856,1,NPA,5,7.825,31.7
2017,ISERE,Coublevie,1067,191,876,20,856,1,PCF,20,7.825,31.7
2017,ISERE,Coublevie,1067,191,876,20,856,1,REC,49,7.825,31.7
2017,ISERE,Coublevie,1067,191,876,20,856,1,RES,19,7.825,31.7
2017,ISERE,Echirolles,1067,317,750,7,743,1,EELV,35,7.825,31.7
2017,ISERE,Echirolles,1067,317,750,7,743,1,FN,99,7.825,31.7
2017,ISERE,Echirolles,1067,317,750,7,743,1,LFI,286,7.825,31.7
2017,ISERE,Echirolles,1067,317,750,7,743,1,LO,7,7.825,31.7
2017,ISERE,Echirolles,1067,317,750,7,743,1,LR,13,7.825,31.7
2017,ISERE,Echirolles,1067,317,750,7,743,1,LREM,182,7.825,31.7
2017,ISERE,Echirolles,1067,317,750,7,743,1,NPA,3,7.825,31.7
2017,ISERE,Echirolles,1067,317,750,7,743,1,PCF,33,7.825,31.7
2017,ISERE,Echirolles,1067,317,750,7,743,1,REC,38,7.825,31.7
2017,ISERE,Echirolles,1067,317,750,7,743,1,RES,9,7.825,31.7
2017,ISERE,Roussillon,1067,339,728,12,716,1,EELV,17,7.825,31.7
2017,ISERE,Roussillon,1067,339,728,12,716,1,FN,173,7.825,31.7
2017,ISERE,Roussillon,1067,339,728,12,716,1,LFI,225,7.825,31.7
2017,ISERE,Roussillon,1067,339,728,12,716,1,LO,1,7.825,31.7
2017,ISERE,Roussillon,1067,339,728,12,716,1,LR,24,7.825,31.7
2017,ISERE,Roussillon,1067,339,728,12,716,1,LREM,160,7.825,31.7
2017,ISERE,Roussillon,1067,339,728,12,716,1,NPA,3,7.825,31.7
2017,ISERE,Roussillon,1067,339,728,12,716,1,PCF,21,7.825,31.7
2017,ISERE,Roussillon,1067,339,728,12,716,1,REC,39,7.825,31.7
2017,ISERE,Roussillon,1067,339,728,12,716,1,RES,19,7.825,31.7
2017,ISERE,Cessieu,1070,260,810,21,789,1,EELV,29,7.825,31.7
2017,ISERE,Cessieu,1070,260,810,21,789,1,FN,257,7.825,31.7
2017,ISERE,Cessieu,1070,260,810,21,789,1,LFI,124,7.825,31.7
2017,ISERE,Cessieu,1070,260,810,21,789,1,LO,4,7.825,31.7
2017,ISERE,Cessieu,1070,260,810,21,789,1,LR,40,7.825,31.7
2017,ISERE,Cessieu,1070,260,810,21,789,1,LREM,189,7.825,31.7
2017,ISERE,Cessieu,1070,260,810,21,789,1,NPA,4,7.825,31.7
2017,ISERE,Cessieu,1070,260,810,21,789,1,PCF,6,7.825,31.7
2017,ISERE,Cessieu,1070,260,810,21,789,1,REC,87,7.825,31.7
2017,ISERE,Cessieu,1070,260,810,21,789,1,RES,21,7.825,31.7
2017,ISERE,Bourgoin-Jallieu,1070,327,743,22,721,1,EELV,40,7.825,31.7
2017,ISERE,Bourgoin-Jallieu,1070,327,743,22,721,1,FN,166,7.825,31.7
2017,ISERE,Bourgoin-Jallieu,1070,327,743,22,721,1,LFI,178,7.825,31.7
2017,ISERE,Bourgoin-Jallieu,1070,327,743,22,721,1,LO,3,7.825,31.7
2017,ISERE,Bourgoin-Jallieu,1070,327,743,22,721,1,LR,30,7.825,31.7
2017,ISERE,Bourgoin-Jallieu,1070,327,743,22,721,1,LREM,198,7.825,31.7
2017,ISERE,Bourgoin-Jallieu,1070,327,743,22,721,1,NPA,5,7.825,31.7
2017,ISERE,Bourgoin-Jallieu,1070,327,743,22,721,1,PCF,13,7.825,31.7
2017,ISERE,Bourgoin-Jallieu,1070,327,743,22,721,1,REC,47,7.825,31.7
2017,ISERE,Bourgoin-Jallieu,1070,327,743,22,721,1,RES,9,7.825,31.7
2017,ISERE,Eybens,1072,228,844,17,827,1,EELV,71,7.825,31.7
2017,ISERE,Eybens,1072,228,844,17,827,1,FN,133,7.825,31.7
2017,ISERE,Eybens,1072,228,844,17,827,1,LFI,188,7.825,31.7
2017,ISERE,Eybens,1072,228,844,17,827,1,LO,4,7.825,31.7
2017,ISERE,Eybens,1072,228,844,17,827,1,LR,42,7.825,31.7
2017,ISERE,Eybens,1072,228,844,17,827,1,LREM,238,7.825,31.7
2017,ISERE,Eybens,1072,228,844,17,827,1,NPA,4,7.825,31.7
2017,ISERE,Eybens,1072,228,844,17,827,1,PCF,27,7.825,31.7
2017,ISERE,Eybens,1072,228,844,17,827,1,REC,56,7.825,31.7
2017,ISERE,Eybens,1072,228,844,17,827,1,RES,18,7.825,31.7
2017,ISERE,Saint-Savin,1073,231,842,19,823,1,EELV,35,7.825,31.7
2017,ISERE,Saint-Savin,1073,231,842,19,823,1,FN,225,7.825,31.7
2017,ISERE,Saint-Savin,1073,231,842,19,823,1,LFI,119,7.825,31.7
2017,ISERE,Saint-Savin,1073,231,842,19,823,1,LO,3,7.825,31.7
2017,ISERE,Saint-Savin,1073,231,842,19,823,1,LR,42,7.825,31.7
2017,ISERE,Saint-Savin,1073,231,842,19,823,1,LREM,238,7.825,31.7
2017,ISERE,Saint-Savin,1073,231,842,19,823,1,NPA,7,7.825,31.7
2017,ISERE,Saint-Savin,1073,231,842,19,823,1,PCF,27,7.825,31.7
2017,ISERE,Saint-Savin,1073,231,842,19,823,1,REC,53,7.825,31.7
2017,ISERE,Saint-Savin,1073,231,842,19,823,1,RES,27,7.825,31.7
2017,ISERE,Saint-Martin-d'Hères,1073,304,769,13,756,1,EELV,31,7.825,31.7
2017,ISERE,Saint-Martin-d'Hères,1073,304,769,13,756,1,FN,88,7.825,31.7
2017,ISERE,Saint-Martin-d'Hères,1073,304,769,13,756,1,LFI,382,7.825,31.7
2017,ISERE,Saint-Martin-d'Hères,1073,304,769,13,756,1,LO,6,7.825,31.7
2017,ISERE,Saint-Martin-d'Hères,1073,304,769,13,756,1,LR,14,7.825,31.7
2017,ISERE,Saint-Martin-d'Hères,1073,304,769,13,756,1,LREM,161,7.825,31.7
2017,ISERE,Saint-Martin-d'Hères,1073,304,769,13,756,1,NPA,5,7.825,31.7
2017,ISERE,Saint-Martin-d'Hères,1073,304,769,13,756,1,PCF,15,7.825,31.7
2017,ISERE,Saint-Martin-d'Hères,1073,304,769,13,756,1,REC,23,7.825,31.7
2017,ISERE,Saint-Martin-d'Hères,1073,304,769,13,756,1,RES,17,7.825,31.7
2017,ISERE,Ruy-Montceau,1074,197,877,14,863,1,EELV,52,7.825,31.7
2017,ISERE,Ruy-Montceau,1074,197,877,14,863,1,FN,243,7.825,31.7
2017,ISERE,Ruy-Montceau,1074,197,877,14,863,1,LFI,103,7.825,31.7
2017,ISERE,Ruy-Montceau,1074,197,877,14,863,1,LO,3,7.825,31.7
2017,ISERE,Ruy-Montceau,1074,197,877,14,863,1,LR,47,7.825,31.7
2017,ISERE,Ruy-Montceau,1074,197,877,14,863,1,LREM,263,7.825,31.7
2017,ISERE,Ruy-Montceau,1074,197,877,14,863,1,NPA,5,7.825,31.7
2017,ISERE,Ruy-Montceau,1074,197,877,14,863,1,PCF,14,7.825,31.7
2017,ISERE,Ruy-Montceau,1074,197,877,14,863,1,REC,69,7.825,31.7
2017,ISERE,Ruy-Montceau,1074,197,877,14,863,1,RES,26,7.825,31.7
2017,ISERE,Fontaine,1074,359,715,13,702,1,EELV,32,7.825,31.7
2017,ISERE,Fontaine,1074,359,715,13,702,1,FN,136,7.825,31.7
2017,ISERE,Fontaine,1074,359,715,13,702,1,LFI,238,7.825,31.7
2017,ISERE,Fontaine,1074,359,715,13,702,1,LO,4,7.825,31.7
2017,ISERE,Fontaine,1074,359,715,13,702,1,LR,14,7.825,31.7
2017,ISERE,Fontaine,1074,359,715,13,702,1,LREM,178,7.825,31.7
2017,ISERE,Fontaine,1074,359,715,13,702,1,NPA,9,7.825,31.7
2017,ISERE,Fontaine,1074,359,715,13,702,1,PCF,21,7.825,31.7
2017,ISERE,Fontaine,1074,359,715,13,702,1,REC,40,7.825,31.7
2017,ISERE,Fontaine,1074,359,715,13,702,1,RES,6,7.825,31.7
2017,ISERE,Bourgoin-Jallieu,1074,369,705,24,681,1,EELV,33,7.825,31.7
2017,ISERE,Bourgoin-Jallieu,1074,369,705,24,681,1,FN,150,7.825,31.7
2017,ISERE,Bourgoin-Jallieu,1074,369,705,24,681,1,LFI,203,7.825,31.7
2017,ISERE,Bourgoin-Jallieu,1074,369,705,24,681,1,LO,3,7.825,31.7
2017,ISERE,Bourgoin-Jallieu,1074,369,705,24,681,1,LR,21,7.825,31.7
2017,ISERE,Bourgoin-Jallieu,1074,369,705,24,681,1,LREM,153,7.825,31.7
2017,ISERE,Bourgoin-Jallieu,1074,369,705,24,681,1,NPA,3,7.825,31.7
2017,ISERE,Bourgoin-Jallieu,1074,369,705,24,681,1,PCF,10,7.825,31.7
2017,ISERE,Bourgoin-Jallieu,1074,369,705,24,681,1,REC,51,7.825,31.7
2017,ISERE,Bourgoin-Jallieu,1074,369,705,24,681,1,RES,16,7.825,31.7
2017,ISERE,Voiron,1075,332,743,14,729,1,EELV,42,7.825,31.7
2017,ISERE,Voiron,1075,332,743,14,729,1,FN,146,7.825,31.7
2017,ISERE,Voiron,1075,332,743,14,729,1,LFI,259,7.825,31.7
2017,ISERE,Voiron,1075,332,743,14,729,1,LO,4,7.825,31.7
2017,ISERE,Voiron,1075,332,743,14,729,1,LR,20,7.825,31.7
2017,ISERE,Voiron,1075,332,743,14,729,1,LREM,158,7.825,31.7
2017,ISERE,Voiron,1075,332,743,14,729,1,NPA,7,7.825,31.7
2017,ISERE,Voiron,1075,332,743,14,729,1,PCF,13,7.825,31.7
2017,ISERE,Voiron,1075,332,743,14,729,1,REC,36,7.825,31.7
2017,ISERE,Voiron,1075,332,743,14,729,1,RES,11,7.825,31.7
2017,ISERE,Bourgoin-Jallieu,1075,409,666,21,645,1,EELV,24,7.825,31.7
2017,ISERE,Bourgoin-Jallieu,1075,409,666,21,645,1,FN,136,7.825,31.7
2017,ISERE,Bourgoin-Jallieu,1075,409,666,21,645,1,LFI,250,7.825,31.7
2017,ISERE,Bourgoin-Jallieu,1075,409,666,21,645,1,LO,5,7.825,31.7
2017,ISERE,Bourgoin-Jallieu,1075,409,666,21,645,1,LR,5,7.825,31.7
2017,ISERE,Bourgoin-Jallieu,1075,409,666,21,645,1,LREM,149,7.825,31.7
2017,ISERE,Bourgoin-Jallieu,1075,409,666,21,645,1,NPA,0,7.825,31.7
2017,ISERE,Bourgoin-Jallieu,1075,409,666,21,645,1,PCF,18,7.825,31.7
2017,ISERE,Bourgoin-Jallieu,1075,409,666,21,645,1,REC,33,7.825,31.7
2017,ISERE,Bourgoin-Jallieu,1075,409,666,21,645,1,RES,4,7.825,31.7
2017,ISERE,Villages du lac de Paladru,1076,200,876,18,858,1,EELV,45,7.825,31.7
2017,ISERE,Villages du lac de Paladru,1076,200,876,18,858,1,FN,207,7.825,31.7
2017,ISERE,Villages du lac de Paladru,1076,200,876,18,858,1,LFI,169,7.825,31.7
2017,ISERE,Villages du lac de Paladru,1076,200,876,18,858,1,LO,4,7.825,31.7
2017,ISERE,Villages du lac de Paladru,1076,200,876,18,858,1,LR,39,7.825,31.7
2017,ISERE,Villages du lac de Paladru,1076,200,876,18,858,1,LREM,238,7.825,31.7
2017,ISERE,Villages du lac de Paladru,1076,200,876,18,858,1,NPA,6,7.825,31.7
2017,ISERE,Villages du lac de Paladru,1076,200,876,18,858,1,PCF,14,7.825,31.7
2017,ISERE,Villages du lac de Paladru,1076,200,876,18,858,1,REC,62,7.825,31.7
2017,ISERE,Villages du lac de Paladru,1076,200,876,18,858,1,RES,23,7.825,31.7
2017,ISERE,Crolles,1076,201,875,18,857,1,EELV,102,7.825,31.7
2017,ISERE,Crolles,1076,201,875,18,857,1,FN,101,7.825,31.7
2017,ISERE,Crolles,1076,201,875,18,857,1,LFI,177,7.825,31.7
2017,ISERE,Crolles,1076,201,875,18,857,1,LO,3,7.825,31.7
2017,ISERE,Crolles,1076,201,875,18,857,1,LR,52,7.825,31.7
2017,ISERE,Crolles,1076,201,875,18,857,1,LREM,300,7.825,31.7
2017,ISERE,Crolles,1076,201,875,18,857,1,NPA,6,7.825,31.7
2017,ISERE,Crolles,1076,201,875,18,857,1,PCF,22,7.825,31.7
2017,ISERE,Crolles,1076,201,875,18,857,1,REC,47,7.825,31.7
2017,ISERE,Crolles,1076,201,875,18,857,1,RES,12,7.825,31.7
2017,ISERE,Varces-Allières-et-Risset,1076,203,873,19,854,1,EELV,59,7.825,31.7
2017,ISERE,Varces-Allières-et-Risset,1076,203,873,19,854,1,FN,188,7.825,31.7
2017,ISERE,Varces-Allières-et-Risset,1076,203,873,19,854,1,LFI,172,7.825,31.7
2017,ISERE,Varces-Allières-et-Risset,1076,203,873,19,854,1,LO,5,7.825,31.7
2017,ISERE,Varces-Allières-et-Risset,1076,203,873,19,854,1,LR,32,7.825,31.7
2017,ISERE,Varces-Allières-et-Risset,1076,203,873,19,854,1,LREM,249,7.825,31.7
2017,ISERE,Varces-Allières-et-Risset,1076,203,873,19,854,1,NPA,10,7.825,31.7
2017,ISERE,Varces-Allières-et-Risset,1076,203,873,19,854,1,PCF,17,7.825,31.7
2017,ISERE,Varces-Allières-et-Risset,1076,203,873,19,854,1,REC,70,7.825,31.7
2017,ISERE,Varces-Allières-et-Risset,1076,203,873,19,854,1,RES,18,7.825,31.7
2017,ISERE,Crémieu,1076,261,815,12,803,1,EELV,72,7.825,31.7
2017,ISERE,Crémieu,1076,261,815,12,803,1,FN,192,7.825,31.7
2017,ISERE,Crémieu,1076,261,815,12,803,1,LFI,152,7.825,31.7
2017,ISERE,Crémieu,1076,261,815,12,803,1,LO,3,7.825,31.7
2017,ISERE,Crémieu,1076,261,815,12,803,1,LR,25,7.825,31.7
2017,ISERE,Crémieu,1076,261,815,12,803,1,LREM,213,7.825,31.7
2017,ISERE,Crémieu,1076,261,815,12,803,1,NPA,4,7.825,31.7
2017,ISERE,Crémieu,1076,261,815,12,803,1,PCF,16,7.825,31.7
2017,ISERE,Crémieu,1076,261,815,12,803,1,REC,66,7.825,31.7
2017,ISERE,Crémieu,1076,261,815,12,803,1,RES,22,7.825,31.7
2017,ISERE,Saint-André-le-Gaz,1079,250,829,18,811,1,EELV,37,7.825,31.7
2017,ISERE,Saint-André-le-Gaz,1079,250,829,18,811,1,FN,253,7.825,31.7
2017,ISERE,Saint-André-le-Gaz,1079,250,829,18,811,1,LFI,162,7.825,31.7
2017,ISERE,Saint-André-le-Gaz,1079,250,829,18,811,1,LO,6,7.825,31.7
2017,ISERE,Saint-André-le-Gaz,1079,250,829,18,811,1,LR,33,7.825,31.7
2017,ISERE,Saint-André-le-Gaz,1079,250,829,18,811,1,LREM,170,7.825,31.7
2017,ISERE,Saint-André-le-Gaz,1079,250,829,18,811,1,NPA,6,7.825,31.7
2017,ISERE,Saint-André-le-Gaz,1079,250,829,18,811,1,PCF,13,7.825,31.7
2017,ISERE,Saint-André-le-Gaz,1079,250,829,18,811,1,REC,76,7.825,31.7
2017,ISERE,Saint-André-le-Gaz,1079,250,829,18,811,1,RES,22,7.825,31.7
2017,ISERE,Saint-Laurent-du-Pont,1081,218,863,18,845,1,EELV,52,7.825,31.7
2017,ISERE,Saint-Laurent-du-Pont,1081,218,863,18,845,1,FN,227,7.825,31.7
2017,ISERE,Saint-Laurent-du-Pont,1081,218,863,18,845,1,LFI,180,7.825,31.7
2017,ISERE,Saint-Laurent-du-Pont,1081,218,863,18,845,1,LO,8,7.825,31.7
2017,ISERE,Saint-Laurent-du-Pont,1081,218,863,18,845,1,LR,26,7.825,31.7
2017,ISERE,Saint-Laurent-du-Pont,1081,218,863,18,845,1,LREM,195,7.825,31.7
2017,ISERE,Saint-Laurent-du-Pont,1081,218,863,18,845,1,NPA,11,7.825,31.7
2017,ISERE,Saint-Laurent-du-Pont,1081,218,863,18,845,1,PCF,17,7.825,31.7
2017,ISERE,Saint-Laurent-du-Pont,1081,218,863,18,845,1,REC,56,7.825,31.7
2017,ISERE,Saint-Laurent-du-Pont,1081,218,863,18,845,1,RES,23,7.825,31.7
2017,ISERE,Saint-Etienne-de-Saint-Geoirs,1083,220,863,23,840,1,EELV,51,7.825,31.7
2017,ISERE,Saint-Etienne-de-Saint-Geoirs,1083,220,863,23,840,1,FN,235,7.825,31.7
2017,ISERE,Saint-Etienne-de-Saint-Geoirs,1083,220,863,23,840,1,LFI,129,7.825,31.7
2017,ISERE,Saint-Etienne-de-Saint-Geoirs,1083,220,863,23,840,1,LO,5,7.825,31.7
2017,ISERE,Saint-Etienne-de-Saint-Geoirs,1083,220,863,23,840,1,LR,44,7.825,31.7
2017,ISERE,Saint-Etienne-de-Saint-Geoirs,1083,220,863,23,840,1,LREM,232,7.825,31.7
2017,ISERE,Saint-Etienne-de-Saint-Geoirs,1083,220,863,23,840,1,NPA,7,7.825,31.7
2017,ISERE,Saint-Etienne-de-Saint-Geoirs,1083,220,863,23,840,1,PCF,12,7.825,31.7
2017,ISERE,Saint-Etienne-de-Saint-Geoirs,1083,220,863,23,840,1,REC,55,7.825,31.7
2017,ISERE,Saint-Etienne-de-Saint-Geoirs,1083,220,863,23,840,1,RES,29,7.825,31.7
2017,ISERE,Grenoble,1085,216,869,7,862,1,EELV,83,7.825,31.7
2017,ISERE,Grenoble,1085,216,869,7,862,1,FN,70,7.825,31.7
2017,ISERE,Grenoble,1085,216,869,7,862,1,LFI,225,7.825,31.7
2017,ISERE,Grenoble,1085,216,869,7,862,1,LO,5,7.825,31.7
2017,ISERE,Grenoble,1085,216,869,7,862,1,LR,51,7.825,31.7
2017,ISERE,Grenoble,1085,216,869,7,862,1,LREM,297,7.825,31.7
2017,ISERE,Grenoble,1085,216,869,7,862,1,NPA,4,7.825,31.7
2017,ISERE,Grenoble,1085,216,869,7,862,1,PCF,9,7.825,31.7
2017,ISERE,Grenoble,1085,216,869,7,862,1,REC,70,7.825,31.7
2017,ISERE,Grenoble,1085,216,869,7,862,1,RES,14,7.825,31.7
2017,ISERE,Meylan,1088,188,900,12,888,1,EELV,71,7.825,31.7
2017,ISERE,Meylan,1088,188,900,12,888,1,FN,99,7.825,31.7
2017,ISERE,Meylan,1088,188,900,12,888,1,LFI,224,7.825,31.7
2017,ISERE,Meylan,1088,188,900,12,888,1,LO,0,7.825,31.7
2017,ISERE,Meylan,1088,188,900,12,888,1,LR,48,7.825,31.7
2017,ISERE,Meylan,1088,188,900,12,888,1,LREM,305,7.825,31.7
2017,ISERE,Meylan,1088,188,900,12,888,1,NPA,6,7.825,31.7
2017,ISERE,Meylan,1088,188,900,12,888,1,PCF,14,7.825,31.7
2017,ISERE,Meylan,1088,188,900,12,888,1,REC,70,7.825,31.7
2017,ISERE,Meylan,1088,188,900,12,888,1,RES,21,7.825,31.7
2017,ISERE,Saint-Clair-du-Rhône,1091,280,811,22,789,1,EELV,31,7.825,31.7
2017,ISERE,Saint-Clair-du-Rhône,1091,280,811,22,789,1,FN,310,7.825,31.7
2017,ISERE,Saint-Clair-du-Rhône,1091,280,811,22,789,1,LFI,124,7.825,31.7
2017,ISERE,Saint-Clair-du-Rhône,1091,280,811,22,789,1,LO,4,7.825,31.7
2017,ISERE,Saint-Clair-du-Rhône,1091,280,811,22,789,1,LR,19,7.825,31.7
2017,ISERE,Saint-Clair-du-Rhône,1091,280,811,22,789,1,LREM,168,7.825,31.7
2017,ISERE,Saint-Clair-du-Rhône,1091,280,811,22,789,1,NPA,1,7.825,31.7
2017,ISERE,Saint-Clair-du-Rhône,1091,280,811,22,789,1,PCF,23,7.825,31.7
2017,ISERE,Saint-Clair-du-Rhône,1091,280,811,22,789,1,REC,48,7.825,31.7
2017,ISERE,Saint-Clair-du-Rhône,1091,280,811,22,789,1,RES,23,7.825,31.7
2017,ISERE,Grenoble,1091,292,799,14,785,1,EELV,55,7.825,31.7
2017,ISERE,Grenoble,1091,292,799,14,785,1,FN,121,7.825,31.7
2017,ISERE,Grenoble,1091,292,799,14,785,1,LFI,198,7.825,31.7
2017,ISERE,Grenoble,1091,292,799,14,785,1,LO,9,7.825,31.7
2017,ISERE,Grenoble,1091,292,799,14,785,1,LR,44,7.825,31.7
2017,ISERE,Grenoble,1091,292,799,14,785,1,LREM,237,7.825,31.7
2017,ISERE,Grenoble,1091,292,799,14,785,1,NPA,6,7.825,31.7
2017,ISERE,Grenoble,1091,292,799,14,785,1,PCF,18,7.825,31.7
2017,ISERE,Grenoble,1091,292,799,14,785,1,REC,71,7.825,31.7
2017,ISERE,Grenoble,1091,292,799,14,785,1,RES,7,7.825,31.7
2017,ISERE,Saint-Savin,1092,252,840,21,819,1,EELV,30,7.825,31.7
2017,ISERE,Saint-Savin,1092,252,840,21,819,1,FN,251,7.825,31.7
2017,ISERE,Saint-Savin,1092,252,840,21,819,1,LFI,95,7.825,31.7
2017,ISERE,Saint-Savin,1092,252,840,21,819,1,LO,6,7.825,31.7
2017,ISERE,Saint-Savin,1092,252,840,21,819,1,LR,56,7.825,31.7
2017,ISERE,Saint-Savin,1092,252,840,21,819,1,LREM,221,7.825,31.7
2017,ISERE,Saint-Savin,1092,252,840,21,819,1,NPA,3,7.825,31.7
2017,ISERE,Saint-Savin,1092,252,840,21,819,1,PCF,14,7.825,31.7
2017,ISERE,Saint-Savin,1092,252,840,21,819,1,REC,68,7.825,31.7
2017,ISERE,Saint-Savin,1092,252,840,21,819,1,RES,29,7.825,31.7
2017,ISERE,Bourgoin-Jallieu,1092,412,680,13,667,1,EELV,27,7.825,31.7
2017,ISERE,Bourgoin-Jallieu,1092,412,680,13,667,1,FN,114,7.825,31.7
2017,ISERE,Bourgoin-Jallieu,1092,412,680,13,667,1,LFI,259,7.825,31.7
2017,ISERE,Bourgoin-Jallieu,1092,412,680,13,667,1,LO,6,7.825,31.7
2017,ISERE,Bourgoin-Jallieu,1092,412,680,13,667,1,LR,20,7.825,31.7
2017,ISERE,Bourgoin-Jallieu,1092,412,680,13,667,1,LREM,164,7.825,31.7
2017,ISERE,Bourgoin-Jallieu,1092,412,680,13,667,1,NPA,5,7.825,31.7
2017,ISERE,Bourgoin-Jallieu,1092,412,680,13,667,1,PCF,19,7.825,31.7
2017,ISERE,Bourgoin-Jallieu,1092,412,680,13,667,1,REC,26,7.825,31.7
2017,ISERE,Bourgoin-Jallieu,1092,412,680,13,667,1,RES,10,7.825,31.7
2017,ISERE,Bourgoin-Jallieu,1093,337,756,9,747,1,EELV,46,7.825,31.7
2017,ISERE,Bourgoin-Jallieu,1093,337,756,9,747,1,FN,172,7.825,31.7
2017,ISERE,Bourgoin-Jallieu,1093,337,756,9,747,1,LFI,178,7.825,31.7
2017,ISERE,Bourgoin-Jallieu,1093,337,756,9,747,1,LO,0,7.825,31.7
2017,ISERE,Bourgoin-Jallieu,1093,337,756,9,747,1,LR,29,7.825,31.7
2017,ISERE,Bourgoin-Jallieu,1093,337,756,9,747,1,LREM,207,7.825,31.7
2017,ISERE,Bourgoin-Jallieu,1093,337,756,9,747,1,NPA,3,7.825,31.7
2017,ISERE,Bourgoin-Jallieu,1093,337,756,9,747,1,PCF,12,7.825,31.7
2017,ISERE,Bourgoin-Jallieu,1093,337,756,9,747,1,REC,59,7.825,31.7
2017,ISERE,Bourgoin-Jallieu,1093,337,756,9,747,1,RES,12,7.825,31.7
2017,ISERE,Apprieu,1095,185,910,25,885,1,EELV,42,7.825,31.7
2017,ISERE,Apprieu,1095,185,910,25,885,1,FN,198,7.825,31.7
2017,ISERE,Apprieu,1095,185,910,25,885,1,LFI,179,7.825,31.7
2017,ISERE,Apprieu,1095,185,910,25,885,1,LO,5,7.825,31.7
2017,ISERE,Apprieu,1095,185,910,25,885,1,LR,33,7.825,31.7
2017,ISERE,Apprieu,1095,185,910,25,885,1,LREM,256,7.825,31.7
2017,ISERE,Apprieu,1095,185,910,25,885,1,NPA,5,7.825,31.7
2017,ISERE,Apprieu,1095,185,910,25,885,1,PCF,12,7.825,31.7
2017,ISERE,Apprieu,1095,185,910,25,885,1,REC,85,7.825,31.7
2017,ISERE,Apprieu,1095,185,910,25,885,1,RES,30,7.825,31.7
2017,ISERE,Chimilin,1095,234,861,18,843,1,EELV,49,7.825,31.7
2017,ISERE,Chimilin,1095,234,861,18,843,1,FN,277,7.825,31.7
2017,ISERE,Chimilin,1095,234,861,18,843,1,LFI,127,7.825,31.7
2017,ISERE,Chimilin,1095,234,861,18,843,1,LO,4,7.825,31.7
2017,ISERE,Chimilin,1095,234,861,18,843,1,LR,33,7.825,31.7
2017,ISERE,Chimilin,1095,234,861,18,843,1,LREM,194,7.825,31.7
2017,ISERE,Chimilin,1095,234,861,18,843,1,NPA,6,7.825,31.7
2017,ISERE,Chimilin,1095,234,861,18,843,1,PCF,22,7.825,31.7
2017,ISERE,Chimilin,1095,234,861,18,843,1,REC,64,7.825,31.7
2017,ISERE,Chimilin,1095,234,861,18,843,1,RES,28,7.825,31.7
2017,ISERE,Allevard,1095,250,845,16,829,1,EELV,58,7.825,31.7
2017,ISERE,Allevard,1095,250,845,16,829,1,FN,163,7.825,31.7
2017,ISERE,Allevard,1095,250,845,16,829,1,LFI,226,7.825,31.7
2017,ISERE,Allevard,1095,250,845,16,829,1,LO,6,7.825,31.7
2017,ISERE,Allevard,1095,250,845,16,829,1,LR,30,7.825,31.7
2017,ISERE,Allevard,1095,250,845,16,829,1,LREM,196,7.825,31.7
2017,ISERE,Allevard,1095,250,845,16,829,1,NPA,10,7.825,31.7
2017,ISERE,Allevard,1095,250,845,16,829,1,PCF,12,7.825,31.7
2017,ISERE,Allevard,1095,250,845,16,829,1,REC,66,7.825,31.7
2017,ISERE,Allevard,1095,250,845,16,829,1,RES,16,7.825,31.7
2017,ISERE,Saint-Quentin-sur-Isère,1096,190,906,20,886,1,EELV,55,7.825,31.7
2017,ISERE,Saint-Quentin-sur-Isère,1096,190,906,20,886,1,FN,247,7.825,31.7
2017,ISERE,Saint-Quentin-sur-Isère,1096,190,906,20,886,1,LFI,146,7.825,31.7
2017,ISERE,Saint-Quentin-sur-Isère,1096,190,906,20,886,1,LO,10,7.825,31.7
2017,ISERE,Saint-Quentin-sur-Isère,1096,190,906,20,886,1,LR,36,7.825,31.7
2017,ISERE,Saint-Quentin-sur-Isère,1096,190,906,20,886,1,LREM,234,7.825,31.7
2017,ISERE,Saint-Quentin-sur-Isère,1096,190,906,20,886,1,NPA,7,7.825,31.7
2017,ISERE,Saint-Quentin-sur-Isère,1096,190,906,20,886,1,PCF,20,7.825,31.7
2017,ISERE,Saint-Quentin-sur-Isère,1096,190,906,20,886,1,REC,52,7.825,31.7
2017,ISERE,Saint-Quentin-sur-Isère,1096,190,906,20,886,1,RES,41,7.825,31.7
2017,ISERE,Four,1097,174,923,21,902,1,EELV,55,7.825,31.7
2017,ISERE,Four,1097,174,923,21,902,1,FN,249,7.825,31.7
2017,ISERE,Four,1097,174,923,21,902,1,LFI,139,7.825,31.7
2017,ISERE,Four,1097,174,923,21,902,1,LO,3,7.825,31.7
2017,ISERE,Four,1097,174,923,21,902,1,LR,57,7.825,31.7
2017,ISERE,Four,1097,174,923,21,902,1,LREM,228,7.825,31.7
2017,ISERE,Four,1097,174,923,21,902,1,NPA,5,7.825,31.7
2017,ISERE,Four,1097,174,923,21,902,1,PCF,11,7.825,31.7
2017,ISERE,Four,1097,174,923,21,902,1,REC,86,7.825,31.7
2017,ISERE,Four,1097,174,923,21,902,1,RES,23,7.825,31.7
2017,ISERE,Saint-Maurice-l'Exil,1097,365,732,22,710,1,EELV,19,7.825,31.7
2017,ISERE,Saint-Maurice-l'Exil,1097,365,732,22,710,1,FN,229,7.825,31.7
2017,ISERE,Saint-Maurice-l'Exil,1097,365,732,22,710,1,LFI,191,7.825,31.7
2017,ISERE,Saint-Maurice-l'Exil,1097,365,732,22,710,1,LO,4,7.825,31.7
2017,ISERE,Saint-Maurice-l'Exil,1097,365,732,22,710,1,LR,11,7.825,31.7
2017,ISERE,Saint-Maurice-l'Exil,1097,365,732,22,710,1,LREM,131,7.825,31.7
2017,ISERE,Saint-Maurice-l'Exil,1097,365,732,22,710,1,NPA,12,7.825,31.7
2017,ISERE,Saint-Maurice-l'Exil,1097,365,732,22,710,1,PCF,20,7.825,31.7
2017,ISERE,Saint-Maurice-l'Exil,1097,365,732,22,710,1,REC,49,7.825,31.7
2017,ISERE,Saint-Maurice-l'Exil,1097,365,732,22,710,1,RES,18,7.825,31.7
2017,ISERE,Eybens,1098,183,915,22,893,1,EELV,78,7.825,31.7
2017,ISERE,Eybens,1098,183,915,22,893,1,FN,153,7.825,31.7
2017,ISERE,Eybens,1098,183,915,22,893,1,LFI,164,7.825,31.7
2017,ISERE,Eybens,1098,183,915,22,893,1,LO,3,7.825,31.7
2017,ISERE,Eybens,1098,183,915,22,893,1,LR,39,7.825,31.7
2017,ISERE,Eybens,1098,183,915,22,893,1,LREM,309,7.825,31.7
2017,ISERE,Eybens,1098,183,915,22,893,1,NPA,6,7.825,31.7
2017,ISERE,Eybens,1098,183,915,22,893,1,PCF,26,7.825,31.7
2017,ISERE,Eybens,1098,183,915,22,893,1,REC,71,7.825,31.7
2017,ISERE,Eybens,1098,183,915,22,893,1,RES,16,7.825,31.7
2017,ISERE,Grenoble,1098,203,895,11,884,1,EELV,90,7.825,31.7
2017,ISERE,Grenoble,1098,203,895,11,884,1,FN,65,7.825,31.7
2017,ISERE,Grenoble,1098,203,895,11,884,1,LFI,231,7.825,31.7
2017,ISERE,Grenoble,1098,203,895,11,884,1,LO,1,7.825,31.7
2017,ISERE,Grenoble,1098,203,895,11,884,1,LR,53,7.825,31.7
2017,ISERE,Grenoble,1098,203,895,11,884,1,LREM,303,7.825,31.7
2017,ISERE,Grenoble,1098,203,895,11,884,1,NPA,2,7.825,31.7
2017,ISERE,Grenoble,1098,203,895,11,884,1,PCF,13,7.825,31.7
2017,ISERE,Grenoble,1098,203,895,11,884,1,REC,78,7.825,31.7
2017,ISERE,Grenoble,1098,203,895,11,884,1,RES,9,7.825,31.7
2017,ISERE,Grenoble,1098,231,867,14,853,1,EELV,96,7.825,31.7
2017,ISERE,Grenoble,1098,231,867,14,853,1,FN,75,7.825,31.7
2017,ISERE,Grenoble,1098,231,867,14,853,1,LFI,301,7.825,31.7
2017,ISERE,Grenoble,1098,231,867,14,853,1,LO,1,7.825,31.7
2017,ISERE,Grenoble,1098,231,867,14,853,1,LR,32,7.825,31.7
2017,ISERE,Grenoble,1098,231,867,14,853,1,LREM,249,7.825,31.7
2017,ISERE,Grenoble,1098,231,867,14,853,1,NPA,4,7.825,31.7
2017,ISERE,Grenoble,1098,231,867,14,853,1,PCF,19,7.825,31.7
2017,ISERE,Grenoble,1098,231,867,14,853,1,REC,32,7.825,31.7
2017,ISERE,Grenoble,1098,231,867,14,853,1,RES,6,7.825,31.7
2017,ISERE,Saint-Marcellin,1098,261,837,22,815,1,EELV,61,7.825,31.7
2017,ISERE,Saint-Marcellin,1098,261,837,22,815,1,FN,182,7.825,31.7
2017,ISERE,Saint-Marcellin,1098,261,837,22,815,1,LFI,171,7.825,31.7
2017,ISERE,Saint-Marcellin,1098,261,837,22,815,1,LO,9,7.825,31.7
2017,ISERE,Saint-Marcellin,1098,261,837,22,815,1,LR,56,7.825,31.7
2017,ISERE,Saint-Marcellin,1098,261,837,22,815,1,LREM,210,7.825,31.7
2017,ISERE,Saint-Marcellin,1098,261,837,22,815,1,NPA,2,7.825,31.7
2017,ISERE,Saint-Marcellin,1098,261,837,22,815,1,PCF,24,7.825,31.7
2017,ISERE,Saint-Marcellin,1098,261,837,22,815,1,REC,51,7.825,31.7
2017,ISERE,Saint-Marcellin,1098,261,837,22,815,1,RES,25,7.825,31.7
2017,ISERE,Grenoble,1098,301,797,12,785,1,EELV,49,7.825,31.7
2017,ISERE,Grenoble,1098,301,797,12,785,1,FN,127,7.825,31.7
2017,ISERE,Grenoble,1098,301,797,12,785,1,LFI,268,7.825,31.7
2017,ISERE,Grenoble,1098,301,797,12,785,1,LO,4,7.825,31.7
2017,ISERE,Grenoble,1098,301,797,12,785,1,LR,25,7.825,31.7
2017,ISERE,Grenoble,1098,301,797,12,785,1,LREM,212,7.825,31.7
2017,ISERE,Grenoble,1098,301,797,12,785,1,NPA,6,7.825,31.7
2017,ISERE,Grenoble,1098,301,797,12,785,1,PCF,30,7.825,31.7
2017,ISERE,Grenoble,1098,301,797,12,785,1,REC,32,7.825,31.7
2017,ISERE,Grenoble,1098,301,797,12,785,1,RES,15,7.825,31.7
2017,ISERE,Charvieu-Chavagneux,1099,248,851,10,841,1,EELV,19,7.825,31.7
2017,ISERE,Charvieu-Chavagneux,1099,248,851,10,841,1,FN,312,7.825,31.7
2017,ISERE,Charvieu-Chavagneux,1099,248,851,10,841,1,LFI,130,7.825,31.7
2017,ISERE,Charvieu-Chavagneux,1099,248,851,10,841,1,LO,1,7.825,31.7
2017,ISERE,Charvieu-Chavagneux,1099,248,851,10,841,1,LR,21,7.825,31.7
2017,ISERE,Charvieu-Chavagneux,1099,248,851,10,841,1,LREM,200,7.825,31.7
2017,ISERE,Charvieu-Chavagneux,1099,248,851,10,841,1,NPA,2,7.825,31.7
2017,ISERE,Charvieu-Chavagneux,1099,248,851,10,841,1,PCF,15,7.825,31.7
2017,ISERE,Charvieu-Chavagneux,1099,248,851,10,841,1,REC,96,7.825,31.7
2017,ISERE,Charvieu-Chavagneux,1099,248,851,10,841,1,RES,18,7.825,31.7
2017,ISERE,Vienne,1102,298,804,23,781,1,EELV,53,7.825,31.7
2017,ISERE,Vienne,1102,298,804,23,781,1,FN,130,7.825,31.7
2017,ISERE,Vienne,1102,298,804,23,781,1,LFI,201,7.825,31.7
2017,ISERE,Vienne,1102,298,804,23,781,1,LO,1,7.825,31.7
2017,ISERE,Vienne,1102,298,804,23,781,1,LR,35,7.825,31.7
2017,ISERE,Vienne,1102,298,804,23,781,1,LREM,244,7.825,31.7
2017,ISERE,Vienne,1102,298,804,23,781,1,NPA,3,7.825,31.7
2017,ISERE,Vienne,1102,298,804,23,781,1,PCF,13,7.825,31.7
2017,ISERE,Vienne,1102,298,804,23,781,1,REC,65,7.825,31.7
2017,ISERE,Vienne,1102,298,804,23,781,1,RES,12,7.825,31.7
2017,ISERE,Pont-Evêque,1102,305,797,28,769,1,EELV,36,7.825,31.7
2017,ISERE,Pont-Evêque,1102,305,797,28,769,1,FN,181,7.825,31.7
2017,ISERE,Pont-Evêque,1102,305,797,28,769,1,LFI,161,7.825,31.7
2017,ISERE,Pont-Evêque,1102,305,797,28,769,1,LO,3,7.825,31.7
2017,ISERE,Pont-Evêque,1102,305,797,28,769,1,LR,41,7.825,31.7
2017,ISERE,Pont-Evêque,1102,305,797,28,769,1,LREM,215,7.825,31.7
2017,ISERE,Pont-Evêque,1102,305,797,28,769,1,NPA,4,7.825,31.7
2017,ISERE,Pont-Evêque,1102,305,797,28,769,1,PCF,15,7.825,31.7
2017,ISERE,Pont-Evêque,1102,305,797,28,769,1,REC,67,7.825,31.7
2017,ISERE,Pont-Evêque,1102,305,797,28,769,1,RES,20,7.825,31.7
2017,ISERE,Rives,1102,312,790,16,774,1,EELV,38,7.825,31.7
2017,ISERE,Rives,1102,312,790,16,774,1,FN,231,7.825,31.7
2017,ISERE,Rives,1102,312,790,16,774,1,LFI,153,7.825,31.7
2017,ISERE,Rives,1102,312,790,16,774,1,LO,1,7.825,31.7
2017,ISERE,Rives,1102,312,790,16,774,1,LR,32,7.825,31.7
2017,ISERE,Rives,1102,312,790,16,774,1,LREM,186,7.825,31.7
2017,ISERE,Rives,1102,312,790,16,774,1,NPA,7,7.825,31.7
2017,ISERE,Rives,1102,312,790,16,774,1,PCF,26,7.825,31.7
2017,ISERE,Rives,1102,312,790,16,774,1,REC,52,7.825,31.7
2017,ISERE,Rives,1102,312,790,16,774,1,RES,14,7.825,31.7
2017,ISERE,Brié-et-Angonnes,1105,176,929,19,910,1,EELV,63,7.825,31.7
2017,ISERE,Brié-et-Angonnes,1105,176,929,19,910,1,FN,188,7.825,31.7
2017,ISERE,Brié-et-Angonnes,1105,176,929,19,910,1,LFI,104,7.825,31.7
2017,ISERE,Brié-et-Angonnes,1105,176,929,19,910,1,LO,8,7.825,31.7
2017,ISERE,Brié-et-Angonnes,1105,176,929,19,910,1,LR,53,7.825,31.7
2017,ISERE,Brié-et-Angonnes,1105,176,929,19,910,1,LREM,344,7.825,31.7
2017,ISERE,Brié-et-Angonnes,1105,176,929,19,910,1,NPA,3,7.825,31.7
2017,ISERE,Brié-et-Angonnes,1105,176,929,19,910,1,PCF,5,7.825,31.7
2017,ISERE,Brié-et-Angonnes,1105,176,929,19,910,1,REC,91,7.825,31.7
2017,ISERE,Brié-et-Angonnes,1105,176,929,19,910,1,RES,21,7.825,31.7
2017,ISERE,Bouvesse-Quirieu,1105,240,865,24,841,1,EELV,16,7.825,31.7
2017,ISERE,Bouvesse-Quirieu,1105,240,865,24,841,1,FN,306,7.825,31.7
2017,ISERE,Bouvesse-Quirieu,1105,240,865,24,841,1,LFI,147,7.825,31.7
2017,ISERE,Bouvesse-Quirieu,1105,240,865,24,841,1,LO,7,7.825,31.7
2017,ISERE,Bouvesse-Quirieu,1105,240,865,24,841,1,LR,42,7.825,31.7
2017,ISERE,Bouvesse-Quirieu,1105,240,865,24,841,1,LREM,161,7.825,31.7
2017,ISERE,Bouvesse-Quirieu,1105,240,865,24,841,1,NPA,6,7.825,31.7
2017,ISERE,Bouvesse-Quirieu,1105,240,865,24,841,1,PCF,26,7.825,31.7
2017,ISERE,Bouvesse-Quirieu,1105,240,865,24,841,1,REC,71,7.825,31.7
2017,ISERE,Bouvesse-Quirieu,1105,240,865,24,841,1,RES,26,7.825,31.7
2017,ISERE,Crolles,1105,254,851,15,836,1,EELV,68,7.825,31.7
2017,ISERE,Crolles,1105,254,851,15,836,1,FN,126,7.825,31.7
2017,ISERE,Crolles,1105,254,851,15,836,1,LFI,231,7.825,31.7
2017,ISERE,Crolles,1105,254,851,15,836,1,LO,9,7.825,31.7
2017,ISERE,Crolles,1105,254,851,15,836,1,LR,41,7.825,31.7
2017,ISERE,Crolles,1105,254,851,15,836,1,LREM,220,7.825,31.7
2017,ISERE,Crolles,1105,254,851,15,836,1,NPA,6,7.825,31.7
2017,ISERE,Crolles,1105,254,851,15,836,1,PCF,39,7.825,31.7
2017,ISERE,Crolles,1105,254,851,15,836,1,REC,50,7.825,31.7
2017,ISERE,Crolles,1105,254,851,15,836,1,RES,16,7.825,31.7
2017,ISERE,Vinay,1106,239,867,17,850,1,EELV,17,7.825,31.7
2017,ISERE,Vinay,1106,239,867,17,850,1,FN,284,7.825,31.7
2017,ISERE,Vinay,1106,239,867,17,850,1,LFI,148,7.825,31.7
2017,ISERE,Vinay,1106,239,867,17,850,1,LO,5,7.825,31.7
2017,ISERE,Vinay,1106,239,867,17,850,1,LR,42,7.825,31.7
2017,ISERE,Vinay,1106,239,867,17,850,1,LREM,214,7.825,31.7
2017,ISERE,Vinay,1106,239,867,17,850,1,NPA,9,7.825,31.7
2017,ISERE,Vinay,1106,239,867,17,850,1,PCF,10,7.825,31.7
2017,ISERE,Vinay,1106,239,867,17,850,1,REC,55,7.825,31.7
2017,ISERE,Vinay,1106,239,867,17,850,1,RES,27,7.825,31.7
2017,ISERE,L'Isle-d'Abeau,1107,291,816,17,799,1,EELV,40,7.825,31.7
2017,ISERE,L'Isle-d'Abeau,1107,291,816,17,799,1,FN,226,7.825,31.7
2017,ISERE,L'Isle-d'Abeau,1107,291,816,17,799,1,LFI,216,7.825,31.7
2017,ISERE,L'Isle-d'Abeau,1107,291,816,17,799,1,LO,5,7.825,31.7
2017,ISERE,L'Isle-d'Abeau,1107,291,816,17,799,1,LR,23,7.825,31.7
2017,ISERE,L'Isle-d'Abeau,1107,291,816,17,799,1,LREM,159,7.825,31.7
2017,ISERE,L'Isle-d'Abeau,1107,291,816,17,799,1,NPA,6,7.825,31.7
2017,ISERE,L'Isle-d'Abeau,1107,291,816,17,799,1,PCF,19,7.825,31.7
2017,ISERE,L'Isle-d'Abeau,1107,291,816,17,799,1,REC,44,7.825,31.7
2017,ISERE,L'Isle-d'Abeau,1107,291,816,17,799,1,RES,23,7.825,31.7
2017,ISERE,Grenoble,1107,304,803,8,795,1,EELV,58,7.825,31.7
2017,ISERE,Grenoble,1107,304,803,8,795,1,FN,96,7.825,31.7
2017,ISERE,Grenoble,1107,304,803,8,795,1,LFI,310,7.825,31.7
2017,ISERE,Grenoble,1107,304,803,8,795,1,LO,4,7.825,31.7
2017,ISERE,Grenoble,1107,304,803,8,795,1,LR,14,7.825,31.7
2017,ISERE,Grenoble,1107,304,803,8,795,1,LREM,199,7.825,31.7
2017,ISERE,Grenoble,1107,304,803,8,795,1,NPA,8,7.825,31.7
2017,ISERE,Grenoble,1107,304,803,8,795,1,PCF,15,7.825,31.7
2017,ISERE,Grenoble,1107,304,803,8,795,1,REC,49,7.825,31.7
2017,ISERE,Grenoble,1107,304,803,8,795,1,RES,14,7.825,31.7
2017,ISERE,Veurey-Voroize,1108,224,884,12,872,1,EELV,52,7.825,31.7
2017,ISERE,Veurey-Voroize,1108,224,884,12,872,1,FN,219,7.825,31.7
2017,ISERE,Veurey-Voroize,1108,224,884,12,872,1,LFI,151,7.825,31.7
2017,ISERE,Veurey-Voroize,1108,224,884,12,872,1,LO,3,7.825,31.7
2017,ISERE,Veurey-Voroize,1108,224,884,12,872,1,LR,46,7.825,31.7
2017,ISERE,Veurey-Voroize,1108,224,884,12,872,1,LREM,266,7.825,31.7
2017,ISERE,Veurey-Voroize,1108,224,884,12,872,1,NPA,8,7.825,31.7
2017,ISERE,Veurey-Voroize,1108,224,884,12,872,1,PCF,21,7.825,31.7
2017,ISERE,Veurey-Voroize,1108,224,884,12,872,1,REC,57,7.825,31.7
2017,ISERE,Veurey-Voroize,1108,224,884,12,872,1,RES,15,7.825,31.7
2017,ISERE,Vif,1108,227,881,26,855,1,EELV,63,7.825,31.7
2017,ISERE,Vif,1108,227,881,26,855,1,FN,205,7.825,31.7
2017,ISERE,Vif,1108,227,881,26,855,1,LFI,140,7.825,31.7
2017,ISERE,Vif,1108,227,881,26,855,1,LO,4,7.825,31.7
2017,ISERE,Vif,1108,227,881,26,855,1,LR,36,7.825,31.7
2017,ISERE,Vif,1108,227,881,26,855,1,LREM,279,7.825,31.7
2017,ISERE,Vif,1108,227,881,26,855,1,NPA,2,7.825,31.7
2017,ISERE,Vif,1108,227,881,26,855,1,PCF,22,7.825,31.7
2017,ISERE,Vif,1108,227,881,26,855,1,REC,48,7.825,31.7
2017,ISERE,Vif,1108,227,881,26,855,1,RES,26,7.825,31.7
2017,ISERE,Bourgoin-Jallieu,1108,267,841,26,815,1,EELV,58,7.825,31.7
2017,ISERE,Bourgoin-Jallieu,1108,267,841,26,815,1,FN,133,7.825,31.7
2017,ISERE,Bourgoin-Jallieu,1108,267,841,26,815,1,LFI,138,7.825,31.7
2017,ISERE,Bourgoin-Jallieu,1108,267,841,26,815,1,LO,1,7.825,31.7
2017,ISERE,Bourgoin-Jallieu,1108,267,841,26,815,1,LR,63,7.825,31.7
2017,ISERE,Bourgoin-Jallieu,1108,267,841,26,815,1,LREM,258,7.825,31.7
2017,ISERE,Bourgoin-Jallieu,1108,267,841,26,815,1,NPA,2,7.825,31.7
2017,ISERE,Bourgoin-Jallieu,1108,267,841,26,815,1,PCF,20,7.825,31.7
2017,ISERE,Bourgoin-Jallieu,1108,267,841,26,815,1,REC,97,7.825,31.7
2017,ISERE,Bourgoin-Jallieu,1108,267,841,26,815,1,RES,17,7.825,31.7
2017,ISERE,Rives,1112,262,850,11,839,1,EELV,29,7.825,31.7
2017,ISERE,Rives,1112,262,850,11,839,1,FN,253,7.825,31.7
2017,ISERE,Rives,1112,262,850,11,839,1,LFI,151,7.825,31.7
2017,ISERE,Rives,1112,262,850,11,839,1,LO,7,7.825,31.7
2017,ISERE,Rives,1112,262,850,11,839,1,LR,31,7.825,31.7
2017,ISERE,Rives,1112,262,850,11,839,1,LREM,233,7.825,31.7
2017,ISERE,Rives,1112,262,850,11,839,1,NPA,16,7.825,31.7
2017,ISERE,Rives,1112,262,850,11,839,1,PCF,19,7.825,31.7
2017,ISERE,Rives,1112,262,850,11,839,1,REC,49,7.825,31.7
2017,ISERE,Rives,1112,262,850,11,839,1,RES,20,7.825,31.7
2017,ISERE,Pierre-Châtel,1113,218,895,30,865,1,EELV,44,7.825,31.7
2017,ISERE,Pierre-Châtel,1113,218,895,30,865,1,FN,250,7.825,31.7
2017,ISERE,Pierre-Châtel,1113,218,895,30,865,1,LFI,192,7.825,31.7
2017,ISERE,Pierre-Châtel,1113,218,895,30,865,1,LO,14,7.825,31.7
2017,ISERE,Pierre-Châtel,1113,218,895,30,865,1,LR,29,7.825,31.7
2017,ISERE,Pierre-Châtel,1113,218,895,30,865,1,LREM,151,7.825,31.7
2017,ISERE,Pierre-Châtel,1113,218,895,30,865,1,NPA,9,7.825,31.7
2017,ISERE,Pierre-Châtel,1113,218,895,30,865,1,PCF,22,7.825,31.7
2017,ISERE,Pierre-Châtel,1113,218,895,30,865,1,REC,66,7.825,31.7
2017,ISERE,Pierre-Châtel,1113,218,895,30,865,1,RES,29,7.825,31.7
2017,ISERE,Barraux,1115,163,952,13,939,1,EELV,93,7.825,31.7
2017,ISERE,Barraux,1115,163,952,13,939,1,FN,183,7.825,31.7
2017,ISERE,Barraux,1115,163,952,13,939,1,LFI,218,7.825,31.7
2017,ISERE,Barraux,1115,163,952,13,939,1,LO,5,7.825,31.7
2017,ISERE,Barraux,1115,163,952,13,939,1,LR,40,7.825,31.7
2017,ISERE,Barraux,1115,163,952,13,939,1,LREM,252,7.825,31.7
2017,ISERE,Barraux,1115,163,952,13,939,1,NPA,4,7.825,31.7
2017,ISERE,Barraux,1115,163,952,13,939,1,PCF,19,7.825,31.7
2017,ISERE,Barraux,1115,163,952,13,939,1,REC,58,7.825,31.7
2017,ISERE,Barraux,1115,163,952,13,939,1,RES,23,7.825,31.7
2017,ISERE,Moirans,1115,242,873,8,865,1,EELV,45,7.825,31.7
2017,ISERE,Moirans,1115,242,873,8,865,1,FN,171,7.825,31.7
2017,ISERE,Moirans,1115,242,873,8,865,1,LFI,193,7.825,31.7
2017,ISERE,Moirans,1115,242,873,8,865,1,LO,1,7.825,31.7
2017,ISERE,Moirans,1115,242,873,8,865,1,LR,48,7.825,31.7
2017,ISERE,Moirans,1115,242,873,8,865,1,LREM,266,7.825,31.7
2017,ISERE,Moirans,1115,242,873,8,865,1,NPA,4,7.825,31.7
2017,ISERE,Moirans,1115,242,873,8,865,1,PCF,14,7.825,31.7
2017,ISERE,Moirans,1115,242,873,8,865,1,REC,59,7.825,31.7
2017,ISERE,Moirans,1115,242,873,8,865,1,RES,30,7.825,31.7
2017,ISERE,Grenoble,1115,366,749,11,738,1,EELV,34,7.825,31.7
2017,ISERE,Grenoble,1115,366,749,11,738,1,FN,145,7.825,31.7
2017,ISERE,Grenoble,1115,366,749,11,738,1,LFI,260,7.825,31.7
2017,ISERE,Grenoble,1115,366,749,11,738,1,LO,2,7.825,31.7
2017,ISERE,Grenoble,1115,366,749,11,738,1,LR,14,7.825,31.7
2017,ISERE,Grenoble,1115,366,749,11,738,1,LREM,168,7.825,31.7
2017,ISERE,Grenoble,1115,366,749,11,738,1,NPA,13,7.825,31.7
2017,ISERE,Grenoble,1115,366,749,11,738,1,PCF,14,7.825,31.7
2017,ISERE,Grenoble,1115,366,749,11,738,1,REC,47,7.825,31.7
2017,ISERE,Grenoble,1115,366,749,11,738,1,RES,19,7.825,31.7
2017,ISERE,Tullins,1116,371,745,13,732,1,EELV,55,7.825,31.7
2017,ISERE,Tullins,1116,371,745,13,732,1,FN,177,7.825,31.7
2017,ISERE,Tullins,1116,371,745,13,732,1,LFI,183,7.825,31.7
2017,ISERE,Tullins,1116,371,745,13,732,1,LO,3,7.825,31.7
2017,ISERE,Tullins,1116,371,745,13,732,1,LR,20,7.825,31.7
2017,ISERE,Tullins,1116,371,745,13,732,1,LREM,156,7.825,31.7
2017,ISERE,Tullins,1116,371,745,13,732,1,NPA,11,7.825,31.7
2017,ISERE,Tullins,1116,371,745,13,732,1,PCF,15,7.825,31.7
2017,ISERE,Tullins,1116,371,745,13,732,1,REC,56,7.825,31.7
2017,ISERE,Tullins,1116,371,745,13,732,1,RES,25,7.825,31.7
2017,ISERE,Grenoble,1119,260,859,12,847,1,EELV,95,7.825,31.7
2017,ISERE,Grenoble,1119,260,859,12,847,1,FN,69,7.825,31.7
2017,ISERE,Grenoble,1119,260,859,12,847,1,LFI,327,7.825,31.7
2017,ISERE,Grenoble,1119,260,859,12,847,1,LO,2,7.825,31.7
2017,ISERE,Grenoble,1119,260,859,12,847,1,LR,24,7.825,31.7
2017,ISERE,Grenoble,1119,260,859,12,847,1,LREM,219,7.825,31.7
2017,ISERE,Grenoble,1119,260,859,12,847,1,NPA,2,7.825,31.7
2017,ISERE,Grenoble,1119,260,859,12,847,1,PCF,18,7.825,31.7
2017,ISERE,Grenoble,1119,260,859,12,847,1,REC,46,7.825,31.7
2017,ISERE,Grenoble,1119,260,859,12,847,1,RES,12,7.825,31.7
2017,ISERE,Corenc,1120,173,947,12,935,1,EELV,96,7.825,31.7
2017,ISERE,Corenc,1120,173,947,12,935,1,FN,89,7.825,31.7
2017,ISERE,Corenc,1120,173,947,12,935,1,LFI,169,7.825,31.7
2017,ISERE,Corenc,1120,173,947,12,935,1,LO,0,7.825,31.7
2017,ISERE,Corenc,1120,173,947,12,935,1,LR,85,7.825,31.7
2017,ISERE,Corenc,1120,173,947,12,935,1,LREM,345,7.825,31.7
2017,ISERE,Corenc,1120,173,947,12,935,1,NPA,3,7.825,31.7
2017,ISERE,Corenc,1120,173,947,12,935,1,PCF,18,7.825,31.7
2017,ISERE,Corenc,1120,173,947,12,935,1,REC,97,7.825,31.7
2017,ISERE,Corenc,1120,173,947,12,935,1,RES,12,7.825,31.7
2017,ISERE,Fontaine,1122,304,818,17,801,1,EELV,34,7.825,31.7
2017,ISERE,Fontaine,1122,304,818,17,801,1,FN,164,7.825,31.7
2017,ISERE,Fontaine,1122,304,818,17,801,1,LFI,276,7.825,31.7
2017,ISERE,Fontaine,1122,304,818,17,801,1,LO,7,7.825,31.7
2017,ISERE,Fontaine,1122,304,818,17,801,1,LR,21,7.825,31.7
2017,ISERE,Fontaine,1122,304,818,17,801,1,LREM,192,7.825,31.7
2017,ISERE,Fontaine,1122,304,818,17,801,1,NPA,6,7.825,31.7
2017,ISERE,Fontaine,1122,304,818,17,801,1,PCF,32,7.825,31.7
2017,ISERE,Fontaine,1122,304,818,17,801,1,REC,40,7.825,31.7
2017,ISERE,Fontaine,1122,304,818,17,801,1,RES,11,7.825,31.7
2017,ISERE,Saint-Just-Chaleyssin,1123,200,923,23,900,1,EELV,34,7.825,31.7
2017,ISERE,Saint-Just-Chaleyssin,1123,200,923,23,900,1,FN,283,7.825,31.7
2017,ISERE,Saint-Just-Chaleyssin,1123,200,923,23,900,1,LFI,106,7.825,31.7
2017,ISERE,Saint-Just-Chaleyssin,1123,200,923,23,900,1,LO,5,7.825,31.7
2017,ISERE,Saint-Just-Chaleyssin,1123,200,923,23,900,1,LR,47,7.825,31.7
2017,ISERE,Saint-Just-Chaleyssin,1123,200,923,23,900,1,LREM,278,7.825,31.7
2017,ISERE,Saint-Just-Chaleyssin,1123,200,923,23,900,1,NPA,7,7.825,31.7
2017,ISERE,Saint-Just-Chaleyssin,1123,200,923,23,900,1,PCF,11,7.825,31.7
2017,ISERE,Saint-Just-Chaleyssin,1123,200,923,23,900,1,REC,68,7.825,31.7
2017,ISERE,Saint-Just-Chaleyssin,1123,200,923,23,900,1,RES,28,7.825,31.7
2017,ISERE,Heyrieux,1123,238,885,15,870,1,EELV,30,7.825,31.7
2017,ISERE,Heyrieux,1123,238,885,15,870,1,FN,291,7.825,31.7
2017,ISERE,Heyrieux,1123,238,885,15,870,1,LFI,116,7.825,31.7
2017,ISERE,Heyrieux,1123,238,885,15,870,1,LO,4,7.825,31.7
2017,ISERE,Heyrieux,1123,238,885,15,870,1,LR,42,7.825,31.7
2017,ISERE,Heyrieux,1123,238,885,15,870,1,LREM,236,7.825,31.7
2017,ISERE,Heyrieux,1123,238,885,15,870,1,NPA,7,7.825,31.7
2017,ISERE,Heyrieux,1123,238,885,15,870,1,PCF,16,7.825,31.7
2017,ISERE,Heyrieux,1123,238,885,15,870,1,REC,65,7.825,31.7
2017,ISERE,Heyrieux,1123,238,885,15,870,1,RES,23,7.825,31.7
2017,ISERE,Moirans,1123,352,771,10,761,1,EELV,44,7.825,31.7
2017,ISERE,Moirans,1123,352,771,10,761,1,FN,183,7.825,31.7
2017,ISERE,Moirans,1123,352,771,10,761,1,LFI,218,7.825,31.7
2017,ISERE,Moirans,1123,352,771,10,761,1,LO,7,7.825,31.7
2017,ISERE,Moirans,1123,352,771,10,761,1,LR,30,7.825,31.7
2017,ISERE,Moirans,1123,352,771,10,761,1,LREM,191,7.825,31.7
2017,ISERE,Moirans,1123,352,771,10,761,1,NPA,8,7.825,31.7
2017,ISERE,Moirans,1123,352,771,10,761,1,PCF,9,7.825,31.7
2017,ISERE,Moirans,1123,352,771,10,761,1,REC,42,7.825,31.7
2017,ISERE,Moirans,1123,352,771,10,761,1,RES,10,7.825,31.7
2017,ISERE,Heyrieux,1125,195,930,22,908,1,EELV,40,7.825,31.7
2017,ISERE,Heyrieux,1125,195,930,22,908,1,FN,278,7.825,31.7
2017,ISERE,Heyrieux,1125,195,930,22,908,1,LFI,106,7.825,31.7
2017,ISERE,Heyrieux,1125,195,930,22,908,1,LO,1,7.825,31.7
2017,ISERE,Heyrieux,1125,195,930,22,908,1,LR,38,7.825,31.7
2017,ISERE,Heyrieux,1125,195,930,22,908,1,LREM,249,7.825,31.7
2017,ISERE,Heyrieux,1125,195,930,22,908,1,NPA,10,7.825,31.7
2017,ISERE,Heyrieux,1125,195,930,22,908,1,PCF,19,7.825,31.7
2017,ISERE,Heyrieux,1125,195,930,22,908,1,REC,111,7.825,31.7
2017,ISERE,Heyrieux,1125,195,930,22,908,1,RES,25,7.825,31.7
2017,ISERE,Salagnon,1125,241,884,19,865,1,EELV,43,7.825,31.7
2017,ISERE,Salagnon,1125,241,884,19,865,1,FN,310,7.825,31.7
2017,ISERE,Salagnon,1125,241,884,19,865,1,LFI,115,7.825,31.7
2017,ISERE,Salagnon,1125,241,884,19,865,1,LO,6,7.825,31.7
2017,ISERE,Salagnon,1125,241,884,19,865,1,LR,28,7.825,31.7
2017,ISERE,Salagnon,1125,241,884,19,865,1,LREM,210,7.825,31.7
2017,ISERE,Salagnon,1125,241,884,19,865,1,NPA,4,7.825,31.7
2017,ISERE,Salagnon,1125,241,884,19,865,1,PCF,9,7.825,31.7
2017,ISERE,Salagnon,1125,241,884,19,865,1,REC,78,7.825,31.7
2017,ISERE,Salagnon,1125,241,884,19,865,1,RES,31,7.825,31.7
2017,ISERE,Luzinay,1128,224,904,35,869,1,EELV,47,7.825,31.7
2017,ISERE,Luzinay,1128,224,904,35,869,1,FN,273,7.825,31.7
2017,ISERE,Luzinay,1128,224,904,35,869,1,LFI,110,7.825,31.7
2017,ISERE,Luzinay,1128,224,904,35,869,1,LO,3,7.825,31.7
2017,ISERE,Luzinay,1128,224,904,35,869,1,LR,52,7.825,31.7
2017,ISERE,Luzinay,1128,224,904,35,869,1,LREM,244,7.825,31.7
2017,ISERE,Luzinay,1128,224,904,35,869,1,NPA,7,7.825,31.7
2017,ISERE,Luzinay,1128,224,904,35,869,1,PCF,18,7.825,31.7
2017,ISERE,Luzinay,1128,224,904,35,869,1,REC,64,7.825,31.7
2017,ISERE,Luzinay,1128,224,904,35,869,1,RES,18,7.825,31.7
2017,ISERE,Les Abrets en Dauphiné,1128,282,846,17,829,1,EELV,32,7.825,31.7
2017,ISERE,Les Abrets en Dauphiné,1128,282,846,17,829,1,FN,259,7.825,31.7
2017,ISERE,Les Abrets en Dauphiné,1128,282,846,17,829,1,LFI,169,7.825,31.7
2017,ISERE,Les Abrets en Dauphiné,1128,282,846,17,829,1,LO,5,7.825,31.7
2017,ISERE,Les Abrets en Dauphiné,1128,282,846,17,829,1,LR,36,7.825,31.7
2017,ISERE,Les Abrets en Dauphiné,1128,282,846,17,829,1,LREM,198,7.825,31.7
2017,ISERE,Les Abrets en Dauphiné,1128,282,846,17,829,1,NPA,5,7.825,31.7
2017,ISERE,Les Abrets en Dauphiné,1128,282,846,17,829,1,PCF,6,7.825,31.7
2017,ISERE,Les Abrets en Dauphiné,1128,282,846,17,829,1,REC,56,7.825,31.7
2017,ISERE,Les Abrets en Dauphiné,1128,282,846,17,829,1,RES,26,7.825,31.7
2017,ISERE,Lans-en-Vercors,1129,170,959,12,947,1,EELV,100,7.825,31.7
2017,ISERE,Lans-en-Vercors,1129,170,959,12,947,1,FN,119,7.825,31.7
2017,ISERE,Lans-en-Vercors,1129,170,959,12,947,1,LFI,254,7.825,31.7
2017,ISERE,Lans-en-Vercors,1129,170,959,12,947,1,LO,7,7.825,31.7
2017,ISERE,Lans-en-Vercors,1129,170,959,12,947,1,LR,50,7.825,31.7
2017,ISERE,Lans-en-Vercors,1129,170,959,12,947,1,LREM,255,7.825,31.7
2017,ISERE,Lans-en-Vercors,1129,170,959,12,947,1,NPA,7,7.825,31.7
2017,ISERE,Lans-en-Vercors,1129,170,959,12,947,1,PCF,23,7.825,31.7
2017,ISERE,Lans-en-Vercors,1129,170,959,12,947,1,REC,47,7.825,31.7
2017,ISERE,Lans-en-Vercors,1129,170,959,12,947,1,RES,30,7.825,31.7
2017,ISERE,Pontcharra,1129,247,882,23,859,1,EELV,54,7.825,31.7
2017,ISERE,Pontcharra,1129,247,882,23,859,1,FN,239,7.825,31.7
2017,ISERE,Pontcharra,1129,247,882,23,859,1,LFI,201,7.825,31.7
2017,ISERE,Pontcharra,1129,247,882,23,859,1,LO,6,7.825,31.7
2017,ISERE,Pontcharra,1129,247,882,23,859,1,LR,26,7.825,31.7
2017,ISERE,Pontcharra,1129,247,882,23,859,1,LREM,189,7.825,31.7
2017,ISERE,Pontcharra,1129,247,882,23,859,1,NPA,8,7.825,31.7
2017,ISERE,Pontcharra,1129,247,882,23,859,1,PCF,16,7.825,31.7
2017,ISERE,Pontcharra,1129,247,882,23,859,1,REC,66,7.825,31.7
2017,ISERE,Pontcharra,1129,247,882,23,859,1,RES,18,7.825,31.7
2017,ISERE,Faverges-de-la-Tour,1130,204,926,27,899,1,EELV,51,7.825,31.7
2017,ISERE,Faverges-de-la-Tour,1130,204,926,27,899,1,FN,273,7.825,31.7
2017,ISERE,Faverges-de-la-Tour,1130,204,926,27,899,1,LFI,169,7.825,31.7
2017,ISERE,Faverges-de-la-Tour,1130,204,926,27,899,1,LO,8,7.825,31.7
2017,ISERE,Faverges-de-la-Tour,1130,204,926,27,899,1,LR,26,7.825,31.7
2017,ISERE,Faverges-de-la-Tour,1130,204,926,27,899,1,LREM,183,7.825,31.7
2017,ISERE,Faverges-de-la-Tour,1130,204,926,27,899,1,NPA,5,7.825,31.7
2017,ISERE,Faverges-de-la-Tour,1130,204,926,27,899,1,PCF,20,7.825,31.7
2017,ISERE,Faverges-de-la-Tour,1130,204,926,27,899,1,REC,71,7.825,31.7
2017,ISERE,Faverges-de-la-Tour,1130,204,926,27,899,1,RES,32,7.825,31.7
2017,ISERE,Moirans,1130,242,888,16,872,1,EELV,66,7.825,31.7
2017,ISERE,Moirans,1130,242,888,16,872,1,FN,183,7.825,31.7
2017,ISERE,Moirans,1130,242,888,16,872,1,LFI,220,7.825,31.7
2017,ISERE,Moirans,1130,242,888,16,872,1,LO,2,7.825,31.7
2017,ISERE,Moirans,1130,242,888,16,872,1,LR,35,7.825,31.7
2017,ISERE,Moirans,1130,242,888,16,872,1,LREM,211,7.825,31.7
2017,ISERE,Moirans,1130,242,888,16,872,1,NPA,3,7.825,31.7
2017,ISERE,Moirans,1130,242,888,16,872,1,PCF,17,7.825,31.7
2017,ISERE,Moirans,1130,242,888,16,872,1,REC,66,7.825,31.7
2017,ISERE,Moirans,1130,242,888,16,872,1,RES,34,7.825,31.7
2017,ISERE,Grenoble,1131,295,836,5,831,1,EELV,77,7.825,31.7
2017,ISERE,Grenoble,1131,295,836,5,831,1,FN,93,7.825,31.7
2017,ISERE,Grenoble,1131,295,836,5,831,1,LFI,304,7.825,31.7
2017,ISERE,Grenoble,1131,295,836,5,831,1,LO,4,7.825,31.7
2017,ISERE,Grenoble,1131,295,836,5,831,1,LR,31,7.825,31.7
2017,ISERE,Grenoble,1131,295,836,5,831,1,LREM,214,7.825,31.7
2017,ISERE,Grenoble,1131,295,836,5,831,1,NPA,5,7.825,31.7
2017,ISERE,Grenoble,1131,295,836,5,831,1,PCF,16,7.825,31.7
2017,ISERE,Grenoble,1131,295,836,5,831,1,REC,47,7.825,31.7
2017,ISERE,Grenoble,1131,295,836,5,831,1,RES,19,7.825,31.7
2017,ISERE,Claix,1132,202,930,17,913,1,EELV,79,7.825,31.7
2017,ISERE,Claix,1132,202,930,17,913,1,FN,107,7.825,31.7
2017,ISERE,Claix,1132,202,930,17,913,1,LFI,159,7.825,31.7
2017,ISERE,Claix,1132,202,930,17,913,1,LO,2,7.825,31.7
2017,ISERE,Claix,1132,202,930,17,913,1,LR,54,7.825,31.7
2017,ISERE,Claix,1132,202,930,17,913,1,LREM,366,7.825,31.7
2017,ISERE,Claix,1132,202,930,17,913,1,NPA,7,7.825,31.7
2017,ISERE,Claix,1132,202,930,17,913,1,PCF,20,7.825,31.7
2017,ISERE,Claix,1132,202,930,17,913,1,REC,56,7.825,31.7
2017,ISERE,Claix,1132,202,930,17,913,1,RES,22,7.825,31.7
2017,ISERE,Saint-Etienne-de-Crossey,1132,211,921,21,900,1,EELV,89,7.825,31.7
2017,ISERE,Saint-Etienne-de-Crossey,1132,211,921,21,900,1,FN,144,7.825,31.7
2017,ISERE,Saint-Etienne-de-Crossey,1132,211,921,21,900,1,LFI,205,7.825,31.7
2017,ISERE,Saint-Etienne-de-Crossey,1132,211,921,21,900,1,LO,2,7.825,31.7
2017,ISERE,Saint-Etienne-de-Crossey,1132,211,921,21,900,1,LR,35,7.825,31.7
2017,ISERE,Saint-Etienne-de-Crossey,1132,211,921,21,900,1,LREM,289,7.825,31.7
2017,ISERE,Saint-Etienne-de-Crossey,1132,211,921,21,900,1,NPA,6,7.825,31.7
2017,ISERE,Saint-Etienne-de-Crossey,1132,211,921,21,900,1,PCF,23,7.825,31.7
2017,ISERE,Saint-Etienne-de-Crossey,1132,211,921,21,900,1,REC,46,7.825,31.7
2017,ISERE,Saint-Etienne-de-Crossey,1132,211,921,21,900,1,RES,16,7.825,31.7
2017,ISERE,Viriville,1135,241,894,28,866,1,EELV,46,7.825,31.7
2017,ISERE,Viriville,1135,241,894,28,866,1,FN,245,7.825,31.7
2017,ISERE,Viriville,1135,241,894,28,866,1,LFI,155,7.825,31.7
2017,ISERE,Viriville,1135,241,894,28,866,1,LO,4,7.825,31.7
2017,ISERE,Viriville,1135,241,894,28,866,1,LR,36,7.825,31.7
2017,ISERE,Viriville,1135,241,894,28,866,1,LREM,202,7.825,31.7
2017,ISERE,Viriville,1135,241,894,28,866,1,NPA,7,7.825,31.7
2017,ISERE,Viriville,1135,241,894,28,866,1,PCF,20,7.825,31.7
2017,ISERE,Viriville,1135,241,894,28,866,1,REC,74,7.825,31.7
2017,ISERE,Viriville,1135,241,894,28,866,1,RES,41,7.825,31.7
2017,ISERE,Domène,1136,229,907,14,893,1,EELV,56,7.825,31.7
2017,ISERE,Domène,1136,229,907,14,893,1,FN,194,7.825,31.7
2017,ISERE,Domène,1136,229,907,14,893,1,LFI,187,7.825,31.7
2017,ISERE,Domène,1136,229,907,14,893,1,LO,9,7.825,31.7
2017,ISERE,Domène,1136,229,907,14,893,1,LR,50,7.825,31.7
2017,ISERE,Domène,1136,229,907,14,893,1,LREM,243,7.825,31.7
2017,ISERE,Domène,1136,229,907,14,893,1,NPA,6,7.825,31.7
2017,ISERE,Domène,1136,229,907,14,893,1,PCF,31,7.825,31.7
2017,ISERE,Domène,1136,229,907,14,893,1,REC,55,7.825,31.7
2017,ISERE,Domène,1136,229,907,14,893,1,RES,26,7.825,31.7
2017,ISERE,Roussillon,1136,236,900,24,876,1,EELV,32,7.825,31.7
2017,ISERE,Roussillon,1136,236,900,24,876,1,FN,252,7.825,31.7
2017,ISERE,Roussillon,1136,236,900,24,876,1,LFI,171,7.825,31.7
2017,ISERE,Roussillon,1136,236,900,24,876,1,LO,1,7.825,31.7
2017,ISERE,Roussillon,1136,236,900,24,876,1,LR,36,7.825,31.7
2017,ISERE,Roussillon,1136,236,900,24,876,1,LREM,226,7.825,31.7
2017,ISERE,Roussillon,1136,236,900,24,876,1,NPA,7,7.825,31.7
2017,ISERE,Roussillon,1136,236,900,24,876,1,PCF,13,7.825,31.7
2017,ISERE,Roussillon,1136,236,900,24,876,1,REC,73,7.825,31.7
2017,ISERE,Roussillon,1136,236,900,24,876,1,RES,19,7.825,31.7
2017,ISERE,Seyssins,1137,215,922,19,903,1,EELV,58,7.825,31.7
2017,ISERE,Seyssins,1137,215,922,19,903,1,FN,172,7.825,31.7
2017,ISERE,Seyssins,1137,215,922,19,903,1,LFI,181,7.825,31.7
2017,ISERE,Seyssins,1137,215,922,19,903,1,LO,7,7.825,31.7
2017,ISERE,Seyssins,1137,215,922,19,903,1,LR,40,7.825,31.7
2017,ISERE,Seyssins,1137,215,922,19,903,1,LREM,312,7.825,31.7
2017,ISERE,Seyssins,1137,215,922,19,903,1,NPA,4,7.825,31.7
2017,ISERE,Seyssins,1137,215,922,19,903,1,PCF,12,7.825,31.7
2017,ISERE,Seyssins,1137,215,922,19,903,1,REC,63,7.825,31.7
2017,ISERE,Seyssins,1137,215,922,19,903,1,RES,17,7.825,31.7
2017,ISERE,Chasse-sur-Rhône,1138,290,848,25,823,1,EELV,15,7.825,31.7
2017,ISERE,Chasse-sur-Rhône,1138,290,848,25,823,1,FN,288,7.825,31.7
2017,ISERE,Chasse-sur-Rhône,1138,290,848,25,823,1,LFI,176,7.825,31.7
2017,ISERE,Chasse-sur-Rhône,1138,290,848,25,823,1,LO,2,7.825,31.7
2017,ISERE,Chasse-sur-Rhône,1138,290,848,25,823,1,LR,17,7.825,31.7
2017,ISERE,Chasse-sur-Rhône,1138,290,848,25,823,1,LREM,168,7.825,31.7
2017,ISERE,Chasse-sur-Rhône,1138,290,848,25,823,1,NPA,9,7.825,31.7
2017,ISERE,Chasse-sur-Rhône,1138,290,848,25,823,1,PCF,13,7.825,31.7
2017,ISERE,Chasse-sur-Rhône,1138,290,848,25,823,1,REC,69,7.825,31.7
2017,ISERE,Chasse-sur-Rhône,1138,290,848,25,823,1,RES,18,7.825,31.7
2017,ISERE,Le Cheylas,1139,235,904,19,885,1,EELV,40,7.825,31.7
2017,ISERE,Le Cheylas,1139,235,904,19,885,1,FN,214,7.825,31.7
2017,ISERE,Le Cheylas,1139,235,904,19,885,1,LFI,193,7.825,31.7
2017,ISERE,Le Cheylas,1139,235,904,19,885,1,LO,4,7.825,31.7
2017,ISERE,Le Cheylas,1139,235,904,19,885,1,LR,30,7.825,31.7
2017,ISERE,Le Cheylas,1139,235,904,19,885,1,LREM,258,7.825,31.7
2017,ISERE,Le Cheylas,1139,235,904,19,885,1,NPA,3,7.825,31.7
2017,ISERE,Le Cheylas,1139,235,904,19,885,1,PCF,35,7.825,31.7
2017,ISERE,Le Cheylas,1139,235,904,19,885,1,REC,54,7.825,31.7
2017,ISERE,Le Cheylas,1139,235,904,19,885,1,RES,26,7.825,31.7
2017,ISERE,Rives,1139,279,860,18,842,1,EELV,50,7.825,31.7
2017,ISERE,Rives,1139,279,860,18,842,1,FN,228,7.825,31.7
2017,ISERE,Rives,1139,279,860,18,842,1,LFI,197,7.825,31.7
2017,ISERE,Rives,1139,279,860,18,842,1,LO,8,7.825,31.7
2017,ISERE,Rives,1139,279,860,18,842,1,LR,30,7.825,31.7
2017,ISERE,Rives,1139,279,860,18,842,1,LREM,193,7.825,31.7
2017,ISERE,Rives,1139,279,860,18,842,1,NPA,8,7.825,31.7
2017,ISERE,Rives,1139,279,860,18,842,1,PCF,17,7.825,31.7
2017,ISERE,Rives,1139,279,860,18,842,1,REC,44,7.825,31.7
2017,ISERE,Rives,1139,279,860,18,842,1,RES,16,7.825,31.7
2017,ISERE,Varces-Allières-et-Risset,1141,221,920,18,902,1,EELV,58,7.825,31.7
2017,ISERE,Varces-Allières-et-Risset,1141,221,920,18,902,1,FN,235,7.825,31.7
2017,ISERE,Varces-Allières-et-Risset,1141,221,920,18,902,1,LFI,127,7.825,31.7
2017,ISERE,Varces-Allières-et-Risset,1141,221,920,18,902,1,LO,1,7.825,31.7
2017,ISERE,Varces-Allières-et-Risset,1141,221,920,18,902,1,LR,43,7.825,31.7
2017,ISERE,Varces-Allières-et-Risset,1141,221,920,18,902,1,LREM,279,7.825,31.7
2017,ISERE,Varces-Allières-et-Risset,1141,221,920,18,902,1,NPA,6,7.825,31.7
2017,ISERE,Varces-Allières-et-Risset,1141,221,920,18,902,1,PCF,15,7.825,31.7
2017,ISERE,Varces-Allières-et-Risset,1141,221,920,18,902,1,REC,78,7.825,31.7
2017,ISERE,Varces-Allières-et-Risset,1141,221,920,18,902,1,RES,16,7.825,31.7
2017,ISERE,Saint-Savin,1141,235,906,21,885,1,EELV,34,7.825,31.7
2017,ISERE,Saint-Savin,1141,235,906,21,885,1,FN,277,7.825,31.7
2017,ISERE,Saint-Savin,1141,235,906,21,885,1,LFI,127,7.825,31.7
2017,ISERE,Saint-Savin,1141,235,906,21,885,1,LO,3,7.825,31.7
2017,ISERE,Saint-Savin,1141,235,906,21,885,1,LR,36,7.825,31.7
2017,ISERE,Saint-Savin,1141,235,906,21,885,1,LREM,222,7.825,31.7
2017,ISERE,Saint-Savin,1141,235,906,21,885,1,NPA,6,7.825,31.7
2017,ISERE,Saint-Savin,1141,235,906,21,885,1,PCF,24,7.825,31.7
2017,ISERE,Saint-Savin,1141,235,906,21,885,1,REC,96,7.825,31.7
2017,ISERE,Saint-Savin,1141,235,906,21,885,1,RES,22,7.825,31.7
2017,ISERE,Chapareillan,1143,186,957,25,932,1,EELV,97,7.825,31.7
2017,ISERE,Chapareillan,1143,186,957,25,932,1,FN,177,7.825,31.7
2017,ISERE,Chapareillan,1143,186,957,25,932,1,LFI,202,7.825,31.7
2017,ISERE,Chapareillan,1143,186,957,25,932,1,LO,6,7.825,31.7
2017,ISERE,Chapareillan,1143,186,957,25,932,1,LR,52,7.825,31.7
2017,ISERE,Chapareillan,1143,186,957,25,932,1,LREM,229,7.825,31.7
2017,ISERE,Chapareillan,1143,186,957,25,932,1,NPA,12,7.825,31.7
2017,ISERE,Chapareillan,1143,186,957,25,932,1,PCF,24,7.825,31.7
2017,ISERE,Chapareillan,1143,186,957,25,932,1,REC,67,7.825,31.7
2017,ISERE,Chapareillan,1143,186,957,25,932,1,RES,26,7.825,31.7
2017,ISERE,Echirolles,1143,237,906,12,894,1,EELV,43,7.825,31.7
2017,ISERE,Echirolles,1143,237,906,12,894,1,FN,191,7.825,31.7
2017,ISERE,Echirolles,1143,237,906,12,894,1,LFI,225,7.825,31.7
2017,ISERE,Echirolles,1143,237,906,12,894,1,LO,7,7.825,31.7
2017,ISERE,Echirolles,1143,237,906,12,894,1,LR,28,7.825,31.7
2017,ISERE,Echirolles,1143,237,906,12,894,1,LREM,249,7.825,31.7
2017,ISERE,Echirolles,1143,237,906,12,894,1,NPA,8,7.825,31.7
2017,ISERE,Echirolles,1143,237,906,12,894,1,PCF,32,7.825,31.7
2017,ISERE,Echirolles,1143,237,906,12,894,1,REC,50,7.825,31.7
2017,ISERE,Echirolles,1143,237,906,12,894,1,RES,24,7.825,31.7
2017,ISERE,Saint-Hilaire-de-la-Côte,1144,188,956,28,928,1,EELV,41,7.825,31.7
2017,ISERE,Saint-Hilaire-de-la-Côte,1144,188,956,28,928,1,FN,257,7.825,31.7
2017,ISERE,Saint-Hilaire-de-la-Côte,1144,188,956,28,928,1,LFI,178,7.825,31.7
2017,ISERE,Saint-Hilaire-de-la-Côte,1144,188,956,28,928,1,LO,5,7.825,31.7
2017,ISERE,Saint-Hilaire-de-la-Côte,1144,188,956,28,928,1,LR,41,7.825,31.7
2017,ISERE,Saint-Hilaire-de-la-Côte,1144,188,956,28,928,1,LREM,246,7.825,31.7
2017,ISERE,Saint-Hilaire-de-la-Côte,1144,188,956,28,928,1,NPA,4,7.825,31.7
2017,ISERE,Saint-Hilaire-de-la-Côte,1144,188,956,28,928,1,PCF,15,7.825,31.7
2017,ISERE,Saint-Hilaire-de-la-Côte,1144,188,956,28,928,1,REC,68,7.825,31.7
2017,ISERE,Saint-Hilaire-de-la-Côte,1144,188,956,28,928,1,RES,27,7.825,31.7
2017,ISERE,Auberives-sur-Varèze,1144,299,845,19,826,1,EELV,22,7.825,31.7
2017,ISERE,Auberives-sur-Varèze,1144,299,845,19,826,1,FN,282,7.825,31.7
2017,ISERE,Auberives-sur-Varèze,1144,299,845,19,826,1,LFI,141,7.825,31.7
2017,ISERE,Auberives-sur-Varèze,1144,299,845,19,826,1,LO,4,7.825,31.7
2017,ISERE,Auberives-sur-Varèze,1144,299,845,19,826,1,LR,36,7.825,31.7
2017,ISERE,Auberives-sur-Varèze,1144,299,845,19,826,1,LREM,171,7.825,31.7
2017,ISERE,Auberives-sur-Varèze,1144,299,845,19,826,1,NPA,9,7.825,31.7
2017,ISERE,Auberives-sur-Varèze,1144,299,845,19,826,1,PCF,24,7.825,31.7
2017,ISERE,Auberives-sur-Varèze,1144,299,845,19,826,1,REC,62,7.825,31.7
2017,ISERE,Auberives-sur-Varèze,1144,299,845,19,826,1,RES,38,7.825,31.7
2017,ISERE,Dolomieu,1145,211,934,23,911,1,EELV,30,7.825,31.7
2017,ISERE,Dolomieu,1145,211,934,23,911,1,FN,280,7.825,31.7
2017,ISERE,Dolomieu,1145,211,934,23,911,1,LFI,160,7.825,31.7
2017,ISERE,Dolomieu,1145,211,934,23,911,1,LO,5,7.825,31.7
2017,ISERE,Dolomieu,1145,211,934,23,911,1,LR,40,7.825,31.7
2017,ISERE,Dolomieu,1145,211,934,23,911,1,LREM,235,7.825,31.7
2017,ISERE,Dolomieu,1145,211,934,23,911,1,NPA,6,7.825,31.7
2017,ISERE,Dolomieu,1145,211,934,23,911,1,PCF,14,7.825,31.7
2017,ISERE,Dolomieu,1145,211,934,23,911,1,REC,65,7.825,31.7
2017,ISERE,Dolomieu,1145,211,934,23,911,1,RES,24,7.825,31.7
2017,ISERE,Pontcharra,1145,277,868,20,848,1,EELV,51,7.825,31.7
2017,ISERE,Pontcharra,1145,277,868,20,848,1,FN,215,7.825,31.7
2017,ISERE,Pontcharra,1145,277,868,20,848,1,LFI,158,7.825,31.7
2017,ISERE,Pontcharra,1145,277,868,20,848,1,LO,4,7.825,31.7
2017,ISERE,Pontcharra,1145,277,868,20,848,1,LR,51,7.825,31.7
2017,ISERE,Pontcharra,1145,277,868,20,848,1,LREM,240,7.825,31.7
2017,ISERE,Pontcharra,1145,277,868,20,848,1,NPA,5,7.825,31.7
2017,ISERE,Pontcharra,1145,277,868,20,848,1,PCF,18,7.825,31.7
2017,ISERE,Pontcharra,1145,277,868,20,848,1,REC,48,7.825,31.7
2017,ISERE,Pontcharra,1145,277,868,20,848,1,RES,16,7.825,31.7
2017,ISERE,Saint-Prim,1146,224,922,18,904,1,EELV,56,7.825,31.7
2017,ISERE,Saint-Prim,1146,224,922,18,904,1,FN,261,7.825,31.7
2017,ISERE,Saint-Prim,1146,224,922,18,904,1,LFI,101,7.825,31.7
2017,ISERE,Saint-Prim,1146,224,922,18,904,1,LO,10,7.825,31.7
2017,ISERE,Saint-Prim,1146,224,922,18,904,1,LR,40,7.825,31.7
2017,ISERE,Saint-Prim,1146,224,922,18,904,1,LREM,266,7.825,31.7
2017,ISERE,Saint-Prim,1146,224,922,18,904,1,NPA,4,7.825,31.7
2017,ISERE,Saint-Prim,1146,224,922,18,904,1,PCF,23,7.825,31.7
2017,ISERE,Saint-Prim,1146,224,922,18,904,1,REC,77,7.825,31.7
2017,ISERE,Saint-Prim,1146,224,922,18,904,1,RES,28,7.825,31.7
2017,ISERE,Villefontaine,1146,259,887,14,873,1,EELV,58,7.825,31.7
2017,ISERE,Villefontaine,1146,259,887,14,873,1,FN,142,7.825,31.7
2017,ISERE,Villefontaine,1146,259,887,14,873,1,LFI,279,7.825,31.7
2017,ISERE,Villefontaine,1146,259,887,14,873,1,LO,8,7.825,31.7
2017,ISERE,Villefontaine,1146,259,887,14,873,1,LR,31,7.825,31.7
2017,ISERE,Villefontaine,1146,259,887,14,873,1,LREM,241,7.825,31.7
2017,ISERE,Villefontaine,1146,259,887,14,873,1,NPA,5,7.825,31.7
2017,ISERE,Villefontaine,1146,259,887,14,873,1,PCF,17,7.825,31.7
2017,ISERE,Villefontaine,1146,259,887,14,873,1,REC,44,7.825,31.7
2017,ISERE,Villefontaine,1146,259,887,14,873,1,RES,16,7.825,31.7
2017,ISERE,Saint-Jean-de-Soudain,1146,266,880,27,853,1,EELV,40,7.825,31.7
2017,ISERE,Saint-Jean-de-Soudain,1146,266,880,27,853,1,FN,266,7.825,31.7
2017,ISERE,Saint-Jean-de-Soudain,1146,266,880,27,853,1,LFI,133,7.825,31.7
2017,ISERE,Saint-Jean-de-Soudain,1146,266,880,27,853,1,LO,4,7.825,31.7
2017,ISERE,Saint-Jean-de-Soudain,1146,266,880,27,853,1,LR,35,7.825,31.7
2017,ISERE,Saint-Jean-de-Soudain,1146,266,880,27,853,1,LREM,222,7.825,31.7
2017,ISERE,Saint-Jean-de-Soudain,1146,266,880,27,853,1,NPA,5,7.825,31.7
2017,ISERE,Saint-Jean-de-Soudain,1146,266,880,27,853,1,PCF,18,7.825,31.7
2017,ISERE,Saint-Jean-de-Soudain,1146,266,880,27,853,1,REC,56,7.825,31.7
2017,ISERE,Saint-Jean-de-Soudain,1146,266,880,27,853,1,RES,38,7.825,31.7
2017,ISERE,Saint-Martin-d'Hères,1147,337,810,18,792,1,EELV,39,7.825,31.7
2017,ISERE,Saint-Martin-d'Hères,1147,337,810,18,792,1,FN,130,7.825,31.7
2017,ISERE,Saint-Martin-d'Hères,1147,337,810,18,792,1,LFI,358,7.825,31.7
2017,ISERE,Saint-Martin-d'Hères,1147,337,810,18,792,1,LO,2,7.825,31.7
2017,ISERE,Saint-Martin-d'Hères,1147,337,810,18,792,1,LR,16,7.825,31.7
2017,ISERE,Saint-Martin-d'Hères,1147,337,810,18,792,1,LREM,136,7.825,31.7
2017,ISERE,Saint-Martin-d'Hères,1147,337,810,18,792,1,NPA,8,7.825,31.7
2017,ISERE,Saint-Martin-d'Hères,1147,337,810,18,792,1,PCF,23,7.825,31.7
2017,ISERE,Saint-Martin-d'Hères,1147,337,810,18,792,1,REC,38,7.825,31.7
2017,ISERE,Saint-Martin-d'Hères,1147,337,810,18,792,1,RES,14,7.825,31.7
2017,ISERE,Saint-Clair-du-Rhône,1150,256,894,32,862,1,EELV,44,7.825,31.7
2017,ISERE,Saint-Clair-du-Rhône,1150,256,894,32,862,1,FN,257,7.825,31.7
2017,ISERE,Saint-Clair-du-Rhône,1150,256,894,32,862,1,LFI,167,7.825,31.7
2017,ISERE,Saint-Clair-du-Rhône,1150,256,894,32,862,1,LO,3,7.825,31.7
2017,ISERE,Saint-Clair-du-Rhône,1150,256,894,32,862,1,LR,29,7.825,31.7
2017,ISERE,Saint-Clair-du-Rhône,1150,256,894,32,862,1,LREM,221,7.825,31.7
2017,ISERE,Saint-Clair-du-Rhône,1150,256,894,32,862,1,NPA,15,7.825,31.7
2017,ISERE,Saint-Clair-du-Rhône,1150,256,894,32,862,1,PCF,11,7.825,31.7
2017,ISERE,Saint-Clair-du-Rhône,1150,256,894,32,862,1,REC,48,7.825,31.7
2017,ISERE,Saint-Clair-du-Rhône,1150,256,894,32,862,1,RES,29,7.825,31.7
2017,ISERE,Cessieu,1152,272,880,14,866,1,EELV,35,7.825,31.7
2017,ISERE,Cessieu,1152,272,880,14,866,1,FN,311,7.825,31.7
2017,ISERE,Cessieu,1152,272,880,14,866,1,LFI,115,7.825,31.7
2017,ISERE,Cessieu,1152,272,880,14,866,1,LO,5,7.825,31.7
2017,ISERE,Cessieu,1152,272,880,14,866,1,LR,36,7.825,31.7
2017,ISERE,Cessieu,1152,272,880,14,866,1,LREM,202,7.825,31.7
2017,ISERE,Cessieu,1152,272,880,14,866,1,NPA,9,7.825,31.7
2017,ISERE,Cessieu,1152,272,880,14,866,1,PCF,23,7.825,31.7
2017,ISERE,Cessieu,1152,272,880,14,866,1,REC,71,7.825,31.7
2017,ISERE,Cessieu,1152,272,880,14,866,1,RES,21,7.825,31.7
2017,ISERE,Bourgoin-Jallieu,1152,314,838,20,818,1,EELV,59,7.825,31.7
2017,ISERE,Bourgoin-Jallieu,1152,314,838,20,818,1,FN,195,7.825,31.7
2017,ISERE,Bourgoin-Jallieu,1152,314,838,20,818,1,LFI,136,7.825,31.7
2017,ISERE,Bourgoin-Jallieu,1152,314,838,20,818,1,LO,3,7.825,31.7
2017,ISERE,Bourgoin-Jallieu,1152,314,838,20,818,1,LR,52,7.825,31.7
2017,ISERE,Bourgoin-Jallieu,1152,314,838,20,818,1,LREM,229,7.825,31.7
2017,ISERE,Bourgoin-Jallieu,1152,314,838,20,818,1,NPA,4,7.825,31.7
2017,ISERE,Bourgoin-Jallieu,1152,314,838,20,818,1,PCF,14,7.825,31.7
2017,ISERE,Bourgoin-Jallieu,1152,314,838,20,818,1,REC,67,7.825,31.7
2017,ISERE,Bourgoin-Jallieu,1152,314,838,20,818,1,RES,16,7.825,31.7
2017,ISERE,Varces-Allières-et-Risset,1153,225,928,20,908,1,EELV,56,7.825,31.7
2017,ISERE,Varces-Allières-et-Risset,1153,225,928,20,908,1,FN,187,7.825,31.7
2017,ISERE,Varces-Allières-et-Risset,1153,225,928,20,908,1,LFI,141,7.825,31.7
2017,ISERE,Varces-Allières-et-Risset,1153,225,928,20,908,1,LO,2,7.825,31.7
2017,ISERE,Varces-Allières-et-Risset,1153,225,928,20,908,1,LR,36,7.825,31.7
2017,ISERE,Varces-Allières-et-Risset,1153,225,928,20,908,1,LREM,308,7.825,31.7
2017,ISERE,Varces-Allières-et-Risset,1153,225,928,20,908,1,NPA,9,7.825,31.7
2017,ISERE,Varces-Allières-et-Risset,1153,225,928,20,908,1,PCF,15,7.825,31.7
2017,ISERE,Varces-Allières-et-Risset,1153,225,928,20,908,1,REC,84,7.825,31.7
2017,ISERE,Varces-Allières-et-Risset,1153,225,928,20,908,1,RES,25,7.825,31.7
2017,ISERE,Lans-en-Vercors,1156,174,982,11,971,1,EELV,131,7.825,31.7
2017,ISERE,Lans-en-Vercors,1156,174,982,11,971,1,FN,123,7.825,31.7
2017,ISERE,Lans-en-Vercors,1156,174,982,11,971,1,LFI,258,7.825,31.7
2017,ISERE,Lans-en-Vercors,1156,174,982,11,971,1,LO,6,7.825,31.7
2017,ISERE,Lans-en-Vercors,1156,174,982,11,971,1,LR,45,7.825,31.7
2017,ISERE,Lans-en-Vercors,1156,174,982,11,971,1,LREM,279,7.825,31.7
2017,ISERE,Lans-en-Vercors,1156,174,982,11,971,1,NPA,6,7.825,31.7
2017,ISERE,Lans-en-Vercors,1156,174,982,11,971,1,PCF,15,7.825,31.7
2017,ISERE,Lans-en-Vercors,1156,174,982,11,971,1,REC,39,7.825,31.7
2017,ISERE,Lans-en-Vercors,1156,174,982,11,971,1,RES,23,7.825,31.7
2017,ISERE,Grenoble,1156,257,899,14,885,1,EELV,88,7.825,31.7
2017,ISERE,Grenoble,1156,257,899,14,885,1,FN,42,7.825,31.7
2017,ISERE,Grenoble,1156,257,899,14,885,1,LFI,323,7.825,31.7
2017,ISERE,Grenoble,1156,257,899,14,885,1,LO,1,7.825,31.7
2017,ISERE,Grenoble,1156,257,899,14,885,1,LR,39,7.825,31.7
2017,ISERE,Grenoble,1156,257,899,14,885,1,LREM,262,7.825,31.7
2017,ISERE,Grenoble,1156,257,899,14,885,1,NPA,9,7.825,31.7
2017,ISERE,Grenoble,1156,257,899,14,885,1,PCF,17,7.825,31.7
2017,ISERE,Grenoble,1156,257,899,14,885,1,REC,64,7.825,31.7
2017,ISERE,Grenoble,1156,257,899,14,885,1,RES,10,7.825,31.7
2017,ISERE,Bourgoin-Jallieu,1156,313,843,18,825,1,EELV,48,7.825,31.7
2017,ISERE,Bourgoin-Jallieu,1156,313,843,18,825,1,FN,182,7.825,31.7
2017,ISERE,Bourgoin-Jallieu,1156,313,843,18,825,1,LFI,202,7.825,31.7
2017,ISERE,Bourgoin-Jallieu,1156,313,843,18,825,1,LO,4,7.825,31.7
2017,ISERE,Bourgoin-Jallieu,1156,313,843,18,825,1,LR,35,7.825,31.7
2017,ISERE,Bourgoin-Jallieu,1156,313,843,18,825,1,LREM,245,7.825,31.7
2017,ISERE,Bourgoin-Jallieu,1156,313,843,18,825,1,NPA,4,7.825,31.7
2017,ISERE,Bourgoin-Jallieu,1156,313,843,18,825,1,PCF,20,7.825,31.7
2017,ISERE,Bourgoin-Jallieu,1156,313,843,18,825,1,REC,46,7.825,31.7
2017,ISERE,Bourgoin-Jallieu,1156,313,843,18,825,1,RES,13,7.825,31.7
2017,ISERE,Voiron,1158,308,850,25,825,1,EELV,51,7.825,31.7
2017,ISERE,Voiron,1158,308,850,25,825,1,FN,146,7.825,31.7
2017,ISERE,Voiron,1158,308,850,25,825,1,LFI,209,7.825,31.7
2017,ISERE,Voiron,1158,308,850,25,825,1,LO,4,7.825,31.7
2017,ISERE,Voiron,1158,308,850,25,825,1,LR,49,7.825,31.7
2017,ISERE,Voiron,1158,308,850,25,825,1,LREM,253,7.825,31.7
2017,ISERE,Voiron,1158,308,850,25,825,1,NPA,7,7.825,31.7
2017,ISERE,Voiron,1158,308,850,25,825,1,PCF,18,7.825,31.7
2017,ISERE,Voiron,1158,308,850,25,825,1,REC,48,7.825,31.7
2017,ISERE,Voiron,1158,308,850,25,825,1,RES,14,7.825,31.7
2017,ISERE,Crolles,1159,223,936,15,921,1,EELV,73,7.825,31.7
2017,ISERE,Crolles,1159,223,936,15,921,1,FN,141,7.825,31.7
2017,ISERE,Crolles,1159,223,936,15,921,1,LFI,192,7.825,31.7
2017,ISERE,Crolles,1159,223,936,15,921,1,LO,0,7.825,31.7
2017,ISERE,Crolles,1159,223,936,15,921,1,LR,40,7.825,31.7
2017,ISERE,Crolles,1159,223,936,15,921,1,LREM,359,7.825,31.7
2017,ISERE,Crolles,1159,223,936,15,921,1,NPA,10,7.825,31.7
2017,ISERE,Crolles,1159,223,936,15,921,1,PCF,14,7.825,31.7
2017,ISERE,Crolles,1159,223,936,15,921,1,REC,49,7.825,31.7
2017,ISERE,Crolles,1159,223,936,15,921,1,RES,17,7.825,31.7
2017,ISERE,Chapareillan,1160,223,937,15,922,1,EELV,69,7.825,31.7
2017,ISERE,Chapareillan,1160,223,937,15,922,1,FN,235,7.825,31.7
2017,ISERE,Chapareillan,1160,223,937,15,922,1,LFI,189,7.825,31.7
2017,ISERE,Chapareillan,1160,223,937,15,922,1,LO,1,7.825,31.7
2017,ISERE,Chapareillan,1160,223,937,15,922,1,LR,47,7.825,31.7
2017,ISERE,Chapareillan,1160,223,937,15,922,1,LREM,233,7.825,31.7
2017,ISERE,Chapareillan,1160,223,937,15,922,1,NPA,12,7.825,31.7
2017,ISERE,Chapareillan,1160,223,937,15,922,1,PCF,16,7.825,31.7
2017,ISERE,Chapareillan,1160,223,937,15,922,1,REC,66,7.825,31.7
2017,ISERE,Chapareillan,1160,223,937,15,922,1,RES,25,7.825,31.7
2017,ISERE,Saint-Etienne-de-Crossey,1161,208,953,13,940,1,EELV,95,7.825,31.7
2017,ISERE,Saint-Etienne-de-Crossey,1161,208,953,13,940,1,FN,134,7.825,31.7
2017,ISERE,Saint-Etienne-de-Crossey,1161,208,953,13,940,1,LFI,192,7.825,31.7
2017,ISERE,Saint-Etienne-de-Crossey,1161,208,953,13,940,1,LO,2,7.825,31.7
2017,ISERE,Saint-Etienne-de-Crossey,1161,208,953,13,940,1,LR,39,7.825,31.7
2017,ISERE,Saint-Etienne-de-Crossey,1161,208,953,13,940,1,LREM,313,7.825,31.7
2017,ISERE,Saint-Etienne-de-Crossey,1161,208,953,13,940,1,NPA,2,7.825,31.7
2017,ISERE,Saint-Etienne-de-Crossey,1161,208,953,13,940,1,PCF,23,7.825,31.7
2017,ISERE,Saint-Etienne-de-Crossey,1161,208,953,13,940,1,REC,58,7.825,31.7
2017,ISERE,Saint-Etienne-de-Crossey,1161,208,953,13,940,1,RES,25,7.825,31.7
2017,ISERE,Pont-Evêque,1162,401,761,19,742,1,EELV,19,7.825,31.7
2017,ISERE,Pont-Evêque,1162,401,761,19,742,1,FN,165,7.825,31.7
2017,ISERE,Pont-Evêque,1162,401,761,19,742,1,LFI,296,7.825,31.7
2017,ISERE,Pont-Evêque,1162,401,761,19,742,1,LO,6,7.825,31.7
2017,ISERE,Pont-Evêque,1162,401,761,19,742,1,LR,26,7.825,31.7
2017,ISERE,Pont-Evêque,1162,401,761,19,742,1,LREM,144,7.825,31.7
2017,ISERE,Pont-Evêque,1162,401,761,19,742,1,NPA,4,7.825,31.7
2017,ISERE,Pont-Evêque,1162,401,761,19,742,1,PCF,12,7.825,31.7
2017,ISERE,Pont-Evêque,1162,401,761,19,742,1,REC,29,7.825,31.7
2017,ISERE,Pont-Evêque,1162,401,761,19,742,1,RES,15,7.825,31.7
2017,ISERE,Grenoble,1164,227,937,12,925,1,EELV,123,7.825,31.7
2017,ISERE,Grenoble,1164,227,937,12,925,1,FN,83,7.825,31.7
2017,ISERE,Grenoble,1164,227,937,12,925,1,LFI,401,7.825,31.7
2017,ISERE,Grenoble,1164,227,937,12,925,1,LO,3,7.825,31.7
2017,ISERE,Grenoble,1164,227,937,12,925,1,LR,30,7.825,31.7
2017,ISERE,Grenoble,1164,227,937,12,925,1,LREM,198,7.825,31.7
2017,ISERE,Grenoble,1164,227,937,12,925,1,NPA,12,7.825,31.7
2017,ISERE,Grenoble,1164,227,937,12,925,1,PCF,18,7.825,31.7
2017,ISERE,Grenoble,1164,227,937,12,925,1,REC,21,7.825,31.7
2017,ISERE,Grenoble,1164,227,937,12,925,1,RES,7,7.825,31.7
2017,ISERE,Herbeys,1166,166,1000,17,983,1,EELV,127,7.825,31.7
2017,ISERE,Herbeys,1166,166,1000,17,983,1,FN,126,7.825,31.7
2017,ISERE,Herbeys,1166,166,1000,17,983,1,LFI,206,7.825,31.7
2017,ISERE,Herbeys,1166,166,1000,17,983,1,LO,1,7.825,31.7
2017,ISERE,Herbeys,1166,166,1000,17,983,1,LR,51,7.825,31.7
2017,ISERE,Herbeys,1166,166,1000,17,983,1,LREM,341,7.825,31.7
2017,ISERE,Herbeys,1166,166,1000,17,983,1,NPA,6,7.825,31.7
2017,ISERE,Herbeys,1166,166,1000,17,983,1,PCF,9,7.825,31.7
2017,ISERE,Herbeys,1166,166,1000,17,983,1,REC,70,7.825,31.7
2017,ISERE,Herbeys,1166,166,1000,17,983,1,RES,19,7.825,31.7
2017,ISERE,Meylan,1167,177,990,18,972,1,EELV,69,7.825,31.7
2017,ISERE,Meylan,1167,177,990,18,972,1,FN,139,7.825,31.7
2017,ISERE,Meylan,1167,177,990,18,972,1,LFI,182,7.825,31.7
2017,ISERE,Meylan,1167,177,990,18,972,1,LO,1,7.825,31.7
2017,ISERE,Meylan,1167,177,990,18,972,1,LR,48,7.825,31.7
2017,ISERE,Meylan,1167,177,990,18,972,1,LREM,390,7.825,31.7
2017,ISERE,Meylan,1167,177,990,18,972,1,NPA,4,7.825,31.7
2017,ISERE,Meylan,1167,177,990,18,972,1,PCF,18,7.825,31.7
2017,ISERE,Meylan,1167,177,990,18,972,1,REC,67,7.825,31.7
2017,ISERE,Meylan,1167,177,990,18,972,1,RES,8,7.825,31.7
2017,ISERE,Pontcharra,1169,249,920,14,906,1,EELV,63,7.825,31.7
2017,ISERE,Pontcharra,1169,249,920,14,906,1,FN,195,7.825,31.7
2017,ISERE,Pontcharra,1169,249,920,14,906,1,LFI,208,7.825,31.7
2017,ISERE,Pontcharra,1169,249,920,14,906,1,LO,1,7.825,31.7
2017,ISERE,Pontcharra,1169,249,920,14,906,1,LR,34,7.825,31.7
2017,ISERE,Pontcharra,1169,249,920,14,906,1,LREM,266,7.825,31.7
2017,ISERE,Pontcharra,1169,249,920,14,906,1,NPA,4,7.825,31.7
2017,ISERE,Pontcharra,1169,249,920,14,906,1,PCF,19,7.825,31.7
2017,ISERE,Pontcharra,1169,249,920,14,906,1,REC,48,7.825,31.7
2017,ISERE,Pontcharra,1169,249,920,14,906,1,RES,22,7.825,31.7
2017,ISERE,Les Deux-Alpes,1169,350,819,29,790,1,EELV,37,7.825,31.7
2017,ISERE,Les Deux-Alpes,1169,350,819,29,790,1,FN,160,7.825,31.7
2017,ISERE,Les Deux-Alpes,1169,350,819,29,790,1,LFI,125,7.825,31.7
2017,ISERE,Les Deux-Alpes,1169,350,819,29,790,1,LO,2,7.825,31.7
2017,ISERE,Les Deux-Alpes,1169,350,819,29,790,1,LR,38,7.825,31.7
2017,ISERE,Les Deux-Alpes,1169,350,819,29,790,1,LREM,278,7.825,31.7
2017,ISERE,Les Deux-Alpes,1169,350,819,29,790,1,NPA,7,7.825,31.7
2017,ISERE,Les Deux-Alpes,1169,350,819,29,790,1,PCF,6,7.825,31.7
2017,ISERE,Les Deux-Alpes,1169,350,819,29,790,1,REC,80,7.825,31.7
2017,ISERE,Les Deux-Alpes,1169,350,819,29,790,1,RES,24,7.825,31.7
2017,ISERE,Coublevie,1170,213,957,26,931,1,EELV,94,7.825,31.7
2017,ISERE,Coublevie,1170,213,957,26,931,1,FN,130,7.825,31.7
2017,ISERE,Coublevie,1170,213,957,26,931,1,LFI,207,7.825,31.7
2017,ISERE,Coublevie,1170,213,957,26,931,1,LO,2,7.825,31.7
2017,ISERE,Coublevie,1170,213,957,26,931,1,LR,46,7.825,31.7
2017,ISERE,Coublevie,1170,213,957,26,931,1,LREM,332,7.825,31.7
2017,ISERE,Coublevie,1170,213,957,26,931,1,NPA,4,7.825,31.7
2017,ISERE,Coublevie,1170,213,957,26,931,1,PCF,18,7.825,31.7
2017,ISERE,Coublevie,1170,213,957,26,931,1,REC,47,7.825,31.7
2017,ISERE,Coublevie,1170,213,957,26,931,1,RES,15,7.825,31.7
2017,ISERE,Heyrieux,1172,221,951,24,927,1,EELV,42,7.825,31.7
2017,ISERE,Heyrieux,1172,221,951,24,927,1,FN,303,7.825,31.7
2017,ISERE,Heyrieux,1172,221,951,24,927,1,LFI,123,7.825,31.7
2017,ISERE,Heyrieux,1172,221,951,24,927,1,LO,2,7.825,31.7
2017,ISERE,Heyrieux,1172,221,951,24,927,1,LR,40,7.825,31.7
2017,ISERE,Heyrieux,1172,221,951,24,927,1,LREM,264,7.825,31.7
2017,ISERE,Heyrieux,1172,221,951,24,927,1,NPA,5,7.825,31.7
2017,ISERE,Heyrieux,1172,221,951,24,927,1,PCF,13,7.825,31.7
2017,ISERE,Heyrieux,1172,221,951,24,927,1,REC,71,7.825,31.7
2017,ISERE,Heyrieux,1172,221,951,24,927,1,RES,17,7.825,31.7
2017,ISERE,Saint-Siméon-de-Bressieux,1173,251,922,14,908,1,EELV,36,7.825,31.7
2017,ISERE,Saint-Siméon-de-Bressieux,1173,251,922,14,908,1,FN,253,7.825,31.7
2017,ISERE,Saint-Siméon-de-Bressieux,1173,251,922,14,908,1,LFI,190,7.825,31.7
2017,ISERE,Saint-Siméon-de-Bressieux,1173,251,922,14,908,1,LO,7,7.825,31.7
2017,ISERE,Saint-Siméon-de-Bressieux,1173,251,922,14,908,1,LR,59,7.825,31.7
2017,ISERE,Saint-Siméon-de-Bressieux,1173,251,922,14,908,1,LREM,192,7.825,31.7
2017,ISERE,Saint-Siméon-de-Bressieux,1173,251,922,14,908,1,NPA,7,7.825,31.7
2017,ISERE,Saint-Siméon-de-Bressieux,1173,251,922,14,908,1,PCF,22,7.825,31.7
2017,ISERE,Saint-Siméon-de-Bressieux,1173,251,922,14,908,1,REC,71,7.825,31.7
2017,ISERE,Saint-Siméon-de-Bressieux,1173,251,922,14,908,1,RES,31,7.825,31.7
2017,ISERE,Voiron,1173,387,786,26,760,1,EELV,32,7.825,31.7
2017,ISERE,Voiron,1173,387,786,26,760,1,FN,182,7.825,31.7
2017,ISERE,Voiron,1173,387,786,26,760,1,LFI,197,7.825,31.7
2017,ISERE,Voiron,1173,387,786,26,760,1,LO,7,7.825,31.7
2017,ISERE,Voiron,1173,387,786,26,760,1,LR,32,7.825,31.7
2017,ISERE,Voiron,1173,387,786,26,760,1,LREM,201,7.825,31.7
2017,ISERE,Voiron,1173,387,786,26,760,1,NPA,4,7.825,31.7
2017,ISERE,Voiron,1173,387,786,26,760,1,PCF,15,7.825,31.7
2017,ISERE,Voiron,1173,387,786,26,760,1,REC,47,7.825,31.7
2017,ISERE,Voiron,1173,387,786,26,760,1,RES,12,7.825,31.7
2017,ISERE,Grenoble,1175,323,852,15,837,1,EELV,54,7.825,31.7
2017,ISERE,Grenoble,1175,323,852,15,837,1,FN,118,7.825,31.7
2017,ISERE,Grenoble,1175,323,852,15,837,1,LFI,293,7.825,31.7
2017,ISERE,Grenoble,1175,323,852,15,837,1,LO,3,7.825,31.7
2017,ISERE,Grenoble,1175,323,852,15,837,1,LR,30,7.825,31.7
2017,ISERE,Grenoble,1175,323,852,15,837,1,LREM,221,7.825,31.7
2017,ISERE,Grenoble,1175,323,852,15,837,1,NPA,6,7.825,31.7
2017,ISERE,Grenoble,1175,323,852,15,837,1,PCF,19,7.825,31.7
2017,ISERE,Grenoble,1175,323,852,15,837,1,REC,49,7.825,31.7
2017,ISERE,Grenoble,1175,323,852,15,837,1,RES,15,7.825,31.7
2017,ISERE,Grenoble,1177,241,936,14,922,1,EELV,112,7.825,31.7
2017,ISERE,Grenoble,1177,241,936,14,922,1,FN,61,7.825,31.7
2017,ISERE,Grenoble,1177,241,936,14,922,1,LFI,362,7.825,31.7
2017,ISERE,Grenoble,1177,241,936,14,922,1,LO,1,7.825,31.7
2017,ISERE,Grenoble,1177,241,936,14,922,1,LR,32,7.825,31.7
2017,ISERE,Grenoble,1177,241,936,14,922,1,LREM,239,7.825,31.7
2017,ISERE,Grenoble,1177,241,936,14,922,1,NPA,12,7.825,31.7
2017,ISERE,Grenoble,1177,241,936,14,922,1,PCF,22,7.825,31.7
2017,ISERE,Grenoble,1177,241,936,14,922,1,REC,36,7.825,31.7
2017,ISERE,Grenoble,1177,241,936,14,922,1,RES,11,7.825,31.7
2017,ISERE,Saint-Nazaire-les-Eymes,1178,166,1012,13,999,1,EELV,82,7.825,31.7
2017,ISERE,Saint-Nazaire-les-Eymes,1178,166,1012,13,999,1,FN,141,7.825,31.7
2017,ISERE,Saint-Nazaire-les-Eymes,1178,166,1012,13,999,1,LFI,126,7.825,31.7
2017,ISERE,Saint-Nazaire-les-Eymes,1178,166,1012,13,999,1,LO,2,7.825,31.7
2017,ISERE,Saint-Nazaire-les-Eymes,1178,166,1012,13,999,1,LR,66,7.825,31.7
2017,ISERE,Saint-Nazaire-les-Eymes,1178,166,1012,13,999,1,LREM,423,7.825,31.7
2017,ISERE,Saint-Nazaire-les-Eymes,1178,166,1012,13,999,1,NPA,3,7.825,31.7
2017,ISERE,Saint-Nazaire-les-Eymes,1178,166,1012,13,999,1,PCF,22,7.825,31.7
2017,ISERE,Saint-Nazaire-les-Eymes,1178,166,1012,13,999,1,REC,80,7.825,31.7
2017,ISERE,Saint-Nazaire-les-Eymes,1178,166,1012,13,999,1,RES,15,7.825,31.7
2017,ISERE,Gières,1179,245,934,15,919,1,EELV,80,7.825,31.7
2017,ISERE,Gières,1179,245,934,15,919,1,FN,166,7.825,31.7
2017,ISERE,Gières,1179,245,934,15,919,1,LFI,231,7.825,31.7
2017,ISERE,Gières,1179,245,934,15,919,1,LO,4,7.825,31.7
2017,ISERE,Gières,1179,245,934,15,919,1,LR,35,7.825,31.7
2017,ISERE,Gières,1179,245,934,15,919,1,LREM,253,7.825,31.7
2017,ISERE,Gières,1179,245,934,15,919,1,NPA,8,7.825,31.7
2017,ISERE,Gières,1179,245,934,15,919,1,PCF,14,7.825,31.7
2017,ISERE,Gières,1179,245,934,15,919,1,REC,56,7.825,31.7
2017,ISERE,Gières,1179,245,934,15,919,1,RES,24,7.825,31.7
2017,ISERE,Vif,1180,213,967,17,950,1,EELV,37,7.825,31.7
2017,ISERE,Vif,1180,213,967,17,950,1,FN,266,7.825,31.7
2017,ISERE,Vif,1180,213,967,17,950,1,LFI,137,7.825,31.7
2017,ISERE,Vif,1180,213,967,17,950,1,LO,6,7.825,31.7
2017,ISERE,Vif,1180,213,967,17,950,1,LR,53,7.825,31.7
2017,ISERE,Vif,1180,213,967,17,950,1,LREM,291,7.825,31.7
2017,ISERE,Vif,1180,213,967,17,950,1,NPA,8,7.825,31.7
2017,ISERE,Vif,1180,213,967,17,950,1,PCF,25,7.825,31.7
2017,ISERE,Vif,1180,213,967,17,950,1,REC,85,7.825,31.7
2017,ISERE,Vif,1180,213,967,17,950,1,RES,14,7.825,31.7
2017,ISERE,Saint-Laurent-du-Pont,1182,275,907,22,885,1,EELV,37,7.825,31.7
2017,ISERE,Saint-Laurent-du-Pont,1182,275,907,22,885,1,FN,250,7.825,31.7
2017,ISERE,Saint-Laurent-du-Pont,1182,275,907,22,885,1,LFI,178,7.825,31.7
2017,ISERE,Saint-Laurent-du-Pont,1182,275,907,22,885,1,LO,8,7.825,31.7
2017,ISERE,Saint-Laurent-du-Pont,1182,275,907,22,885,1,LR,43,7.825,31.7
2017,ISERE,Saint-Laurent-du-Pont,1182,275,907,22,885,1,LREM,205,7.825,31.7
2017,ISERE,Saint-Laurent-du-Pont,1182,275,907,22,885,1,NPA,9,7.825,31.7
2017,ISERE,Saint-Laurent-du-Pont,1182,275,907,22,885,1,PCF,21,7.825,31.7
2017,ISERE,Saint-Laurent-du-Pont,1182,275,907,22,885,1,REC,58,7.825,31.7
2017,ISERE,Saint-Laurent-du-Pont,1182,275,907,22,885,1,RES,28,7.825,31.7
2017,ISERE,Saint-Geoire-en-Valdaine,1182,277,905,22,883,1,EELV,35,7.825,31.7
2017,ISERE,Saint-Geoire-en-Valdaine,1182,277,905,22,883,1,FN,261,7.825,31.7
2017,ISERE,Saint-Geoire-en-Valdaine,1182,277,905,22,883,1,LFI,181,7.825,31.7
2017,ISERE,Saint-Geoire-en-Valdaine,1182,277,905,22,883,1,LO,4,7.825,31.7
2017,ISERE,Saint-Geoire-en-Valdaine,1182,277,905,22,883,1,LR,34,7.825,31.7
2017,ISERE,Saint-Geoire-en-Valdaine,1182,277,905,22,883,1,LREM,220,7.825,31.7
2017,ISERE,Saint-Geoire-en-Valdaine,1182,277,905,22,883,1,NPA,6,7.825,31.7
2017,ISERE,Saint-Geoire-en-Valdaine,1182,277,905,22,883,1,PCF,18,7.825,31.7
2017,ISERE,Saint-Geoire-en-Valdaine,1182,277,905,22,883,1,REC,53,7.825,31.7
2017,ISERE,Saint-Geoire-en-Valdaine,1182,277,905,22,883,1,RES,33,7.825,31.7
2017,ISERE,Crémieu,1185,230,955,17,938,1,EELV,50,7.825,31.7
2017,ISERE,Crémieu,1185,230,955,17,938,1,FN,224,7.825,31.7
2017,ISERE,Crémieu,1185,230,955,17,938,1,LFI,196,7.825,31.7
2017,ISERE,Crémieu,1185,230,955,17,938,1,LO,8,7.825,31.7
2017,ISERE,Crémieu,1185,230,955,17,938,1,LR,49,7.825,31.7
2017,ISERE,Crémieu,1185,230,955,17,938,1,LREM,268,7.825,31.7
2017,ISERE,Crémieu,1185,230,955,17,938,1,NPA,8,7.825,31.7
2017,ISERE,Crémieu,1185,230,955,17,938,1,PCF,13,7.825,31.7
2017,ISERE,Crémieu,1185,230,955,17,938,1,REC,77,7.825,31.7
2017,ISERE,Crémieu,1185,230,955,17,938,1,RES,17,7.825,31.7
2017,ISERE,Grenoble,1187,284,903,19,884,1,EELV,96,7.825,31.7
2017,ISERE,Grenoble,1187,284,903,19,884,1,FN,89,7.825,31.7
2017,ISERE,Grenoble,1187,284,903,19,884,1,LFI,333,7.825,31.7
2017,ISERE,Grenoble,1187,284,903,19,884,1,LO,3,7.825,31.7
2017,ISERE,Grenoble,1187,284,903,19,884,1,LR,28,7.825,31.7
2017,ISERE,Grenoble,1187,284,903,19,884,1,LREM,222,7.825,31.7
2017,ISERE,Grenoble,1187,284,903,19,884,1,NPA,3,7.825,31.7
2017,ISERE,Grenoble,1187,284,903,19,884,1,PCF,21,7.825,31.7
2017,ISERE,Grenoble,1187,284,903,19,884,1,REC,41,7.825,31.7
2017,ISERE,Grenoble,1187,284,903,19,884,1,RES,14,7.825,31.7
2017,ISERE,Diémoz,1191,240,951,14,937,1,EELV,34,7.825,31.7
2017,ISERE,Diémoz,1191,240,951,14,937,1,FN,345,7.825,31.7
2017,ISERE,Diémoz,1191,240,951,14,937,1,LFI,117,7.825,31.7
2017,ISERE,Diémoz,1191,240,951,14,937,1,LO,0,7.825,31.7
2017,ISERE,Diémoz,1191,240,951,14,937,1,LR,32,7.825,31.7
2017,ISERE,Diémoz,1191,240,951,14,937,1,LREM,210,7.825,31.7
2017,ISERE,Diémoz,1191,240,951,14,937,1,NPA,4,7.825,31.7
2017,ISERE,Diémoz,1191,240,951,14,937,1,PCF,17,7.825,31.7
2017,ISERE,Diémoz,1191,240,951,14,937,1,REC,113,7.825,31.7
2017,ISERE,Diémoz,1191,240,951,14,937,1,RES,28,7.825,31.7
2017,ISERE,Fontaine,1191,281,910,18,892,1,EELV,51,7.825,31.7
2017,ISERE,Fontaine,1191,281,910,18,892,1,FN,189,7.825,31.7
2017,ISERE,Fontaine,1191,281,910,18,892,1,LFI,236,7.825,31.7
2017,ISERE,Fontaine,1191,281,910,18,892,1,LO,5,7.825,31.7
2017,ISERE,Fontaine,1191,281,910,18,892,1,LR,20,7.825,31.7
2017,ISERE,Fontaine,1191,281,910,18,892,1,LREM,214,7.825,31.7
2017,ISERE,Fontaine,1191,281,910,18,892,1,NPA,8,7.825,31.7
2017,ISERE,Fontaine,1191,281,910,18,892,1,PCF,52,7.825,31.7
2017,ISERE,Fontaine,1191,281,910,18,892,1,REC,62,7.825,31.7
2017,ISERE,Fontaine,1191,281,910,18,892,1,RES,16,7.825,31.7
2017,ISERE,Roussillon,1191,392,799,14,785,1,EELV,20,7.825,31.7
2017,ISERE,Roussillon,1191,392,799,14,785,1,FN,212,7.825,31.7
2017,ISERE,Roussillon,1191,392,799,14,785,1,LFI,214,7.825,31.7
2017,ISERE,Roussillon,1191,392,799,14,785,1,LO,6,7.825,31.7
2017,ISERE,Roussillon,1191,392,799,14,785,1,LR,21,7.825,31.7
2017,ISERE,Roussillon,1191,392,799,14,785,1,LREM,178,7.825,31.7
2017,ISERE,Roussillon,1191,392,799,14,785,1,NPA,9,7.825,31.7
2017,ISERE,Roussillon,1191,392,799,14,785,1,PCF,38,7.825,31.7
2017,ISERE,Roussillon,1191,392,799,14,785,1,REC,50,7.825,31.7
2017,ISERE,Roussillon,1191,392,799,14,785,1,RES,16,7.825,31.7
2017,ISERE,La Tour-du-Pin,1193,335,858,20,838,1,EELV,41,7.825,31.7
2017,ISERE,La Tour-du-Pin,1193,335,858,20,838,1,FN,249,7.825,31.7
2017,ISERE,La Tour-du-Pin,1193,335,858,20,838,1,LFI,207,7.825,31.7
2017,ISERE,La Tour-du-Pin,1193,335,858,20,838,1,LO,3,7.825,31.7
2017,ISERE,La Tour-du-Pin,1193,335,858,20,838,1,LR,41,7.825,31.7
2017,ISERE,La Tour-du-Pin,1193,335,858,20,838,1,LREM,180,7.825,31.7
2017,ISERE,La Tour-du-Pin,1193,335,858,20,838,1,NPA,8,7.825,31.7
2017,ISERE,La Tour-du-Pin,1193,335,858,20,838,1,PCF,12,7.825,31.7
2017,ISERE,La Tour-du-Pin,1193,335,858,20,838,1,REC,47,7.825,31.7
2017,ISERE,La Tour-du-Pin,1193,335,858,20,838,1,RES,24,7.825,31.7
2017,ISERE,Corenc,1194,213,981,14,967,1,EELV,112,7.825,31.7
2017,ISERE,Corenc,1194,213,981,14,967,1,FN,92,7.825,31.7
2017,ISERE,Corenc,1194,213,981,14,967,1,LFI,177,7.825,31.7
2017,ISERE,Corenc,1194,213,981,14,967,1,LO,0,7.825,31.7
2017,ISERE,Corenc,1194,213,981,14,967,1,LR,67,7.825,31.7
2017,ISERE,Corenc,1194,213,981,14,967,1,LREM,375,7.825,31.7
2017,ISERE,Corenc,1194,213,981,14,967,1,NPA,5,7.825,31.7
2017,ISERE,Corenc,1194,213,981,14,967,1,PCF,13,7.825,31.7
2017,ISERE,Corenc,1194,213,981,14,967,1,REC,86,7.825,31.7
2017,ISERE,Corenc,1194,213,981,14,967,1,RES,19,7.825,31.7
2017,ISERE,Eybens,1194,285,909,14,895,1,EELV,66,7.825,31.7
2017,ISERE,Eybens,1194,285,909,14,895,1,FN,143,7.825,31.7
2017,ISERE,Eybens,1194,285,909,14,895,1,LFI,309,7.825,31.7
2017,ISERE,Eybens,1194,285,909,14,895,1,LO,4,7.825,31.7
2017,ISERE,Eybens,1194,285,909,14,895,1,LR,30,7.825,31.7
2017,ISERE,Eybens,1194,285,909,14,895,1,LREM,232,7.825,31.7
2017,ISERE,Eybens,1194,285,909,14,895,1,NPA,3,7.825,31.7
2017,ISERE,Eybens,1194,285,909,14,895,1,PCF,27,7.825,31.7
2017,ISERE,Eybens,1194,285,909,14,895,1,REC,30,7.825,31.7
2017,ISERE,Eybens,1194,285,909,14,895,1,RES,14,7.825,31.7
2017,ISERE,Saint-Marcel-Bel-Accueil,1196,190,1006,30,976,1,EELV,64,7.825,31.7
2017,ISERE,Saint-Marcel-Bel-Accueil,1196,190,1006,30,976,1,FN,213,7.825,31.7
2017,ISERE,Saint-Marcel-Bel-Accueil,1196,190,1006,30,976,1,LFI,130,7.825,31.7
2017,ISERE,Saint-Marcel-Bel-Accueil,1196,190,1006,30,976,1,LO,4,7.825,31.7
2017,ISERE,Saint-Marcel-Bel-Accueil,1196,190,1006,30,976,1,LR,65,7.825,31.7
2017,ISERE,Saint-Marcel-Bel-Accueil,1196,190,1006,30,976,1,LREM,319,7.825,31.7
2017,ISERE,Saint-Marcel-Bel-Accueil,1196,190,1006,30,976,1,NPA,4,7.825,31.7
2017,ISERE,Saint-Marcel-Bel-Accueil,1196,190,1006,30,976,1,PCF,27,7.825,31.7
2017,ISERE,Saint-Marcel-Bel-Accueil,1196,190,1006,30,976,1,REC,77,7.825,31.7
2017,ISERE,Saint-Marcel-Bel-Accueil,1196,190,1006,30,976,1,RES,32,7.825,31.7
2017,ISERE,Grenoble,1197,251,946,13,933,1,EELV,73,7.825,31.7
2017,ISERE,Grenoble,1197,251,946,13,933,1,FN,78,7.825,31.7
2017,ISERE,Grenoble,1197,251,946,13,933,1,LFI,268,7.825,31.7
2017,ISERE,Grenoble,1197,251,946,13,933,1,LO,2,7.825,31.7
2017,ISERE,Grenoble,1197,251,946,13,933,1,LR,61,7.825,31.7
2017,ISERE,Grenoble,1197,251,946,13,933,1,LREM,318,7.825,31.7
2017,ISERE,Grenoble,1197,251,946,13,933,1,NPA,5,7.825,31.7
2017,ISERE,Grenoble,1197,251,946,13,933,1,PCF,22,7.825,31.7
2017,ISERE,Grenoble,1197,251,946,13,933,1,REC,62,7.825,31.7
2017,ISERE,Grenoble,1197,251,946,13,933,1,RES,16,7.825,31.7
2017,ISERE,Echirolles,1197,311,886,15,871,1,EELV,51,7.825,31.7
2017,ISERE,Echirolles,1197,311,886,15,871,1,FN,167,7.825,31.7
2017,ISERE,Echirolles,1197,311,886,15,871,1,LFI,265,7.825,31.7
2017,ISERE,Echirolles,1197,311,886,15,871,1,LO,5,7.825,31.7
2017,ISERE,Echirolles,1197,311,886,15,871,1,LR,32,7.825,31.7
2017,ISERE,Echirolles,1197,311,886,15,871,1,LREM,220,7.825,31.7
2017,ISERE,Echirolles,1197,311,886,15,871,1,NPA,4,7.825,31.7
2017,ISERE,Echirolles,1197,311,886,15,871,1,PCF,40,7.825,31.7
2017,ISERE,Echirolles,1197,311,886,15,871,1,REC,50,7.825,31.7
2017,ISERE,Echirolles,1197,311,886,15,871,1,RES,12,7.825,31.7
2017,ISERE,Assieu,1198,211,987,15,972,1,EELV,44,7.825,31.7
2017,ISERE,Assieu,1198,211,987,15,972,1,FN,295,7.825,31.7
2017,ISERE,Assieu,1198,211,987,15,972,1,LFI,137,7.825,31.7
2017,ISERE,Assieu,1198,211,987,15,972,1,LO,5,7.825,31.7
2017,ISERE,Assieu,1198,211,987,15,972,1,LR,47,7.825,31.7
2017,ISERE,Assieu,1198,211,987,15,972,1,LREM,242,7.825,31.7
2017,ISERE,Assieu,1198,211,987,15,972,1,NPA,4,7.825,31.7
2017,ISERE,Assieu,1198,211,987,15,972,1,PCF,27,7.825,31.7
2017,ISERE,Assieu,1198,211,987,15,972,1,REC,87,7.825,31.7
2017,ISERE,Assieu,1198,211,987,15,972,1,RES,35,7.825,31.7
2017,ISERE,Grenoble,1199,295,904,6,898,1,EELV,88,7.825,31.7
2017,ISERE,Grenoble,1199,295,904,6,898,1,FN,61,7.825,31.7
2017,ISERE,Grenoble,1199,295,904,6,898,1,LFI,376,7.825,31.7
2017,ISERE,Grenoble,1199,295,904,6,898,1,LO,10,7.825,31.7
2017,ISERE,Grenoble,1199,295,904,6,898,1,LR,23,7.825,31.7
2017,ISERE,Grenoble,1199,295,904,6,898,1,LREM,206,7.825,31.7
2017,ISERE,Grenoble,1199,295,904,6,898,1,NPA,13,7.825,31.7
2017,ISERE,Grenoble,1199,295,904,6,898,1,PCF,22,7.825,31.7
2017,ISERE,Grenoble,1199,295,904,6,898,1,REC,51,7.825,31.7
2017,ISERE,Grenoble,1199,295,904,6,898,1,RES,12,7.825,31.7
2017,ISERE,Grenoble,1200,341,859,19,840,1,EELV,89,7.825,31.7
2017,ISERE,Grenoble,1200,341,859,19,840,1,FN,105,7.825,31.7
2017,ISERE,Grenoble,1200,341,859,19,840,1,LFI,310,7.825,31.7
2017,ISERE,Grenoble,1200,341,859,19,840,1,LO,5,7.825,31.7
2017,ISERE,Grenoble,1200,341,859,19,840,1,LR,32,7.825,31.7
2017,ISERE,Grenoble,1200,341,859,19,840,1,LREM,202,7.825,31.7
2017,ISERE,Grenoble,1200,341,859,19,840,1,NPA,8,7.825,31.7
2017,ISERE,Grenoble,1200,341,859,19,840,1,PCF,19,7.825,31.7
2017,ISERE,Grenoble,1200,341,859,19,840,1,REC,33,7.825,31.7
2017,ISERE,Grenoble,1200,341,859,19,840,1,RES,9,7.825,31.7
2017,ISERE,Sassenage,1201,206,995,19,976,1,EELV,47,7.825,31.7
2017,ISERE,Sassenage,1201,206,995,19,976,1,FN,245,7.825,31.7
2017,ISERE,Sassenage,1201,206,995,19,976,1,LFI,176,7.825,31.7
2017,ISERE,Sassenage,1201,206,995,19,976,1,LO,3,7.825,31.7
2017,ISERE,Sassenage,1201,206,995,19,976,1,LR,20,7.825,31.7
2017,ISERE,Sassenage,1201,206,995,19,976,1,LREM,304,7.825,31.7
2017,ISERE,Sassenage,1201,206,995,19,976,1,NPA,6,7.825,31.7
2017,ISERE,Sassenage,1201,206,995,19,976,1,PCF,34,7.825,31.7
2017,ISERE,Sassenage,1201,206,995,19,976,1,REC,79,7.825,31.7
2017,ISERE,Sassenage,1201,206,995,19,976,1,RES,20,7.825,31.7
2017,ISERE,Les Abrets en Dauphiné,1204,296,908,11,897,1,EELV,20,7.825,31.7
2017,ISERE,Les Abrets en Dauphiné,1204,296,908,11,897,1,FN,324,7.825,31.7
2017,ISERE,Les Abrets en Dauphiné,1204,296,908,11,897,1,LFI,158,7.825,31.7
2017,ISERE,Les Abrets en Dauphiné,1204,296,908,11,897,1,LO,3,7.825,31.7
2017,ISERE,Les Abrets en Dauphiné,1204,296,908,11,897,1,LR,43,7.825,31.7
2017,ISERE,Les Abrets en Dauphiné,1204,296,908,11,897,1,LREM,188,7.825,31.7
2017,ISERE,Les Abrets en Dauphiné,1204,296,908,11,897,1,NPA,5,7.825,31.7
2017,ISERE,Les Abrets en Dauphiné,1204,296,908,11,897,1,PCF,8,7.825,31.7
2017,ISERE,Les Abrets en Dauphiné,1204,296,908,11,897,1,REC,85,7.825,31.7
2017,ISERE,Les Abrets en Dauphiné,1204,296,908,11,897,1,RES,24,7.825,31.7
2017,ISERE,Pont-de-Chéruy,1204,380,824,10,814,1,EELV,18,7.825,31.7
2017,ISERE,Pont-de-Chéruy,1204,380,824,10,814,1,FN,240,7.825,31.7
2017,ISERE,Pont-de-Chéruy,1204,380,824,10,814,1,LFI,261,7.825,31.7
2017,ISERE,Pont-de-Chéruy,1204,380,824,10,814,1,LO,8,7.825,31.7
2017,ISERE,Pont-de-Chéruy,1204,380,824,10,814,1,LR,18,7.825,31.7
2017,ISERE,Pont-de-Chéruy,1204,380,824,10,814,1,LREM,142,7.825,31.7
2017,ISERE,Pont-de-Chéruy,1204,380,824,10,814,1,NPA,4,7.825,31.7
2017,ISERE,Pont-de-Chéruy,1204,380,824,10,814,1,PCF,15,7.825,31.7
2017,ISERE,Pont-de-Chéruy,1204,380,824,10,814,1,REC,67,7.825,31.7
2017,ISERE,Pont-de-Chéruy,1204,380,824,10,814,1,RES,15,7.825,31.7
2017,ISERE,Seyssinet-Pariset,1205,266,939,34,905,1,EELV,59,7.825,31.7
2017,ISERE,Seyssinet-Pariset,1205,266,939,34,905,1,FN,184,7.825,31.7
2017,ISERE,Seyssinet-Pariset,1205,266,939,34,905,1,LFI,229,7.825,31.7
2017,ISERE,Seyssinet-Pariset,1205,266,939,34,905,1,LO,5,7.825,31.7
2017,ISERE,Seyssinet-Pariset,1205,266,939,34,905,1,LR,38,7.825,31.7
2017,ISERE,Seyssinet-Pariset,1205,266,939,34,905,1,LREM,231,7.825,31.7
2017,ISERE,Seyssinet-Pariset,1205,266,939,34,905,1,NPA,9,7.825,31.7
2017,ISERE,Seyssinet-Pariset,1205,266,939,34,905,1,PCF,19,7.825,31.7
2017,ISERE,Seyssinet-Pariset,1205,266,939,34,905,1,REC,70,7.825,31.7
2017,ISERE,Seyssinet-Pariset,1205,266,939,34,905,1,RES,19,7.825,31.7
2017,ISERE,Vienne,1205,323,882,20,862,1,EELV,48,7.825,31.7
2017,ISERE,Vienne,1205,323,882,20,862,1,FN,186,7.825,31.7
2017,ISERE,Vienne,1205,323,882,20,862,1,LFI,242,7.825,31.7
2017,ISERE,Vienne,1205,323,882,20,862,1,LO,3,7.825,31.7
2017,ISERE,Vienne,1205,323,882,20,862,1,LR,30,7.825,31.7
2017,ISERE,Vienne,1205,323,882,20,862,1,LREM,218,7.825,31.7
2017,ISERE,Vienne,1205,323,882,20,862,1,NPA,4,7.825,31.7
2017,ISERE,Vienne,1205,323,882,20,862,1,PCF,20,7.825,31.7
2017,ISERE,Vienne,1205,323,882,20,862,1,REC,63,7.825,31.7
2017,ISERE,Vienne,1205,323,882,20,862,1,RES,21,7.825,31.7
2017,ISERE,Grenoble,1205,362,843,6,837,1,EELV,48,7.825,31.7
2017,ISERE,Grenoble,1205,362,843,6,837,1,FN,85,7.825,31.7
2017,ISERE,Grenoble,1205,362,843,6,837,1,LFI,355,7.825,31.7
2017,ISERE,Grenoble,1205,362,843,6,837,1,LO,2,7.825,31.7
2017,ISERE,Grenoble,1205,362,843,6,837,1,LR,32,7.825,31.7
2017,ISERE,Grenoble,1205,362,843,6,837,1,LREM,203,7.825,31.7
2017,ISERE,Grenoble,1205,362,843,6,837,1,NPA,8,7.825,31.7
2017,ISERE,Grenoble,1205,362,843,6,837,1,PCF,11,7.825,31.7
2017,ISERE,Grenoble,1205,362,843,6,837,1,REC,48,7.825,31.7
2017,ISERE,Grenoble,1205,362,843,6,837,1,RES,17,7.825,31.7
2017,ISERE,Villette-d'Anthon,1208,214,994,18,976,1,EELV,31,7.825,31.7
2017,ISERE,Villette-d'Anthon,1208,214,994,18,976,1,FN,306,7.825,31.7
2017,ISERE,Villette-d'Anthon,1208,214,994,18,976,1,LFI,135,7.825,31.7
2017,ISERE,Villette-d'Anthon,1208,214,994,18,976,1,LO,0,7.825,31.7
2017,ISERE,Villette-d'Anthon,1208,214,994,18,976,1,LR,37,7.825,31.7
2017,ISERE,Villette-d'Anthon,1208,214,994,18,976,1,LREM,296,7.825,31.7
2017,ISERE,Villette-d'Anthon,1208,214,994,18,976,1,NPA,5,7.825,31.7
2017,ISERE,Villette-d'Anthon,1208,214,994,18,976,1,PCF,18,7.825,31.7
2017,ISERE,Villette-d'Anthon,1208,214,994,18,976,1,REC,87,7.825,31.7
2017,ISERE,Villette-d'Anthon,1208,214,994,18,976,1,RES,23,7.825,31.7
2017,ISERE,Voiron,1208,365,843,16,827,1,EELV,55,7.825,31.7
2017,ISERE,Voiron,1208,365,843,16,827,1,FN,115,7.825,31.7
2017,ISERE,Voiron,1208,365,843,16,827,1,LFI,256,7.825,31.7
2017,ISERE,Voiron,1208,365,843,16,827,1,LO,6,7.825,31.7
2017,ISERE,Voiron,1208,365,843,16,827,1,LR,32,7.825,31.7
2017,ISERE,Voiron,1208,365,843,16,827,1,LREM,242,7.825,31.7
2017,ISERE,Voiron,1208,365,843,16,827,1,NPA,5,7.825,31.7
2017,ISERE,Voiron,1208,365,843,16,827,1,PCF,22,7.825,31.7
2017,ISERE,Voiron,1208,365,843,16,827,1,REC,53,7.825,31.7
2017,ISERE,Voiron,1208,365,843,16,827,1,RES,7,7.825,31.7
2017,ISERE,Grenoble,1209,387,822,17,805,1,EELV,36,7.825,31.7
2017,ISERE,Grenoble,1209,387,822,17,805,1,FN,93,7.825,31.7
2017,ISERE,Grenoble,1209,387,822,17,805,1,LFI,387,7.825,31.7
2017,ISERE,Grenoble,1209,387,822,17,805,1,LO,5,7.825,31.7
2017,ISERE,Grenoble,1209,387,822,17,805,1,LR,16,7.825,31.7
2017,ISERE,Grenoble,1209,387,822,17,805,1,LREM,178,7.825,31.7
2017,ISERE,Grenoble,1209,387,822,17,805,1,NPA,4,7.825,31.7
2017,ISERE,Grenoble,1209,387,822,17,805,1,PCF,13,7.825,31.7
2017,ISERE,Grenoble,1209,387,822,17,805,1,REC,34,7.825,31.7
2017,ISERE,Grenoble,1209,387,822,17,805,1,RES,8,7.825,31.7
2017,ISERE,Grenoble,1210,224,986,16,970,1,EELV,107,7.825,31.7
2017,ISERE,Grenoble,1210,224,986,16,970,1,FN,62,7.825,31.7
2017,ISERE,Grenoble,1210,224,986,16,970,1,LFI,401,7.825,31.7
2017,ISERE,Grenoble,1210,224,986,16,970,1,LO,1,7.825,31.7
2017,ISERE,Grenoble,1210,224,986,16,970,1,LR,31,7.825,31.7
2017,ISERE,Grenoble,1210,224,986,16,970,1,LREM,263,7.825,31.7
2017,ISERE,Grenoble,1210,224,986,16,970,1,NPA,8,7.825,31.7
2017,ISERE,Grenoble,1210,224,986,16,970,1,PCF,8,7.825,31.7
2017,ISERE,Grenoble,1210,224,986,16,970,1,REC,37,7.825,31.7
2017,ISERE,Grenoble,1210,224,986,16,970,1,RES,10,7.825,31.7
2017,ISERE,Revel,1213,194,1019,22,997,1,EELV,113,7.825,31.7
2017,ISERE,Revel,1213,194,1019,22,997,1,FN,146,7.825,31.7
2017,ISERE,Revel,1213,194,1019,22,997,1,LFI,257,7.825,31.7
2017,ISERE,Revel,1213,194,1019,22,997,1,LO,1,7.825,31.7
2017,ISERE,Revel,1213,194,1019,22,997,1,LR,39,7.825,31.7
2017,ISERE,Revel,1213,194,1019,22,997,1,LREM,298,7.825,31.7
2017,ISERE,Revel,1213,194,1019,22,997,1,NPA,7,7.825,31.7
2017,ISERE,Revel,1213,194,1019,22,997,1,PCF,24,7.825,31.7
2017,ISERE,Revel,1213,194,1019,22,997,1,REC,49,7.825,31.7
2017,ISERE,Revel,1213,194,1019,22,997,1,RES,12,7.825,31.7
2017,ISERE,Tullins,1214,281,933,17,916,1,EELV,50,7.825,31.7
2017,ISERE,Tullins,1214,281,933,17,916,1,FN,207,7.825,31.7
2017,ISERE,Tullins,1214,281,933,17,916,1,LFI,204,7.825,31.7
2017,ISERE,Tullins,1214,281,933,17,916,1,LO,1,7.825,31.7
2017,ISERE,Tullins,1214,281,933,17,916,1,LR,35,7.825,31.7
2017,ISERE,Tullins,1214,281,933,17,916,1,LREM,256,7.825,31.7
2017,ISERE,Tullins,1214,281,933,17,916,1,NPA,7,7.825,31.7
2017,ISERE,Tullins,1214,281,933,17,916,1,PCF,18,7.825,31.7
2017,ISERE,Tullins,1214,281,933,17,916,1,REC,60,7.825,31.7
2017,ISERE,Tullins,1214,281,933,17,916,1,RES,28,7.825,31.7
2017,ISERE,Claix,1217,192,1025,19,1006,1,EELV,92,7.825,31.7
2017,ISERE,Claix,1217,192,1025,19,1006,1,FN,161,7.825,31.7
2017,ISERE,Claix,1217,192,1025,19,1006,1,LFI,148,7.825,31.7
2017,ISERE,Claix,1217,192,1025,19,1006,1,LO,1,7.825,31.7
2017,ISERE,Claix,1217,192,1025,19,1006,1,LR,63,7.825,31.7
2017,ISERE,Claix,1217,192,1025,19,1006,1,LREM,391,7.825,31.7
2017,ISERE,Claix,1217,192,1025,19,1006,1,NPA,3,7.825,31.7
2017,ISERE,Claix,1217,192,1025,19,1006,1,PCF,17,7.825,31.7
2017,ISERE,Claix,1217,192,1025,19,1006,1,REC,70,7.825,31.7
2017,ISERE,Claix,1217,192,1025,19,1006,1,RES,23,7.825,31.7
2017,ISERE,Autrans-Méaudre en Vercors,1217,208,1009,25,984,1,EELV,82,7.825,31.7
2017,ISERE,Autrans-Méaudre en Vercors,1217,208,1009,25,984,1,FN,157,7.825,31.7
2017,ISERE,Autrans-Méaudre en Vercors,1217,208,1009,25,984,1,LFI,291,7.825,31.7
2017,ISERE,Autrans-Méaudre en Vercors,1217,208,1009,25,984,1,LO,6,7.825,31.7
2017,ISERE,Autrans-Méaudre en Vercors,1217,208,1009,25,984,1,LR,47,7.825,31.7
2017,ISERE,Autrans-Méaudre en Vercors,1217,208,1009,25,984,1,LREM,248,7.825,31.7
2017,ISERE,Autrans-Méaudre en Vercors,1217,208,1009,25,984,1,NPA,11,7.825,31.7
2017,ISERE,Autrans-Méaudre en Vercors,1217,208,1009,25,984,1,PCF,25,7.825,31.7
2017,ISERE,Autrans-Méaudre en Vercors,1217,208,1009,25,984,1,REC,31,7.825,31.7
2017,ISERE,Autrans-Méaudre en Vercors,1217,208,1009,25,984,1,RES,23,7.825,31.7
2017,ISERE,Vif,1219,252,967,21,946,1,EELV,48,7.825,31.7
2017,ISERE,Vif,1219,252,967,21,946,1,FN,271,7.825,31.7
2017,ISERE,Vif,1219,252,967,21,946,1,LFI,145,7.825,31.7
2017,ISERE,Vif,1219,252,967,21,946,1,LO,8,7.825,31.7
2017,ISERE,Vif,1219,252,967,21,946,1,LR,38,7.825,31.7
2017,ISERE,Vif,1219,252,967,21,946,1,LREM,261,7.825,31.7
2017,ISERE,Vif,1219,252,967,21,946,1,NPA,7,7.825,31.7
2017,ISERE,Vif,1219,252,967,21,946,1,PCF,18,7.825,31.7
2017,ISERE,Vif,1219,252,967,21,946,1,REC,74,7.825,31.7
2017,ISERE,Vif,1219,252,967,21,946,1,RES,30,7.825,31.7
2017,ISERE,Grenoble,1219,313,906,9,897,1,EELV,81,7.825,31.7
2017,ISERE,Grenoble,1219,313,906,9,897,1,FN,92,7.825,31.7
2017,ISERE,Grenoble,1219,313,906,9,897,1,LFI,344,7.825,31.7
2017,ISERE,Grenoble,1219,313,906,9,897,1,LO,2,7.825,31.7
2017,ISERE,Grenoble,1219,313,906,9,897,1,LR,29,7.825,31.7
2017,ISERE,Grenoble,1219,313,906,9,897,1,LREM,224,7.825,31.7
2017,ISERE,Grenoble,1219,313,906,9,897,1,NPA,6,7.825,31.7
2017,ISERE,Grenoble,1219,313,906,9,897,1,PCF,26,7.825,31.7
2017,ISERE,Grenoble,1219,313,906,9,897,1,REC,51,7.825,31.7
2017,ISERE,Grenoble,1219,313,906,9,897,1,RES,17,7.825,31.7
2017,ISERE,Voiron,1219,322,897,17,880,1,EELV,68,7.825,31.7
2017,ISERE,Voiron,1219,322,897,17,880,1,FN,156,7.825,31.7
2017,ISERE,Voiron,1219,322,897,17,880,1,LFI,223,7.825,31.7
2017,ISERE,Voiron,1219,322,897,17,880,1,LO,5,7.825,31.7
2017,ISERE,Voiron,1219,322,897,17,880,1,LR,25,7.825,31.7
2017,ISERE,Voiron,1219,322,897,17,880,1,LREM,253,7.825,31.7
2017,ISERE,Voiron,1219,322,897,17,880,1,NPA,6,7.825,31.7
2017,ISERE,Voiron,1219,322,897,17,880,1,PCF,22,7.825,31.7
2017,ISERE,Voiron,1219,322,897,17,880,1,REC,52,7.825,31.7
2017,ISERE,Voiron,1219,322,897,17,880,1,RES,28,7.825,31.7
2017,ISERE,Fontaine,1220,288,932,14,918,1,EELV,66,7.825,31.7
2017,ISERE,Fontaine,1220,288,932,14,918,1,FN,164,7.825,31.7
2017,ISERE,Fontaine,1220,288,932,14,918,1,LFI,303,7.825,31.7
2017,ISERE,Fontaine,1220,288,932,14,918,1,LO,2,7.825,31.7
2017,ISERE,Fontaine,1220,288,932,14,918,1,LR,16,7.825,31.7
2017,ISERE,Fontaine,1220,288,932,14,918,1,LREM,215,7.825,31.7
2017,ISERE,Fontaine,1220,288,932,14,918,1,NPA,7,7.825,31.7
2017,ISERE,Fontaine,1220,288,932,14,918,1,PCF,36,7.825,31.7
2017,ISERE,Fontaine,1220,288,932,14,918,1,REC,60,7.825,31.7
2017,ISERE,Fontaine,1220,288,932,14,918,1,RES,11,7.825,31.7
2017,ISERE,Le Pont-de-Beauvoisin,1222,278,944,14,930,1,EELV,31,7.825,31.7
2017,ISERE,Le Pont-de-Beauvoisin,1222,278,944,14,930,1,FN,265,7.825,31.7
2017,ISERE,Le Pont-de-Beauvoisin,1222,278,944,14,930,1,LFI,198,7.825,31.7
2017,ISERE,Le Pont-de-Beauvoisin,1222,278,944,14,930,1,LO,1,7.825,31.7
2017,ISERE,Le Pont-de-Beauvoisin,1222,278,944,14,930,1,LR,43,7.825,31.7
2017,ISERE,Le Pont-de-Beauvoisin,1222,278,944,14,930,1,LREM,253,7.825,31.7
2017,ISERE,Le Pont-de-Beauvoisin,1222,278,944,14,930,1,NPA,7,7.825,31.7
2017,ISERE,Le Pont-de-Beauvoisin,1222,278,944,14,930,1,PCF,13,7.825,31.7
2017,ISERE,Le Pont-de-Beauvoisin,1222,278,944,14,930,1,REC,52,7.825,31.7
2017,ISERE,Le Pont-de-Beauvoisin,1222,278,944,14,930,1,RES,24,7.825,31.7
2017,ISERE,Mens,1225,215,1010,21,989,1,EELV,77,7.825,31.7
2017,ISERE,Mens,1225,215,1010,21,989,1,FN,173,7.825,31.7
2017,ISERE,Mens,1225,215,1010,21,989,1,LFI,335,7.825,31.7
2017,ISERE,Mens,1225,215,1010,21,989,1,LO,12,7.825,31.7
2017,ISERE,Mens,1225,215,1010,21,989,1,LR,41,7.825,31.7
2017,ISERE,Mens,1225,215,1010,21,989,1,LREM,197,7.825,31.7
2017,ISERE,Mens,1225,215,1010,21,989,1,NPA,13,7.825,31.7
2017,ISERE,Mens,1225,215,1010,21,989,1,PCF,21,7.825,31.7
2017,ISERE,Mens,1225,215,1010,21,989,1,REC,57,7.825,31.7
2017,ISERE,Mens,1225,215,1010,21,989,1,RES,34,7.825,31.7
2017,ISERE,Crêts en Belledonne,1226,275,951,25,926,1,EELV,58,7.825,31.7
2017,ISERE,Crêts en Belledonne,1226,275,951,25,926,1,FN,233,7.825,31.7
2017,ISERE,Crêts en Belledonne,1226,275,951,25,926,1,LFI,210,7.825,31.7
2017,ISERE,Crêts en Belledonne,1226,275,951,25,926,1,LO,6,7.825,31.7
2017,ISERE,Crêts en Belledonne,1226,275,951,25,926,1,LR,31,7.825,31.7
2017,ISERE,Crêts en Belledonne,1226,275,951,25,926,1,LREM,234,7.825,31.7
2017,ISERE,Crêts en Belledonne,1226,275,951,25,926,1,NPA,3,7.825,31.7
2017,ISERE,Crêts en Belledonne,1226,275,951,25,926,1,PCF,28,7.825,31.7
2017,ISERE,Crêts en Belledonne,1226,275,951,25,926,1,REC,60,7.825,31.7
2017,ISERE,Crêts en Belledonne,1226,275,951,25,926,1,RES,29,7.825,31.7
2017,ISERE,Grenoble,1226,308,918,16,902,1,EELV,107,7.825,31.7
2017,ISERE,Grenoble,1226,308,918,16,902,1,FN,70,7.825,31.7
2017,ISERE,Grenoble,1226,308,918,16,902,1,LFI,302,7.825,31.7
2017,ISERE,Grenoble,1226,308,918,16,902,1,LO,5,7.825,31.7
2017,ISERE,Grenoble,1226,308,918,16,902,1,LR,29,7.825,31.7
2017,ISERE,Grenoble,1226,308,918,16,902,1,LREM,276,7.825,31.7
2017,ISERE,Grenoble,1226,308,918,16,902,1,NPA,3,7.825,31.7
2017,ISERE,Grenoble,1226,308,918,16,902,1,PCF,25,7.825,31.7
2017,ISERE,Grenoble,1226,308,918,16,902,1,REC,43,7.825,31.7
2017,ISERE,Grenoble,1226,308,918,16,902,1,RES,10,7.825,31.7
2017,ISERE,Echirolles,1227,240,987,17,970,1,EELV,46,7.825,31.7
2017,ISERE,Echirolles,1227,240,987,17,970,1,FN,198,7.825,31.7
2017,ISERE,Echirolles,1227,240,987,17,970,1,LFI,300,7.825,31.7
2017,ISERE,Echirolles,1227,240,987,17,970,1,LO,8,7.825,31.7
2017,ISERE,Echirolles,1227,240,987,17,970,1,LR,21,7.825,31.7
2017,ISERE,Echirolles,1227,240,987,17,970,1,LREM,234,7.825,31.7
2017,ISERE,Echirolles,1227,240,987,17,970,1,NPA,3,7.825,31.7
2017,ISERE,Echirolles,1227,240,987,17,970,1,PCF,42,7.825,31.7
2017,ISERE,Echirolles,1227,240,987,17,970,1,REC,71,7.825,31.7
2017,ISERE,Echirolles,1227,240,987,17,970,1,RES,15,7.825,31.7
2017,ISERE,Beaucroissant,1231,243,988,24,964,1,EELV,38,7.825,31.7
2017,ISERE,Beaucroissant,1231,243,988,24,964,1,FN,295,7.825,31.7
2017,ISERE,Beaucroissant,1231,243,988,24,964,1,LFI,161,7.825,31.7
2017,ISERE,Beaucroissant,1231,243,988,24,964,1,LO,1,7.825,31.7
2017,ISERE,Beaucroissant,1231,243,988,24,964,1,LR,38,7.825,31.7
2017,ISERE,Beaucroissant,1231,243,988,24,964,1,LREM,248,7.825,31.7
2017,ISERE,Beaucroissant,1231,243,988,24,964,1,NPA,7,7.825,31.7
2017,ISERE,Beaucroissant,1231,243,988,24,964,1,PCF,29,7.825,31.7
2017,ISERE,Beaucroissant,1231,243,988,24,964,1,REC,84,7.825,31.7
2017,ISERE,Beaucroissant,1231,243,988,24,964,1,RES,30,7.825,31.7
2017,ISERE,Domarin,1232,239,993,20,973,1,EELV,60,7.825,31.7
2017,ISERE,Domarin,1232,239,993,20,973,1,FN,238,7.825,31.7
2017,ISERE,Domarin,1232,239,993,20,973,1,LFI,141,7.825,31.7
2017,ISERE,Domarin,1232,239,993,20,973,1,LO,9,7.825,31.7
2017,ISERE,Domarin,1232,239,993,20,973,1,LR,50,7.825,31.7
2017,ISERE,Domarin,1232,239,993,20,973,1,LREM,299,7.825,31.7
2017,ISERE,Domarin,1232,239,993,20,973,1,NPA,8,7.825,31.7
2017,ISERE,Domarin,1232,239,993,20,973,1,PCF,26,7.825,31.7
2017,ISERE,Domarin,1232,239,993,20,973,1,REC,67,7.825,31.7
2017,ISERE,Domarin,1232,239,993,20,973,1,RES,35,7.825,31.7
2017,ISERE,Villard-de-Lans,1232,272,960,23,937,1,EELV,76,7.825,31.7
2017,ISERE,Villard-de-Lans,1232,272,960,23,937,1,FN,167,7.825,31.7
2017,ISERE,Villard-de-Lans,1232,272,960,23,937,1,LFI,154,7.825,31.7
2017,ISERE,Villard-de-Lans,1232,272,960,23,937,1,LO,4,7.825,31.7
2017,ISERE,Villard-de-Lans,1232,272,960,23,937,1,LR,44,7.825,31.7
2017,ISERE,Villard-de-Lans,1232,272,960,23,937,1,LREM,354,7.825,31.7
2017,ISERE,Villard-de-Lans,1232,272,960,23,937,1,NPA,3,7.825,31.7
2017,ISERE,Villard-de-Lans,1232,272,960,23,937,1,PCF,13,7.825,31.7
2017,ISERE,Villard-de-Lans,1232,272,960,23,937,1,REC,67,7.825,31.7
2017,ISERE,Villard-de-Lans,1232,272,960,23,937,1,RES,17,7.825,31.7
2017,ISERE,Tullins,1233,361,872,20,852,1,EELV,43,7.825,31.7
2017,ISERE,Tullins,1233,361,872,20,852,1,FN,221,7.825,31.7
2017,ISERE,Tullins,1233,361,872,20,852,1,LFI,211,7.825,31.7
2017,ISERE,Tullins,1233,361,872,20,852,1,LO,5,7.825,31.7
2017,ISERE,Tullins,1233,361,872,20,852,1,LR,25,7.825,31.7
2017,ISERE,Tullins,1233,361,872,20,852,1,LREM,207,7.825,31.7
2017,ISERE,Tullins,1233,361,872,20,852,1,NPA,7,7.825,31.7
2017,ISERE,Tullins,1233,361,872,20,852,1,PCF,20,7.825,31.7
2017,ISERE,Tullins,1233,361,872,20,852,1,REC,55,7.825,31.7
2017,ISERE,Tullins,1233,361,872,20,852,1,RES,17,7.825,31.7
2017,ISERE,La Côte-Saint-André,1234,393,841,26,815,1,EELV,20,7.825,31.7
2017,ISERE,La Côte-Saint-André,1234,393,841,26,815,1,FN,235,7.825,31.7
2017,ISERE,La Côte-Saint-André,1234,393,841,26,815,1,LFI,131,7.825,31.7
2017,ISERE,La Côte-Saint-André,1234,393,841,26,815,1,LO,5,7.825,31.7
2017,ISERE,La Côte-Saint-André,1234,393,841,26,815,1,LR,52,7.825,31.7
2017,ISERE,La Côte-Saint-André,1234,393,841,26,815,1,LREM,224,7.825,31.7
2017,ISERE,La Côte-Saint-André,1234,393,841,26,815,1,NPA,3,7.825,31.7
2017,ISERE,La Côte-Saint-André,1234,393,841,26,815,1,PCF,21,7.825,31.7
2017,ISERE,La Côte-Saint-André,1234,393,841,26,815,1,REC,67,7.825,31.7
2017,ISERE,La Côte-Saint-André,1234,393,841,26,815,1,RES,28,7.825,31.7
2017,ISERE,Grenoble,1237,291,946,10,936,1,EELV,81,7.825,31.7
2017,ISERE,Grenoble,1237,291,946,10,936,1,FN,91,7.825,31.7
2017,ISERE,Grenoble,1237,291,946,10,936,1,LFI,277,7.825,31.7
2017,ISERE,Grenoble,1237,291,946,10,936,1,LO,3,7.825,31.7
2017,ISERE,Grenoble,1237,291,946,10,936,1,LR,52,7.825,31.7
2017,ISERE,Grenoble,1237,291,946,10,936,1,LREM,293,7.825,31.7
2017,ISERE,Grenoble,1237,291,946,10,936,1,NPA,6,7.825,31.7
2017,ISERE,Grenoble,1237,291,946,10,936,1,PCF,14,7.825,31.7
2017,ISERE,Grenoble,1237,291,946,10,936,1,REC,68,7.825,31.7
2017,ISERE,Grenoble,1237,291,946,10,936,1,RES,8,7.825,31.7
2017,ISERE,Saint-Nazaire-les-Eymes,1241,186,1055,13,1042,1,EELV,110,7.825,31.7
2017,ISERE,Saint-Nazaire-les-Eymes,1241,186,1055,13,1042,1,FN,125,7.825,31.7
2017,ISERE,Saint-Nazaire-les-Eymes,1241,186,1055,13,1042,1,LFI,152,7.825,31.7
2017,ISERE,Saint-Nazaire-les-Eymes,1241,186,1055,13,1042,1,LO,3,7.825,31.7
2017,ISERE,Saint-Nazaire-les-Eymes,1241,186,1055,13,1042,1,LR,67,7.825,31.7
2017,ISERE,Saint-Nazaire-les-Eymes,1241,186,1055,13,1042,1,LREM,417,7.825,31.7
2017,ISERE,Saint-Nazaire-les-Eymes,1241,186,1055,13,1042,1,NPA,7,7.825,31.7
2017,ISERE,Saint-Nazaire-les-Eymes,1241,186,1055,13,1042,1,PCF,13,7.825,31.7
2017,ISERE,Saint-Nazaire-les-Eymes,1241,186,1055,13,1042,1,REC,89,7.825,31.7
2017,ISERE,Saint-Nazaire-les-Eymes,1241,186,1055,13,1042,1,RES,23,7.825,31.7
2017,ISERE,Voiron,1243,306,937,25,912,1,EELV,65,7.825,31.7
2017,ISERE,Voiron,1243,306,937,25,912,1,FN,151,7.825,31.7
2017,ISERE,Voiron,1243,306,937,25,912,1,LFI,286,7.825,31.7
2017,ISERE,Voiron,1243,306,937,25,912,1,LO,3,7.825,31.7
2017,ISERE,Voiron,1243,306,937,25,912,1,LR,39,7.825,31.7
2017,ISERE,Voiron,1243,306,937,25,912,1,LREM,227,7.825,31.7
2017,ISERE,Voiron,1243,306,937,25,912,1,NPA,6,7.825,31.7
2017,ISERE,Voiron,1243,306,937,25,912,1,PCF,15,7.825,31.7
2017,ISERE,Voiron,1243,306,937,25,912,1,REC,88,7.825,31.7
2017,ISERE,Voiron,1243,306,937,25,912,1,RES,10,7.825,31.7
2017,ISERE,Roussillon,1244,308,936,18,918,1,EELV,38,7.825,31.7
2017,ISERE,Roussillon,1244,308,936,18,918,1,FN,224,7.825,31.7
2017,ISERE,Roussillon,1244,308,936,18,918,1,LFI,185,7.825,31.7
2017,ISERE,Roussillon,1244,308,936,18,918,1,LO,3,7.825,31.7
2017,ISERE,Roussillon,1244,308,936,18,918,1,LR,40,7.825,31.7
2017,ISERE,Roussillon,1244,308,936,18,918,1,LREM,231,7.825,31.7
2017,ISERE,Roussillon,1244,308,936,18,918,1,NPA,5,7.825,31.7
2017,ISERE,Roussillon,1244,308,936,18,918,1,PCF,32,7.825,31.7
2017,ISERE,Roussillon,1244,308,936,18,918,1,REC,95,7.825,31.7
2017,ISERE,Roussillon,1244,308,936,18,918,1,RES,28,7.825,31.7
2017,ISERE,Grenoble,1245,296,949,9,940,1,EELV,112,7.825,31.7
2017,ISERE,Grenoble,1245,296,949,9,940,1,FN,71,7.825,31.7
2017,ISERE,Grenoble,1245,296,949,9,940,1,LFI,484,7.825,31.7
2017,ISERE,Grenoble,1245,296,949,9,940,1,LO,4,7.825,31.7
2017,ISERE,Grenoble,1245,296,949,9,940,1,LR,18,7.825,31.7
2017,ISERE,Grenoble,1245,296,949,9,940,1,LREM,147,7.825,31.7
2017,ISERE,Grenoble,1245,296,949,9,940,1,NPA,16,7.825,31.7
2017,ISERE,Grenoble,1245,296,949,9,940,1,PCF,23,7.825,31.7
2017,ISERE,Grenoble,1245,296,949,9,940,1,REC,31,7.825,31.7
2017,ISERE,Grenoble,1245,296,949,9,940,1,RES,10,7.825,31.7
2017,ISERE,Voiron,1246,292,954,22,932,1,EELV,59,7.825,31.7
2017,ISERE,Voiron,1246,292,954,22,932,1,FN,157,7.825,31.7
2017,ISERE,Voiron,1246,292,954,22,932,1,LFI,241,7.825,31.7
2017,ISERE,Voiron,1246,292,954,22,932,1,LO,4,7.825,31.7
2017,ISERE,Voiron,1246,292,954,22,932,1,LR,60,7.825,31.7
2017,ISERE,Voiron,1246,292,954,22,932,1,LREM,273,7.825,31.7
2017,ISERE,Voiron,1246,292,954,22,932,1,NPA,4,7.825,31.7
2017,ISERE,Voiron,1246,292,954,22,932,1,PCF,14,7.825,31.7
2017,ISERE,Voiron,1246,292,954,22,932,1,REC,71,7.825,31.7
2017,ISERE,Voiron,1246,292,954,22,932,1,RES,17,7.825,31.7
2017,ISERE,Grenoble,1247,345,902,24,878,1,EELV,57,7.825,31.7
2017,ISERE,Grenoble,1247,345,902,24,878,1,FN,117,7.825,31.7
2017,ISERE,Grenoble,1247,345,902,24,878,1,LFI,329,7.825,31.7
2017,ISERE,Grenoble,1247,345,902,24,878,1,LO,5,7.825,31.7
2017,ISERE,Grenoble,1247,345,902,24,878,1,LR,31,7.825,31.7
2017,ISERE,Grenoble,1247,345,902,24,878,1,LREM,187,7.825,31.7
2017,ISERE,Grenoble,1247,345,902,24,878,1,NPA,17,7.825,31.7
2017,ISERE,Grenoble,1247,345,902,24,878,1,PCF,29,7.825,31.7
2017,ISERE,Grenoble,1247,345,902,24,878,1,REC,57,7.825,31.7
2017,ISERE,Grenoble,1247,345,902,24,878,1,RES,11,7.825,31.7
2017,ISERE,Crolles,1248,215,1033,27,1006,1,EELV,107,7.825,31.7
2017,ISERE,Crolles,1248,215,1033,27,1006,1,FN,107,7.825,31.7
2017,ISERE,Crolles,1248,215,1033,27,1006,1,LFI,208,7.825,31.7
2017,ISERE,Crolles,1248,215,1033,27,1006,1,LO,1,7.825,31.7
2017,ISERE,Crolles,1248,215,1033,27,1006,1,LR,50,7.825,31.7
2017,ISERE,Crolles,1248,215,1033,27,1006,1,LREM,380,7.825,31.7
2017,ISERE,Crolles,1248,215,1033,27,1006,1,NPA,7,7.825,31.7
2017,ISERE,Crolles,1248,215,1033,27,1006,1,PCF,32,7.825,31.7
2017,ISERE,Crolles,1248,215,1033,27,1006,1,REC,54,7.825,31.7
2017,ISERE,Crolles,1248,215,1033,27,1006,1,RES,25,7.825,31.7
2017,ISERE,Clonas-sur-Varèze,1256,246,1010,21,989,1,EELV,57,7.825,31.7
2017,ISERE,Clonas-sur-Varèze,1256,246,1010,21,989,1,FN,268,7.825,31.7
2017,ISERE,Clonas-sur-Varèze,1256,246,1010,21,989,1,LFI,175,7.825,31.7
2017,ISERE,Clonas-sur-Varèze,1256,246,1010,21,989,1,LO,9,7.825,31.7
2017,ISERE,Clonas-sur-Varèze,1256,246,1010,21,989,1,LR,36,7.825,31.7
2017,ISERE,Clonas-sur-Varèze,1256,246,1010,21,989,1,LREM,240,7.825,31.7
2017,ISERE,Clonas-sur-Varèze,1256,246,1010,21,989,1,NPA,6,7.825,31.7
2017,ISERE,Clonas-sur-Varèze,1256,246,1010,21,989,1,PCF,33,7.825,31.7
2017,ISERE,Clonas-sur-Varèze,1256,246,1010,21,989,1,REC,84,7.825,31.7
2017,ISERE,Clonas-sur-Varèze,1256,246,1010,21,989,1,RES,27,7.825,31.7
2017,ISERE,Renage,1256,289,967,23,944,1,EELV,52,7.825,31.7
2017,ISERE,Renage,1256,289,967,23,944,1,FN,279,7.825,31.7
2017,ISERE,Renage,1256,289,967,23,944,1,LFI,213,7.825,31.7
2017,ISERE,Renage,1256,289,967,23,944,1,LO,4,7.825,31.7
2017,ISERE,Renage,1256,289,967,23,944,1,LR,30,7.825,31.7
2017,ISERE,Renage,1256,289,967,23,944,1,LREM,211,7.825,31.7
2017,ISERE,Renage,1256,289,967,23,944,1,NPA,4,7.825,31.7
2017,ISERE,Renage,1256,289,967,23,944,1,PCF,19,7.825,31.7
2017,ISERE,Renage,1256,289,967,23,944,1,REC,50,7.825,31.7
2017,ISERE,Renage,1256,289,967,23,944,1,RES,35,7.825,31.7
2017,ISERE,Grenoble,1261,284,977,13,964,1,EELV,99,7.825,31.7
2017,ISERE,Grenoble,1261,284,977,13,964,1,FN,67,7.825,31.7
2017,ISERE,Grenoble,1261,284,977,13,964,1,LFI,506,7.825,31.7
2017,ISERE,Grenoble,1261,284,977,13,964,1,LO,6,7.825,31.7
2017,ISERE,Grenoble,1261,284,977,13,964,1,LR,16,7.825,31.7
2017,ISERE,Grenoble,1261,284,977,13,964,1,LREM,145,7.825,31.7
2017,ISERE,Grenoble,1261,284,977,13,964,1,NPA,4,7.825,31.7
2017,ISERE,Grenoble,1261,284,977,13,964,1,PCF,23,7.825,31.7
2017,ISERE,Grenoble,1261,284,977,13,964,1,REC,52,7.825,31.7
2017,ISERE,Grenoble,1261,284,977,13,964,1,RES,6,7.825,31.7
2017,ISERE,Vif,1261,288,973,16,957,1,EELV,55,7.825,31.7
2017,ISERE,Vif,1261,288,973,16,957,1,FN,254,7.825,31.7
2017,ISERE,Vif,1261,288,973,16,957,1,LFI,191,7.825,31.7
2017,ISERE,Vif,1261,288,973,16,957,1,LO,13,7.825,31.7
2017,ISERE,Vif,1261,288,973,16,957,1,LR,29,7.825,31.7
2017,ISERE,Vif,1261,288,973,16,957,1,LREM,256,7.825,31.7
2017,ISERE,Vif,1261,288,973,16,957,1,NPA,13,7.825,31.7
2017,ISERE,Vif,1261,288,973,16,957,1,PCF,25,7.825,31.7
2017,ISERE,Vif,1261,288,973,16,957,1,REC,54,7.825,31.7
2017,ISERE,Vif,1261,288,973,16,957,1,RES,23,7.825,31.7
2017,ISERE,Voiron,1262,287,975,26,949,1,EELV,72,7.825,31.7
2017,ISERE,Voiron,1262,287,975,26,949,1,FN,158,7.825,31.7
2017,ISERE,Voiron,1262,287,975,26,949,1,LFI,209,7.825,31.7
2017,ISERE,Voiron,1262,287,975,26,949,1,LO,8,7.825,31.7
2017,ISERE,Voiron,1262,287,975,26,949,1,LR,72,7.825,31.7
2017,ISERE,Voiron,1262,287,975,26,949,1,LREM,292,7.825,31.7
2017,ISERE,Voiron,1262,287,975,26,949,1,NPA,5,7.825,31.7
2017,ISERE,Voiron,1262,287,975,26,949,1,PCF,21,7.825,31.7
2017,ISERE,Voiron,1262,287,975,26,949,1,REC,62,7.825,31.7
2017,ISERE,Voiron,1262,287,975,26,949,1,RES,16,7.825,31.7
2017,ISERE,Saint-Etienne-de-Saint-Geoirs,1262,301,961,14,947,1,EELV,33,7.825,31.7
2017,ISERE,Saint-Etienne-de-Saint-Geoirs,1262,301,961,14,947,1,FN,285,7.825,31.7
2017,ISERE,Saint-Etienne-de-Saint-Geoirs,1262,301,961,14,947,1,LFI,148,7.825,31.7
2017,ISERE,Saint-Etienne-de-Saint-Geoirs,1262,301,961,14,947,1,LO,5,7.825,31.7
2017,ISERE,Saint-Etienne-de-Saint-Geoirs,1262,301,961,14,947,1,LR,60,7.825,31.7
2017,ISERE,Saint-Etienne-de-Saint-Geoirs,1262,301,961,14,947,1,LREM,251,7.825,31.7
2017,ISERE,Saint-Etienne-de-Saint-Geoirs,1262,301,961,14,947,1,NPA,5,7.825,31.7
2017,ISERE,Saint-Etienne-de-Saint-Geoirs,1262,301,961,14,947,1,PCF,18,7.825,31.7
2017,ISERE,Saint-Etienne-de-Saint-Geoirs,1262,301,961,14,947,1,REC,74,7.825,31.7
2017,ISERE,Saint-Etienne-de-Saint-Geoirs,1262,301,961,14,947,1,RES,34,7.825,31.7
2017,ISERE,Le Bourg-d'Oisans,1262,317,945,22,923,1,EELV,28,7.825,31.7
2017,ISERE,Le Bourg-d'Oisans,1262,317,945,22,923,1,FN,274,7.825,31.7
2017,ISERE,Le Bourg-d'Oisans,1262,317,945,22,923,1,LFI,184,7.825,31.7
2017,ISERE,Le Bourg-d'Oisans,1262,317,945,22,923,1,LO,3,7.825,31.7
2017,ISERE,Le Bourg-d'Oisans,1262,317,945,22,923,1,LR,43,7.825,31.7
2017,ISERE,Le Bourg-d'Oisans,1262,317,945,22,923,1,LREM,254,7.825,31.7
2017,ISERE,Le Bourg-d'Oisans,1262,317,945,22,923,1,NPA,5,7.825,31.7
2017,ISERE,Le Bourg-d'Oisans,1262,317,945,22,923,1,PCF,13,7.825,31.7
2017,ISERE,Le Bourg-d'Oisans,1262,317,945,22,923,1,REC,59,7.825,31.7
2017,ISERE,Le Bourg-d'Oisans,1262,317,945,22,923,1,RES,23,7.825,31.7
2017,ISERE,Gières,1264,232,1032,33,999,1,EELV,85,7.825,31.7
2017,ISERE,Gières,1264,232,1032,33,999,1,FN,199,7.825,31.7
2017,ISERE,Gières,1264,232,1032,33,999,1,LFI,193,7.825,31.7
2017,ISERE,Gières,1264,232,1032,33,999,1,LO,5,7.825,31.7
2017,ISERE,Gières,1264,232,1032,33,999,1,LR,43,7.825,31.7
2017,ISERE,Gières,1264,232,1032,33,999,1,LREM,309,7.825,31.7
2017,ISERE,Gières,1264,232,1032,33,999,1,NPA,11,7.825,31.7
2017,ISERE,Gières,1264,232,1032,33,999,1,PCF,26,7.825,31.7
2017,ISERE,Gières,1264,232,1032,33,999,1,REC,55,7.825,31.7
2017,ISERE,Gières,1264,232,1032,33,999,1,RES,28,7.825,31.7
2017,ISERE,Le Touvet,1266,251,1015,21,994,1,EELV,73,7.825,31.7
2017,ISERE,Le Touvet,1266,251,1015,21,994,1,FN,217,7.825,31.7
2017,ISERE,Le Touvet,1266,251,1015,21,994,1,LFI,210,7.825,31.7
2017,ISERE,Le Touvet,1266,251,1015,21,994,1,LO,7,7.825,31.7
2017,ISERE,Le Touvet,1266,251,1015,21,994,1,LR,42,7.825,31.7
2017,ISERE,Le Touvet,1266,251,1015,21,994,1,LREM,279,7.825,31.7
2017,ISERE,Le Touvet,1266,251,1015,21,994,1,NPA,5,7.825,31.7
2017,ISERE,Le Touvet,1266,251,1015,21,994,1,PCF,32,7.825,31.7
2017,ISERE,Le Touvet,1266,251,1015,21,994,1,REC,69,7.825,31.7
2017,ISERE,Le Touvet,1266,251,1015,21,994,1,RES,23,7.825,31.7
2017,ISERE,Grenoble,1266,253,1013,16,997,1,EELV,111,7.825,31.7
2017,ISERE,Grenoble,1266,253,1013,16,997,1,FN,45,7.825,31.7
2017,ISERE,Grenoble,1266,253,1013,16,997,1,LFI,416,7.825,31.7
2017,ISERE,Grenoble,1266,253,1013,16,997,1,LO,3,7.825,31.7
2017,ISERE,Grenoble,1266,253,1013,16,997,1,LR,39,7.825,31.7
2017,ISERE,Grenoble,1266,253,1013,16,997,1,LREM,261,7.825,31.7
2017,ISERE,Grenoble,1266,253,1013,16,997,1,NPA,7,7.825,31.7
2017,ISERE,Grenoble,1266,253,1013,16,997,1,PCF,12,7.825,31.7
2017,ISERE,Grenoble,1266,253,1013,16,997,1,REC,50,7.825,31.7
2017,ISERE,Grenoble,1266,253,1013,16,997,1,RES,16,7.825,31.7
2017,ISERE,Villette-d'Anthon,1269,176,1093,17,1076,1,EELV,31,7.825,31.7
2017,ISERE,Villette-d'Anthon,1269,176,1093,17,1076,1,FN,353,7.825,31.7
2017,ISERE,Villette-d'Anthon,1269,176,1093,17,1076,1,LFI,90,7.825,31.7
2017,ISERE,Villette-d'Anthon,1269,176,1093,17,1076,1,LO,4,7.825,31.7
2017,ISERE,Villette-d'Anthon,1269,176,1093,17,1076,1,LR,62,7.825,31.7
2017,ISERE,Villette-d'Anthon,1269,176,1093,17,1076,1,LREM,342,7.825,31.7
2017,ISERE,Villette-d'Anthon,1269,176,1093,17,1076,1,NPA,1,7.825,31.7
2017,ISERE,Villette-d'Anthon,1269,176,1093,17,1076,1,PCF,14,7.825,31.7
2017,ISERE,Villette-d'Anthon,1269,176,1093,17,1076,1,REC,134,7.825,31.7
2017,ISERE,Villette-d'Anthon,1269,176,1093,17,1076,1,RES,9,7.825,31.7
2017,ISERE,Chamagnieu,1269,201,1068,22,1046,1,EELV,51,7.825,31.7
2017,ISERE,Chamagnieu,1269,201,1068,22,1046,1,FN,282,7.825,31.7
2017,ISERE,Chamagnieu,1269,201,1068,22,1046,1,LFI,126,7.825,31.7
2017,ISERE,Chamagnieu,1269,201,1068,22,1046,1,LO,1,7.825,31.7
2017,ISERE,Chamagnieu,1269,201,1068,22,1046,1,LR,53,7.825,31.7
2017,ISERE,Chamagnieu,1269,201,1068,22,1046,1,LREM,336,7.825,31.7
2017,ISERE,Chamagnieu,1269,201,1068,22,1046,1,NPA,8,7.825,31.7
2017,ISERE,Chamagnieu,1269,201,1068,22,1046,1,PCF,22,7.825,31.7
2017,ISERE,Chamagnieu,1269,201,1068,22,1046,1,REC,100,7.825,31.7
2017,ISERE,Chamagnieu,1269,201,1068,22,1046,1,RES,20,7.825,31.7
2017,ISERE,Pont-de-Chéruy,1273,481,792,17,775,1,EELV,24,7.825,31.7
2017,ISERE,Pont-de-Chéruy,1273,481,792,17,775,1,FN,241,7.825,31.7
2017,ISERE,Pont-de-Chéruy,1273,481,792,17,775,1,LFI,199,7.825,31.7
2017,ISERE,Pont-de-Chéruy,1273,481,792,17,775,1,LO,5,7.825,31.7
2017,ISERE,Pont-de-Chéruy,1273,481,792,17,775,1,LR,17,7.825,31.7
2017,ISERE,Pont-de-Chéruy,1273,481,792,17,775,1,LREM,147,7.825,31.7
2017,ISERE,Pont-de-Chéruy,1273,481,792,17,775,1,NPA,9,7.825,31.7
2017,ISERE,Pont-de-Chéruy,1273,481,792,17,775,1,PCF,11,7.825,31.7
2017,ISERE,Pont-de-Chéruy,1273,481,792,17,775,1,REC,75,7.825,31.7
2017,ISERE,Pont-de-Chéruy,1273,481,792,17,775,1,RES,14,7.825,31.7
2017,ISERE,Chasse-sur-Rhône,1274,430,844,13,831,1,EELV,18,7.825,31.7
2017,ISERE,Chasse-sur-Rhône,1274,430,844,13,831,1,FN,221,7.825,31.7
2017,ISERE,Chasse-sur-Rhône,1274,430,844,13,831,1,LFI,291,7.825,31.7
2017,ISERE,Chasse-sur-Rhône,1274,430,844,13,831,1,LO,3,7.825,31.7
2017,ISERE,Chasse-sur-Rhône,1274,430,844,13,831,1,LR,24,7.825,31.7
2017,ISERE,Chasse-sur-Rhône,1274,430,844,13,831,1,LREM,153,7.825,31.7
2017,ISERE,Chasse-sur-Rhône,1274,430,844,13,831,1,NPA,8,7.825,31.7
2017,ISERE,Chasse-sur-Rhône,1274,430,844,13,831,1,PCF,9,7.825,31.7
2017,ISERE,Chasse-sur-Rhône,1274,430,844,13,831,1,REC,61,7.825,31.7
2017,ISERE,Chasse-sur-Rhône,1274,430,844,13,831,1,RES,13,7.825,31.7
2017,ISERE,Saint-Vincent-de-Mercuze,1275,199,1076,20,1056,1,EELV,105,7.825,31.7
2017,ISERE,Saint-Vincent-de-Mercuze,1275,199,1076,20,1056,1,FN,161,7.825,31.7
2017,ISERE,Saint-Vincent-de-Mercuze,1275,199,1076,20,1056,1,LFI,189,7.825,31.7
2017,ISERE,Saint-Vincent-de-Mercuze,1275,199,1076,20,1056,1,LO,4,7.825,31.7
2017,ISERE,Saint-Vincent-de-Mercuze,1275,199,1076,20,1056,1,LR,73,7.825,31.7
2017,ISERE,Saint-Vincent-de-Mercuze,1275,199,1076,20,1056,1,LREM,349,7.825,31.7
2017,ISERE,Saint-Vincent-de-Mercuze,1275,199,1076,20,1056,1,NPA,10,7.825,31.7
2017,ISERE,Saint-Vincent-de-Mercuze,1275,199,1076,20,1056,1,PCF,11,7.825,31.7
2017,ISERE,Saint-Vincent-de-Mercuze,1275,199,1076,20,1056,1,REC,79,7.825,31.7
2017,ISERE,Saint-Vincent-de-Mercuze,1275,199,1076,20,1056,1,RES,27,7.825,31.7
2017,ISERE,Le Bourg-d'Oisans,1276,324,952,26,926,1,EELV,47,7.825,31.7
2017,ISERE,Le Bourg-d'Oisans,1276,324,952,26,926,1,FN,214,7.825,31.7
2017,ISERE,Le Bourg-d'Oisans,1276,324,952,26,926,1,LFI,212,7.825,31.7
2017,ISERE,Le Bourg-d'Oisans,1276,324,952,26,926,1,LO,10,7.825,31.7
2017,ISERE,Le Bourg-d'Oisans,1276,324,952,26,926,1,LR,35,7.825,31.7
2017,ISERE,Le Bourg-d'Oisans,1276,324,952,26,926,1,LREM,259,7.825,31.7
2017,ISERE,Le Bourg-d'Oisans,1276,324,952,26,926,1,NPA,10,7.825,31.7
2017,ISERE,Le Bourg-d'Oisans,1276,324,952,26,926,1,PCF,26,7.825,31.7
2017,ISERE,Le Bourg-d'Oisans,1276,324,952,26,926,1,REC,60,7.825,31.7
2017,ISERE,Le Bourg-d'Oisans,1276,324,952,26,926,1,RES,28,7.825,31.7
2017,ISERE,Le Touvet,1278,251,1027,28,999,1,EELV,117,7.825,31.7
2017,ISERE,Le Touvet,1278,251,1027,28,999,1,FN,182,7.825,31.7
2017,ISERE,Le Touvet,1278,251,1027,28,999,1,LFI,196,7.825,31.7
2017,ISERE,Le Touvet,1278,251,1027,28,999,1,LO,9,7.825,31.7
2017,ISERE,Le Touvet,1278,251,1027,28,999,1,LR,50,7.825,31.7
2017,ISERE,Le Touvet,1278,251,1027,28,999,1,LREM,279,7.825,31.7
2017,ISERE,Le Touvet,1278,251,1027,28,999,1,NPA,9,7.825,31.7
2017,ISERE,Le Touvet,1278,251,1027,28,999,1,PCF,16,7.825,31.7
2017,ISERE,Le Touvet,1278,251,1027,28,999,1,REC,82,7.825,31.7
2017,ISERE,Le Touvet,1278,251,1027,28,999,1,RES,19,7.825,31.7
2017,ISERE,Villefontaine,1279,369,910,16,894,1,EELV,63,7.825,31.7
2017,ISERE,Villefontaine,1279,369,910,16,894,1,FN,200,7.825,31.7
2017,ISERE,Villefontaine,1279,369,910,16,894,1,LFI,293,7.825,31.7
2017,ISERE,Villefontaine,1279,369,910,16,894,1,LO,7,7.825,31.7
2017,ISERE,Villefontaine,1279,369,910,16,894,1,LR,25,7.825,31.7
2017,ISERE,Villefontaine,1279,369,910,16,894,1,LREM,167,7.825,31.7
2017,ISERE,Villefontaine,1279,369,910,16,894,1,NPA,15,7.825,31.7
2017,ISERE,Villefontaine,1279,369,910,16,894,1,PCF,16,7.825,31.7
2017,ISERE,Villefontaine,1279,369,910,16,894,1,REC,62,7.825,31.7
2017,ISERE,Villefontaine,1279,369,910,16,894,1,RES,16,7.825,31.7
2017,ISERE,Charnècles,1280,270,1010,24,986,1,EELV,53,7.825,31.7
2017,ISERE,Charnècles,1280,270,1010,24,986,1,FN,220,7.825,31.7
2017,ISERE,Charnècles,1280,270,1010,24,986,1,LFI,155,7.825,31.7
2017,ISERE,Charnècles,1280,270,1010,24,986,1,LO,1,7.825,31.7
2017,ISERE,Charnècles,1280,270,1010,24,986,1,LR,43,7.825,31.7
2017,ISERE,Charnècles,1280,270,1010,24,986,1,LREM,339,7.825,31.7
2017,ISERE,Charnècles,1280,270,1010,24,986,1,NPA,1,7.825,31.7
2017,ISERE,Charnècles,1280,270,1010,24,986,1,PCF,31,7.825,31.7
2017,ISERE,Charnècles,1280,270,1010,24,986,1,REC,77,7.825,31.7
2017,ISERE,Charnècles,1280,270,1010,24,986,1,RES,25,7.825,31.7
2017,ISERE,Grenoble,1281,305,976,6,970,1,EELV,95,7.825,31.7
2017,ISERE,Grenoble,1281,305,976,6,970,1,FN,59,7.825,31.7
2017,ISERE,Grenoble,1281,305,976,6,970,1,LFI,513,7.825,31.7
2017,ISERE,Grenoble,1281,305,976,6,970,1,LO,4,7.825,31.7
2017,ISERE,Grenoble,1281,305,976,6,970,1,LR,15,7.825,31.7
2017,ISERE,Grenoble,1281,305,976,6,970,1,LREM,197,7.825,31.7
2017,ISERE,Grenoble,1281,305,976,6,970,1,NPA,4,7.825,31.7
2017,ISERE,Grenoble,1281,305,976,6,970,1,PCF,11,7.825,31.7
2017,ISERE,Grenoble,1281,305,976,6,970,1,REC,25,7.825,31.7
2017,ISERE,Grenoble,1281,305,976,6,970,1,RES,16,7.825,31.7
2017,ISERE,Vif,1284,271,1013,21,992,1,EELV,50,7.825,31.7
2017,ISERE,Vif,1284,271,1013,21,992,1,FN,287,7.825,31.7
2017,ISERE,Vif,1284,271,1013,21,992,1,LFI,190,7.825,31.7
2017,ISERE,Vif,1284,271,1013,21,992,1,LO,7,7.825,31.7
2017,ISERE,Vif,1284,271,1013,21,992,1,LR,35,7.825,31.7
2017,ISERE,Vif,1284,271,1013,21,992,1,LREM,250,7.825,31.7
2017,ISERE,Vif,1284,271,1013,21,992,1,NPA,7,7.825,31.7
2017,ISERE,Vif,1284,271,1013,21,992,1,PCF,27,7.825,31.7
2017,ISERE,Vif,1284,271,1013,21,992,1,REC,78,7.825,31.7
2017,ISERE,Vif,1284,271,1013,21,992,1,RES,23,7.825,31.7
2017,ISERE,Gières,1291,237,1054,10,1044,1,EELV,95,7.825,31.7
2017,ISERE,Gières,1291,237,1054,10,1044,1,FN,156,7.825,31.7
2017,ISERE,Gières,1291,237,1054,10,1044,1,LFI,277,7.825,31.7
2017,ISERE,Gières,1291,237,1054,10,1044,1,LO,3,7.825,31.7
2017,ISERE,Gières,1291,237,1054,10,1044,1,LR,48,7.825,31.7
2017,ISERE,Gières,1291,237,1054,10,1044,1,LREM,313,7.825,31.7
2017,ISERE,Gières,1291,237,1054,10,1044,1,NPA,6,7.825,31.7
2017,ISERE,Gières,1291,237,1054,10,1044,1,PCF,18,7.825,31.7
2017,ISERE,Gières,1291,237,1054,10,1044,1,REC,62,7.825,31.7
2017,ISERE,Gières,1291,237,1054,10,1044,1,RES,18,7.825,31.7
2017,ISERE,Bilieu,1293,256,1037,22,1015,1,EELV,61,7.825,31.7
2017,ISERE,Bilieu,1293,256,1037,22,1015,1,FN,244,7.825,31.7
2017,ISERE,Bilieu,1293,256,1037,22,1015,1,LFI,213,7.825,31.7
2017,ISERE,Bilieu,1293,256,1037,22,1015,1,LO,5,7.825,31.7
2017,ISERE,Bilieu,1293,256,1037,22,1015,1,LR,45,7.825,31.7
2017,ISERE,Bilieu,1293,256,1037,22,1015,1,LREM,280,7.825,31.7
2017,ISERE,Bilieu,1293,256,1037,22,1015,1,NPA,5,7.825,31.7
2017,ISERE,Bilieu,1293,256,1037,22,1015,1,PCF,31,7.825,31.7
2017,ISERE,Bilieu,1293,256,1037,22,1015,1,REC,44,7.825,31.7
2017,ISERE,Bilieu,1293,256,1037,22,1015,1,RES,37,7.825,31.7
2017,ISERE,Villefontaine,1294,429,865,26,839,1,EELV,31,7.825,31.7
2017,ISERE,Villefontaine,1294,429,865,26,839,1,FN,152,7.825,31.7
2017,ISERE,Villefontaine,1294,429,865,26,839,1,LFI,314,7.825,31.7
2017,ISERE,Villefontaine,1294,429,865,26,839,1,LO,8,7.825,31.7
2017,ISERE,Villefontaine,1294,429,865,26,839,1,LR,19,7.825,31.7
2017,ISERE,Villefontaine,1294,429,865,26,839,1,LREM,185,7.825,31.7
2017,ISERE,Villefontaine,1294,429,865,26,839,1,NPA,5,7.825,31.7
2017,ISERE,Villefontaine,1294,429,865,26,839,1,PCF,19,7.825,31.7
2017,ISERE,Villefontaine,1294,429,865,26,839,1,REC,59,7.825,31.7
2017,ISERE,Villefontaine,1294,429,865,26,839,1,RES,21,7.825,31.7
2017,ISERE,L'Isle-d'Abeau,1294,467,827,13,814,1,EELV,28,7.825,31.7
2017,ISERE,L'Isle-d'Abeau,1294,467,827,13,814,1,FN,232,7.825,31.7
2017,ISERE,L'Isle-d'Abeau,1294,467,827,13,814,1,LFI,293,7.825,31.7
2017,ISERE,L'Isle-d'Abeau,1294,467,827,13,814,1,LO,1,7.825,31.7
2017,ISERE,L'Isle-d'Abeau,1294,467,827,13,814,1,LR,19,7.825,31.7
2017,ISERE,L'Isle-d'Abeau,1294,467,827,13,814,1,LREM,149,7.825,31.7
2017,ISERE,L'Isle-d'Abeau,1294,467,827,13,814,1,NPA,5,7.825,31.7
2017,ISERE,L'Isle-d'Abeau,1294,467,827,13,814,1,PCF,20,7.825,31.7
2017,ISERE,L'Isle-d'Abeau,1294,467,827,13,814,1,REC,29,7.825,31.7
2017,ISERE,L'Isle-d'Abeau,1294,467,827,13,814,1,RES,12,7.825,31.7
2017,ISERE,Grenoble,1304,288,1016,23,993,1,EELV,121,7.825,31.7
2017,ISERE,Grenoble,1304,288,1016,23,993,1,FN,57,7.825,31.7
2017,ISERE,Grenoble,1304,288,1016,23,993,1,LFI,451,7.825,31.7
2017,ISERE,Grenoble,1304,288,1016,23,993,1,LO,5,7.825,31.7
2017,ISERE,Grenoble,1304,288,1016,23,993,1,LR,20,7.825,31.7
2017,ISERE,Grenoble,1304,288,1016,23,993,1,LREM,235,7.825,31.7
2017,ISERE,Grenoble,1304,288,1016,23,993,1,NPA,4,7.825,31.7
2017,ISERE,Grenoble,1304,288,1016,23,993,1,PCF,20,7.825,31.7
2017,ISERE,Grenoble,1304,288,1016,23,993,1,REC,31,7.825,31.7
2017,ISERE,Grenoble,1304,288,1016,23,993,1,RES,8,7.825,31.7
2017,ISERE,Chonas-l'Amballan,1315,210,1105,18,1087,1,EELV,45,7.825,31.7
2017,ISERE,Chonas-l'Amballan,1315,210,1105,18,1087,1,FN,289,7.825,31.7
2017,ISERE,Chonas-l'Amballan,1315,210,1105,18,1087,1,LFI,178,7.825,31.7
2017,ISERE,Chonas-l'Amballan,1315,210,1105,18,1087,1,LO,6,7.825,31.7
2017,ISERE,Chonas-l'Amballan,1315,210,1105,18,1087,1,LR,58,7.825,31.7
2017,ISERE,Chonas-l'Amballan,1315,210,1105,18,1087,1,LREM,323,7.825,31.7
2017,ISERE,Chonas-l'Amballan,1315,210,1105,18,1087,1,NPA,3,7.825,31.7
2017,ISERE,Chonas-l'Amballan,1315,210,1105,18,1087,1,PCF,24,7.825,31.7
2017,ISERE,Chonas-l'Amballan,1315,210,1105,18,1087,1,REC,100,7.825,31.7
2017,ISERE,Chonas-l'Amballan,1315,210,1105,18,1087,1,RES,31,7.825,31.7
2017,ISERE,Villard-Bonnot,1315,310,1005,25,980,1,EELV,59,7.825,31.7
2017,ISERE,Villard-Bonnot,1315,310,1005,25,980,1,FN,197,7.825,31.7
2017,ISERE,Villard-Bonnot,1315,310,1005,25,980,1,LFI,244,7.825,31.7
2017,ISERE,Villard-Bonnot,1315,310,1005,25,980,1,LO,6,7.825,31.7
2017,ISERE,Villard-Bonnot,1315,310,1005,25,980,1,LR,36,7.825,31.7
2017,ISERE,Villard-Bonnot,1315,310,1005,25,980,1,LREM,257,7.825,31.7
2017,ISERE,Villard-Bonnot,1315,310,1005,25,980,1,NPA,12,7.825,31.7
2017,ISERE,Villard-Bonnot,1315,310,1005,25,980,1,PCF,49,7.825,31.7
2017,ISERE,Villard-Bonnot,1315,310,1005,25,980,1,REC,55,7.825,31.7
2017,ISERE,Villard-Bonnot,1315,310,1005,25,980,1,RES,22,7.825,31.7
2017,ISERE,Grenoble,1320,312,1008,13,995,1,EELV,115,7.825,31.7
2017,ISERE,Grenoble,1320,312,1008,13,995,1,FN,95,7.825,31.7
2017,ISERE,Grenoble,1320,312,1008,13,995,1,LFI,350,7.825,31.7
2017,ISERE,Grenoble,1320,312,1008,13,995,1,LO,3,7.825,31.7
2017,ISERE,Grenoble,1320,312,1008,13,995,1,LR,25,7.825,31.7
2017,ISERE,Grenoble,1320,312,1008,13,995,1,LREM,270,7.825,31.7
2017,ISERE,Grenoble,1320,312,1008,13,995,1,NPA,13,7.825,31.7
2017,ISERE,Grenoble,1320,312,1008,13,995,1,PCF,18,7.825,31.7
2017,ISERE,Grenoble,1320,312,1008,13,995,1,REC,58,7.825,31.7
2017,ISERE,Grenoble,1320,312,1008,13,995,1,RES,14,7.825,31.7
2017,ISERE,Colombe,1323,238,1085,32,1053,1,EELV,43,7.825,31.7
2017,ISERE,Colombe,1323,238,1085,32,1053,1,FN,270,7.825,31.7
2017,ISERE,Colombe,1323,238,1085,32,1053,1,LFI,181,7.825,31.7
2017,ISERE,Colombe,1323,238,1085,32,1053,1,LO,5,7.825,31.7
2017,ISERE,Colombe,1323,238,1085,32,1053,1,LR,54,7.825,31.7
2017,ISERE,Colombe,1323,238,1085,32,1053,1,LREM,304,7.825,31.7
2017,ISERE,Colombe,1323,238,1085,32,1053,1,NPA,8,7.825,31.7
2017,ISERE,Colombe,1323,238,1085,32,1053,1,PCF,15,7.825,31.7
2017,ISERE,Colombe,1323,238,1085,32,1053,1,REC,79,7.825,31.7
2017,ISERE,Colombe,1323,238,1085,32,1053,1,RES,41,7.825,31.7
2017,ISERE,Sassenage,1326,262,1064,23,1041,1,EELV,83,7.825,31.7
2017,ISERE,Sassenage,1326,262,1064,23,1041,1,FN,209,7.825,31.7
2017,ISERE,Sassenage,1326,262,1064,23,1041,1,LFI,189,7.825,31.7
2017,ISERE,Sassenage,1326,262,1064,23,1041,1,LO,2,7.825,31.7
2017,ISERE,Sassenage,1326,262,1064,23,1041,1,LR,46,7.825,31.7
2017,ISERE,Sassenage,1326,262,1064,23,1041,1,LREM,340,7.825,31.7
2017,ISERE,Sassenage,1326,262,1064,23,1041,1,NPA,6,7.825,31.7
2017,ISERE,Sassenage,1326,262,1064,23,1041,1,PCF,24,7.825,31.7
2017,ISERE,Sassenage,1326,262,1064,23,1041,1,REC,81,7.825,31.7
2017,ISERE,Sassenage,1326,262,1064,23,1041,1,RES,32,7.825,31.7
2017,ISERE,Montferrat,1327,283,1044,13,1031,1,EELV,60,7.825,31.7
2017,ISERE,Montferrat,1327,283,1044,13,1031,1,FN,264,7.825,31.7
2017,ISERE,Montferrat,1327,283,1044,13,1031,1,LFI,180,7.825,31.7
2017,ISERE,Montferrat,1327,283,1044,13,1031,1,LO,7,7.825,31.7
2017,ISERE,Montferrat,1327,283,1044,13,1031,1,LR,56,7.825,31.7
2017,ISERE,Montferrat,1327,283,1044,13,1031,1,LREM,264,7.825,31.7
2017,ISERE,Montferrat,1327,283,1044,13,1031,1,NPA,9,7.825,31.7
2017,ISERE,Montferrat,1327,283,1044,13,1031,1,PCF,36,7.825,31.7
2017,ISERE,Montferrat,1327,283,1044,13,1031,1,REC,77,7.825,31.7
2017,ISERE,Montferrat,1327,283,1044,13,1031,1,RES,22,7.825,31.7
2017,ISERE,Grenoble,1328,266,1062,20,1042,1,EELV,97,7.825,31.7
2017,ISERE,Grenoble,1328,266,1062,20,1042,1,FN,62,7.825,31.7
2017,ISERE,Grenoble,1328,266,1062,20,1042,1,LFI,273,7.825,31.7
2017,ISERE,Grenoble,1328,266,1062,20,1042,1,LO,1,7.825,31.7
2017,ISERE,Grenoble,1328,266,1062,20,1042,1,LR,68,7.825,31.7
2017,ISERE,Grenoble,1328,266,1062,20,1042,1,LREM,382,7.825,31.7
2017,ISERE,Grenoble,1328,266,1062,20,1042,1,NPA,6,7.825,31.7
2017,ISERE,Grenoble,1328,266,1062,20,1042,1,PCF,9,7.825,31.7
2017,ISERE,Grenoble,1328,266,1062,20,1042,1,REC,99,7.825,31.7
2017,ISERE,Grenoble,1328,266,1062,20,1042,1,RES,7,7.825,31.7
2017,ISERE,La Motte-d'Aveillans,1332,332,1000,21,979,1,EELV,32,7.825,31.7
2017,ISERE,La Motte-d'Aveillans,1332,332,1000,21,979,1,FN,315,7.825,31.7
2017,ISERE,La Motte-d'Aveillans,1332,332,1000,21,979,1,LFI,193,7.825,31.7
2017,ISERE,La Motte-d'Aveillans,1332,332,1000,21,979,1,LO,8,7.825,31.7
2017,ISERE,La Motte-d'Aveillans,1332,332,1000,21,979,1,LR,8,7.825,31.7
2017,ISERE,La Motte-d'Aveillans,1332,332,1000,21,979,1,LREM,224,7.825,31.7
2017,ISERE,La Motte-d'Aveillans,1332,332,1000,21,979,1,NPA,8,7.825,31.7
2017,ISERE,La Motte-d'Aveillans,1332,332,1000,21,979,1,PCF,29,7.825,31.7
2017,ISERE,La Motte-d'Aveillans,1332,332,1000,21,979,1,REC,88,7.825,31.7
2017,ISERE,La Motte-d'Aveillans,1332,332,1000,21,979,1,RES,32,7.825,31.7
2017,ISERE,Saint-Georges-d'Espéranche,1333,264,1069,20,1049,1,EELV,37,7.825,31.7
2017,ISERE,Saint-Georges-d'Espéranche,1333,264,1069,20,1049,1,FN,327,7.825,31.7
2017,ISERE,Saint-Georges-d'Espéranche,1333,264,1069,20,1049,1,LFI,127,7.825,31.7
2017,ISERE,Saint-Georges-d'Espéranche,1333,264,1069,20,1049,1,LO,6,7.825,31.7
2017,ISERE,Saint-Georges-d'Espéranche,1333,264,1069,20,1049,1,LR,60,7.825,31.7
2017,ISERE,Saint-Georges-d'Espéranche,1333,264,1069,20,1049,1,LREM,286,7.825,31.7
2017,ISERE,Saint-Georges-d'Espéranche,1333,264,1069,20,1049,1,NPA,2,7.825,31.7
2017,ISERE,Saint-Georges-d'Espéranche,1333,264,1069,20,1049,1,PCF,21,7.825,31.7
2017,ISERE,Saint-Georges-d'Espéranche,1333,264,1069,20,1049,1,REC,76,7.825,31.7
2017,ISERE,Saint-Georges-d'Espéranche,1333,264,1069,20,1049,1,RES,57,7.825,31.7
2017,ISERE,Dolomieu,1333,285,1048,21,1027,1,EELV,58,7.825,31.7
2017,ISERE,Dolomieu,1333,285,1048,21,1027,1,FN,345,7.825,31.7
2017,ISERE,Dolomieu,1333,285,1048,21,1027,1,LFI,150,7.825,31.7
2017,ISERE,Dolomieu,1333,285,1048,21,1027,1,LO,9,7.825,31.7
2017,ISERE,Dolomieu,1333,285,1048,21,1027,1,LR,46,7.825,31.7
2017,ISERE,Dolomieu,1333,285,1048,21,1027,1,LREM,228,7.825,31.7
2017,ISERE,Dolomieu,1333,285,1048,21,1027,1,NPA,10,7.825,31.7
2017,ISERE,Dolomieu,1333,285,1048,21,1027,1,PCF,22,7.825,31.7
2017,ISERE,Dolomieu,1333,285,1048,21,1027,1,REC,93,7.825,31.7
2017,ISERE,Dolomieu,1333,285,1048,21,1027,1,RES,22,7.825,31.7
2017,ISERE,Entre-deux-Guiers,1333,323,1010,20,990,1,EELV,44,7.825,31.7
2017,ISERE,Entre-deux-Guiers,1333,323,1010,20,990,1,FN,305,7.825,31.7
2017,ISERE,Entre-deux-Guiers,1333,323,1010,20,990,1,LFI,189,7.825,31.7
2017,ISERE,Entre-deux-Guiers,1333,323,1010,20,990,1,LO,6,7.825,31.7
2017,ISERE,Entre-deux-Guiers,1333,323,1010,20,990,1,LR,45,7.825,31.7
2017,ISERE,Entre-deux-Guiers,1333,323,1010,20,990,1,LREM,208,7.825,31.7
2017,ISERE,Entre-deux-Guiers,1333,323,1010,20,990,1,NPA,8,7.825,31.7
2017,ISERE,Entre-deux-Guiers,1333,323,1010,20,990,1,PCF,24,7.825,31.7
2017,ISERE,Entre-deux-Guiers,1333,323,1010,20,990,1,REC,89,7.825,31.7
2017,ISERE,Entre-deux-Guiers,1333,323,1010,20,990,1,RES,26,7.825,31.7
2017,ISERE,Les Roches-de-Condrieu,1335,282,1053,25,1028,1,EELV,52,7.825,31.7
2017,ISERE,Les Roches-de-Condrieu,1335,282,1053,25,1028,1,FN,280,7.825,31.7
2017,ISERE,Les Roches-de-Condrieu,1335,282,1053,25,1028,1,LFI,237,7.825,31.7
2017,ISERE,Les Roches-de-Condrieu,1335,282,1053,25,1028,1,LO,6,7.825,31.7
2017,ISERE,Les Roches-de-Condrieu,1335,282,1053,25,1028,1,LR,40,7.825,31.7
2017,ISERE,Les Roches-de-Condrieu,1335,282,1053,25,1028,1,LREM,240,7.825,31.7
2017,ISERE,Les Roches-de-Condrieu,1335,282,1053,25,1028,1,NPA,8,7.825,31.7
2017,ISERE,Les Roches-de-Condrieu,1335,282,1053,25,1028,1,PCF,20,7.825,31.7
2017,ISERE,Les Roches-de-Condrieu,1335,282,1053,25,1028,1,REC,67,7.825,31.7
2017,ISERE,Les Roches-de-Condrieu,1335,282,1053,25,1028,1,RES,33,7.825,31.7
2017,ISERE,Porcieu-Amblagnieu,1336,316,1020,25,995,1,EELV,27,7.825,31.7
2017,ISERE,Porcieu-Amblagnieu,1336,316,1020,25,995,1,FN,336,7.825,31.7
2017,ISERE,Porcieu-Amblagnieu,1336,316,1020,25,995,1,LFI,144,7.825,31.7
2017,ISERE,Porcieu-Amblagnieu,1336,316,1020,25,995,1,LO,12,7.825,31.7
2017,ISERE,Porcieu-Amblagnieu,1336,316,1020,25,995,1,LR,40,7.825,31.7
2017,ISERE,Porcieu-Amblagnieu,1336,316,1020,25,995,1,LREM,254,7.825,31.7
2017,ISERE,Porcieu-Amblagnieu,1336,316,1020,25,995,1,NPA,10,7.825,31.7
2017,ISERE,Porcieu-Amblagnieu,1336,316,1020,25,995,1,PCF,18,7.825,31.7
2017,ISERE,Porcieu-Amblagnieu,1336,316,1020,25,995,1,REC,103,7.825,31.7
2017,ISERE,Porcieu-Amblagnieu,1336,316,1020,25,995,1,RES,26,7.825,31.7
2017,ISERE,Romagnieu,1337,242,1095,17,1078,1,EELV,42,7.825,31.7
2017,ISERE,Romagnieu,1337,242,1095,17,1078,1,FN,366,7.825,31.7
2017,ISERE,Romagnieu,1337,242,1095,17,1078,1,LFI,167,7.825,31.7
2017,ISERE,Romagnieu,1337,242,1095,17,1078,1,LO,4,7.825,31.7
2017,ISERE,Romagnieu,1337,242,1095,17,1078,1,LR,49,7.825,31.7
2017,ISERE,Romagnieu,1337,242,1095,17,1078,1,LREM,246,7.825,31.7
2017,ISERE,Romagnieu,1337,242,1095,17,1078,1,NPA,7,7.825,31.7
2017,ISERE,Romagnieu,1337,242,1095,17,1078,1,PCF,15,7.825,31.7
2017,ISERE,Romagnieu,1337,242,1095,17,1078,1,REC,90,7.825,31.7
2017,ISERE,Romagnieu,1337,242,1095,17,1078,1,RES,43,7.825,31.7
2017,ISERE,Tencin,1338,255,1083,25,1058,1,EELV,56,7.825,31.7
2017,ISERE,Tencin,1338,255,1083,25,1058,1,FN,302,7.825,31.7
2017,ISERE,Tencin,1338,255,1083,25,1058,1,LFI,205,7.825,31.7
2017,ISERE,Tencin,1338,255,1083,25,1058,1,LO,6,7.825,31.7
2017,ISERE,Tencin,1338,255,1083,25,1058,1,LR,40,7.825,31.7
2017,ISERE,Tencin,1338,255,1083,25,1058,1,LREM,266,7.825,31.7
2017,ISERE,Tencin,1338,255,1083,25,1058,1,NPA,9,7.825,31.7
2017,ISERE,Tencin,1338,255,1083,25,1058,1,PCF,31,7.825,31.7
2017,ISERE,Tencin,1338,255,1083,25,1058,1,REC,68,7.825,31.7
2017,ISERE,Tencin,1338,255,1083,25,1058,1,RES,31,7.825,31.7
2017,ISERE,Saint-Vérand,1339,235,1104,24,1080,1,EELV,80,7.825,31.7
2017,ISERE,Saint-Vérand,1339,235,1104,24,1080,1,FN,264,7.825,31.7
2017,ISERE,Saint-Vérand,1339,235,1104,24,1080,1,LFI,216,7.825,31.7
2017,ISERE,Saint-Vérand,1339,235,1104,24,1080,1,LO,5,7.825,31.7
2017,ISERE,Saint-Vérand,1339,235,1104,24,1080,1,LR,44,7.825,31.7
2017,ISERE,Saint-Vérand,1339,235,1104,24,1080,1,LREM,285,7.825,31.7
2017,ISERE,Saint-Vérand,1339,235,1104,24,1080,1,NPA,1,7.825,31.7
2017,ISERE,Saint-Vérand,1339,235,1104,24,1080,1,PCF,14,7.825,31.7
2017,ISERE,Saint-Vérand,1339,235,1104,24,1080,1,REC,73,7.825,31.7
2017,ISERE,Saint-Vérand,1339,235,1104,24,1080,1,RES,41,7.825,31.7
2017,ISERE,Oytier-Saint-Oblas,1340,307,1033,25,1008,1,EELV,49,7.825,31.7
2017,ISERE,Oytier-Saint-Oblas,1340,307,1033,25,1008,1,FN,340,7.825,31.7
2017,ISERE,Oytier-Saint-Oblas,1340,307,1033,25,1008,1,LFI,117,7.825,31.7
2017,ISERE,Oytier-Saint-Oblas,1340,307,1033,25,1008,1,LO,3,7.825,31.7
2017,ISERE,Oytier-Saint-Oblas,1340,307,1033,25,1008,1,LR,47,7.825,31.7
2017,ISERE,Oytier-Saint-Oblas,1340,307,1033,25,1008,1,LREM,268,7.825,31.7
2017,ISERE,Oytier-Saint-Oblas,1340,307,1033,25,1008,1,NPA,8,7.825,31.7
2017,ISERE,Oytier-Saint-Oblas,1340,307,1033,25,1008,1,PCF,20,7.825,31.7
2017,ISERE,Oytier-Saint-Oblas,1340,307,1033,25,1008,1,REC,72,7.825,31.7
2017,ISERE,Oytier-Saint-Oblas,1340,307,1033,25,1008,1,RES,30,7.825,31.7
2017,ISERE,Saint-Sauveur,1349,260,1089,29,1060,1,EELV,43,7.825,31.7
2017,ISERE,Saint-Sauveur,1349,260,1089,29,1060,1,FN,327,7.825,31.7
2017,ISERE,Saint-Sauveur,1349,260,1089,29,1060,1,LFI,178,7.825,31.7
2017,ISERE,Saint-Sauveur,1349,260,1089,29,1060,1,LO,11,7.825,31.7
2017,ISERE,Saint-Sauveur,1349,260,1089,29,1060,1,LR,38,7.825,31.7
2017,ISERE,Saint-Sauveur,1349,260,1089,29,1060,1,LREM,289,7.825,31.7
2017,ISERE,Saint-Sauveur,1349,260,1089,29,1060,1,NPA,5,7.825,31.7
2017,ISERE,Saint-Sauveur,1349,260,1089,29,1060,1,PCF,33,7.825,31.7
2017,ISERE,Saint-Sauveur,1349,260,1089,29,1060,1,REC,66,7.825,31.7
2017,ISERE,Saint-Sauveur,1349,260,1089,29,1060,1,RES,25,7.825,31.7
2017,ISERE,Grenoble,1349,332,1017,10,1007,1,EELV,105,7.825,31.7
2017,ISERE,Grenoble,1349,332,1017,10,1007,1,FN,92,7.825,31.7
2017,ISERE,Grenoble,1349,332,1017,10,1007,1,LFI,374,7.825,31.7
2017,ISERE,Grenoble,1349,332,1017,10,1007,1,LO,2,7.825,31.7
2017,ISERE,Grenoble,1349,332,1017,10,1007,1,LR,37,7.825,31.7
2017,ISERE,Grenoble,1349,332,1017,10,1007,1,LREM,273,7.825,31.7
2017,ISERE,Grenoble,1349,332,1017,10,1007,1,NPA,5,7.825,31.7
2017,ISERE,Grenoble,1349,332,1017,10,1007,1,PCF,23,7.825,31.7
2017,ISERE,Grenoble,1349,332,1017,10,1007,1,REC,36,7.825,31.7
2017,ISERE,Grenoble,1349,332,1017,10,1007,1,RES,12,7.825,31.7
2017,ISERE,Villefontaine,1353,462,891,19,872,1,EELV,43,7.825,31.7
2017,ISERE,Villefontaine,1353,462,891,19,872,1,FN,175,7.825,31.7
2017,ISERE,Villefontaine,1353,462,891,19,872,1,LFI,318,7.825,31.7
2017,ISERE,Villefontaine,1353,462,891,19,872,1,LO,7,7.825,31.7
2017,ISERE,Villefontaine,1353,462,891,19,872,1,LR,22,7.825,31.7
2017,ISERE,Villefontaine,1353,462,891,19,872,1,LREM,195,7.825,31.7
2017,ISERE,Villefontaine,1353,462,891,19,872,1,NPA,3,7.825,31.7
2017,ISERE,Villefontaine,1353,462,891,19,872,1,PCF,16,7.825,31.7
2017,ISERE,Villefontaine,1353,462,891,19,872,1,REC,43,7.825,31.7
2017,ISERE,Villefontaine,1353,462,891,19,872,1,RES,20,7.825,31.7
2017,ISERE,Saint-Georges-d'Espéranche,1357,312,1045,19,1026,1,EELV,61,7.825,31.7
2017,ISERE,Saint-Georges-d'Espéranche,1357,312,1045,19,1026,1,FN,302,7.825,31.7
2017,ISERE,Saint-Georges-d'Espéranche,1357,312,1045,19,1026,1,LFI,135,7.825,31.7
2017,ISERE,Saint-Georges-d'Espéranche,1357,312,1045,19,1026,1,LO,2,7.825,31.7
2017,ISERE,Saint-Georges-d'Espéranche,1357,312,1045,19,1026,1,LR,65,7.825,31.7
2017,ISERE,Saint-Georges-d'Espéranche,1357,312,1045,19,1026,1,LREM,273,7.825,31.7
2017,ISERE,Saint-Georges-d'Espéranche,1357,312,1045,19,1026,1,NPA,4,7.825,31.7
2017,ISERE,Saint-Georges-d'Espéranche,1357,312,1045,19,1026,1,PCF,19,7.825,31.7
2017,ISERE,Saint-Georges-d'Espéranche,1357,312,1045,19,1026,1,REC,91,7.825,31.7
2017,ISERE,Saint-Georges-d'Espéranche,1357,312,1045,19,1026,1,RES,29,7.825,31.7
2017,ISERE,Fontaine,1357,419,938,25,913,1,EELV,37,7.825,31.7
2017,ISERE,Fontaine,1357,419,938,25,913,1,FN,196,7.825,31.7
2017,ISERE,Fontaine,1357,419,938,25,913,1,LFI,336,7.825,31.7
2017,ISERE,Fontaine,1357,419,938,25,913,1,LO,3,7.825,31.7
2017,ISERE,Fontaine,1357,419,938,25,913,1,LR,19,7.825,31.7
2017,ISERE,Fontaine,1357,419,938,25,913,1,LREM,182,7.825,31.7
2017,ISERE,Fontaine,1357,419,938,25,913,1,NPA,8,7.825,31.7
2017,ISERE,Fontaine,1357,419,938,25,913,1,PCF,36,7.825,31.7
2017,ISERE,Fontaine,1357,419,938,25,913,1,REC,45,7.825,31.7
2017,ISERE,Fontaine,1357,419,938,25,913,1,RES,20,7.825,31.7
2017,ISERE,La Bâtie-Montgascon,1358,273,1085,29,1056,1,EELV,51,7.825,31.7
2017,ISERE,La Bâtie-Montgascon,1358,273,1085,29,1056,1,FN,380,7.825,31.7
2017,ISERE,La Bâtie-Montgascon,1358,273,1085,29,1056,1,LFI,161,7.825,31.7
2017,ISERE,La Bâtie-Montgascon,1358,273,1085,29,1056,1,LO,5,7.825,31.7
2017,ISERE,La Bâtie-Montgascon,1358,273,1085,29,1056,1,LR,25,7.825,31.7
2017,ISERE,La Bâtie-Montgascon,1358,273,1085,29,1056,1,LREM,255,7.825,31.7
2017,ISERE,La Bâtie-Montgascon,1358,273,1085,29,1056,1,NPA,13,7.825,31.7
2017,ISERE,La Bâtie-Montgascon,1358,273,1085,29,1056,1,PCF,13,7.825,31.7
2017,ISERE,La Bâtie-Montgascon,1358,273,1085,29,1056,1,REC,66,7.825,31.7
2017,ISERE,La Bâtie-Montgascon,1358,273,1085,29,1056,1,RES,42,7.825,31.7
2017,ISERE,Vizille,1358,419,939,12,927,1,EELV,32,7.825,31.7
2017,ISERE,Vizille,1358,419,939,12,927,1,FN,251,7.825,31.7
2017,ISERE,Vizille,1358,419,939,12,927,1,LFI,263,7.825,31.7
2017,ISERE,Vizille,1358,419,939,12,927,1,LO,5,7.825,31.7
2017,ISERE,Vizille,1358,419,939,12,927,1,LR,23,7.825,31.7
2017,ISERE,Vizille,1358,419,939,12,927,1,LREM,188,7.825,31.7
2017,ISERE,Vizille,1358,419,939,12,927,1,NPA,9,7.825,31.7
2017,ISERE,Vizille,1358,419,939,12,927,1,PCF,23,7.825,31.7
2017,ISERE,Vizille,1358,419,939,12,927,1,REC,77,7.825,31.7
2017,ISERE,Vizille,1358,419,939,12,927,1,RES,22,7.825,31.7
2017,ISERE,Vourey,1360,258,1102,17,1085,1,EELV,90,7.825,31.7
2017,ISERE,Vourey,1360,258,1102,17,1085,1,FN,202,7.825,31.7
2017,ISERE,Vourey,1360,258,1102,17,1085,1,LFI,193,7.825,31.7
2017,ISERE,Vourey,1360,258,1102,17,1085,1,LO,8,7.825,31.7
2017,ISERE,Vourey,1360,258,1102,17,1085,1,LR,39,7.825,31.7
2017,ISERE,Vourey,1360,258,1102,17,1085,1,LREM,342,7.825,31.7
2017,ISERE,Vourey,1360,258,1102,17,1085,1,NPA,6,7.825,31.7
2017,ISERE,Vourey,1360,258,1102,17,1085,1,PCF,22,7.825,31.7
2017,ISERE,Vourey,1360,258,1102,17,1085,1,REC,93,7.825,31.7
2017,ISERE,Vourey,1360,258,1102,17,1085,1,RES,33,7.825,31.7
2017,ISERE,Villard-Bonnot,1367,336,1031,26,1005,1,EELV,64,7.825,31.7
2017,ISERE,Villard-Bonnot,1367,336,1031,26,1005,1,FN,250,7.825,31.7
2017,ISERE,Villard-Bonnot,1367,336,1031,26,1005,1,LFI,240,7.825,31.7
2017,ISERE,Villard-Bonnot,1367,336,1031,26,1005,1,LO,4,7.825,31.7
2017,ISERE,Villard-Bonnot,1367,336,1031,26,1005,1,LR,25,7.825,31.7
2017,ISERE,Villard-Bonnot,1367,336,1031,26,1005,1,LREM,259,7.825,31.7
2017,ISERE,Villard-Bonnot,1367,336,1031,26,1005,1,NPA,8,7.825,31.7
2017,ISERE,Villard-Bonnot,1367,336,1031,26,1005,1,PCF,40,7.825,31.7
2017,ISERE,Villard-Bonnot,1367,336,1031,26,1005,1,REC,47,7.825,31.7
2017,ISERE,Villard-Bonnot,1367,336,1031,26,1005,1,RES,23,7.825,31.7
2017,ISERE,Saint-Romans,1380,262,1118,29,1089,1,EELV,56,7.825,31.7
2017,ISERE,Saint-Romans,1380,262,1118,29,1089,1,FN,301,7.825,31.7
2017,ISERE,Saint-Romans,1380,262,1118,29,1089,1,LFI,179,7.825,31.7
2017,ISERE,Saint-Romans,1380,262,1118,29,1089,1,LO,8,7.825,31.7
2017,ISERE,Saint-Romans,1380,262,1118,29,1089,1,LR,50,7.825,31.7
2017,ISERE,Saint-Romans,1380,262,1118,29,1089,1,LREM,298,7.825,31.7
2017,ISERE,Saint-Romans,1380,262,1118,29,1089,1,NPA,9,7.825,31.7
2017,ISERE,Saint-Romans,1380,262,1118,29,1089,1,PCF,19,7.825,31.7
2017,ISERE,Saint-Romans,1380,262,1118,29,1089,1,REC,75,7.825,31.7
2017,ISERE,Saint-Romans,1380,262,1118,29,1089,1,RES,42,7.825,31.7
2017,ISERE,Vizille,1389,357,1032,21,1011,1,EELV,72,7.825,31.7
2017,ISERE,Vizille,1389,357,1032,21,1011,1,FN,228,7.825,31.7
2017,ISERE,Vizille,1389,357,1032,21,1011,1,LFI,257,7.825,31.7
2017,ISERE,Vizille,1389,357,1032,21,1011,1,LO,11,7.825,31.7
2017,ISERE,Vizille,1389,357,1032,21,1011,1,LR,28,7.825,31.7
2017,ISERE,Vizille,1389,357,1032,21,1011,1,LREM,244,7.825,31.7
2017,ISERE,Vizille,1389,357,1032,21,1011,1,NPA,14,7.825,31.7
2017,ISERE,Vizille,1389,357,1032,21,1011,1,PCF,32,7.825,31.7
2017,ISERE,Vizille,1389,357,1032,21,1011,1,REC,61,7.825,31.7
2017,ISERE,Vizille,1389,357,1032,21,1011,1,RES,19,7.825,31.7
2017,ISERE,Pont-Evêque,1392,437,955,29,926,1,EELV,32,7.825,31.7
2017,ISERE,Pont-Evêque,1392,437,955,29,926,1,FN,233,7.825,31.7
2017,ISERE,Pont-Evêque,1392,437,955,29,926,1,LFI,260,7.825,31.7
2017,ISERE,Pont-Evêque,1392,437,955,29,926,1,LO,6,7.825,31.7
2017,ISERE,Pont-Evêque,1392,437,955,29,926,1,LR,29,7.825,31.7
2017,ISERE,Pont-Evêque,1392,437,955,29,926,1,LREM,226,7.825,31.7
2017,ISERE,Pont-Evêque,1392,437,955,29,926,1,NPA,8,7.825,31.7
2017,ISERE,Pont-Evêque,1392,437,955,29,926,1,PCF,16,7.825,31.7
2017,ISERE,Pont-Evêque,1392,437,955,29,926,1,REC,58,7.825,31.7
2017,ISERE,Pont-Evêque,1392,437,955,29,926,1,RES,28,7.825,31.7
2017,ISERE,Grenoble,1395,398,997,14,983,1,EELV,45,7.825,31.7
2017,ISERE,Grenoble,1395,398,997,14,983,1,FN,149,7.825,31.7
2017,ISERE,Grenoble,1395,398,997,14,983,1,LFI,427,7.825,31.7
2017,ISERE,Grenoble,1395,398,997,14,983,1,LO,5,7.825,31.7
2017,ISERE,Grenoble,1395,398,997,14,983,1,LR,26,7.825,31.7
2017,ISERE,Grenoble,1395,398,997,14,983,1,LREM,210,7.825,31.7
2017,ISERE,Grenoble,1395,398,997,14,983,1,NPA,2,7.825,31.7
2017,ISERE,Grenoble,1395,398,997,14,983,1,PCF,26,7.825,31.7
2017,ISERE,Grenoble,1395,398,997,14,983,1,REC,50,7.825,31.7
2017,ISERE,Grenoble,1395,398,997,14,983,1,RES,14,7.825,31.7
2017,ISERE,Claix,1397,246,1151,9,1142,1,EELV,102,7.825,31.7
2017,ISERE,Claix,1397,246,1151,9,1142,1,FN,192,7.825,31.7
2017,ISERE,Claix,1397,246,1151,9,1142,1,LFI,174,7.825,31.7
2017,ISERE,Claix,1397,246,1151,9,1142,1,LO,0,7.825,31.7
2017,ISERE,Claix,1397,246,1151,9,1142,1,LR,64,7.825,31.7
2017,ISERE,Claix,1397,246,1151,9,1142,1,LREM,424,7.825,31.7
2017,ISERE,Claix,1397,246,1151,9,1142,1,NPA,8,7.825,31.7
2017,ISERE,Claix,1397,246,1151,9,1142,1,PCF,26,7.825,31.7
2017,ISERE,Claix,1397,246,1151,9,1142,1,REC,81,7.825,31.7
2017,ISERE,Claix,1397,246,1151,9,1142,1,RES,24,7.825,31.7
2017,ISERE,Voiron,1400,290,1110,31,1079,1,EELV,104,7.825,31.7
2017,ISERE,Voiron,1400,290,1110,31,1079,1,FN,146,7.825,31.7
2017,ISERE,Voiron,1400,290,1110,31,1079,1,LFI,206,7.825,31.7
2017,ISERE,Voiron,1400,290,1110,31,1079,1,LO,5,7.825,31.7
2017,ISERE,Voiron,1400,290,1110,31,1079,1,LR,58,7.825,31.7
2017,ISERE,Voiron,1400,290,1110,31,1079,1,LREM,387,7.825,31.7
2017,ISERE,Voiron,1400,290,1110,31,1079,1,NPA,6,7.825,31.7
2017,ISERE,Voiron,1400,290,1110,31,1079,1,PCF,14,7.825,31.7
2017,ISERE,Voiron,1400,290,1110,31,1079,1,REC,76,7.825,31.7
2017,ISERE,Voiron,1400,290,1110,31,1079,1,RES,33,7.825,31.7
2017,ISERE,Grenoble,1406,299,1107,12,1095,1,EELV,108,7.825,31.7
2017,ISERE,Grenoble,1406,299,1107,12,1095,1,FN,77,7.825,31.7
2017,ISERE,Grenoble,1406,299,1107,12,1095,1,LFI,585,7.825,31.7
2017,ISERE,Grenoble,1406,299,1107,12,1095,1,LO,5,7.825,31.7
2017,ISERE,Grenoble,1406,299,1107,12,1095,1,LR,9,7.825,31.7
2017,ISERE,Grenoble,1406,299,1107,12,1095,1,LREM,194,7.825,31.7
2017,ISERE,Grenoble,1406,299,1107,12,1095,1,NPA,8,7.825,31.7
2017,ISERE,Grenoble,1406,299,1107,12,1095,1,PCF,26,7.825,31.7
2017,ISERE,Grenoble,1406,299,1107,12,1095,1,REC,34,7.825,31.7
2017,ISERE,Grenoble,1406,299,1107,12,1095,1,RES,14,7.825,31.7
2017,ISERE,Fontanil-Cornillon,1407,258,1149,39,1110,1,EELV,68,7.825,31.7
2017,ISERE,Fontanil-Cornillon,1407,258,1149,39,1110,1,FN,206,7.825,31.7
2017,ISERE,Fontanil-Cornillon,1407,258,1149,39,1110,1,LFI,199,7.825,31.7
2017,ISERE,Fontanil-Cornillon,1407,258,1149,39,1110,1,LO,7,7.825,31.7
2017,ISERE,Fontanil-Cornillon,1407,258,1149,39,1110,1,LR,61,7.825,31.7
2017,ISERE,Fontanil-Cornillon,1407,258,1149,39,1110,1,LREM,388,7.825,31.7
2017,ISERE,Fontanil-Cornillon,1407,258,1149,39,1110,1,NPA,1,7.825,31.7
2017,ISERE,Fontanil-Cornillon,1407,258,1149,39,1110,1,PCF,14,7.825,31.7
2017,ISERE,Fontanil-Cornillon,1407,258,1149,39,1110,1,REC,85,7.825,31.7
2017,ISERE,Fontanil-Cornillon,1407,258,1149,39,1110,1,RES,27,7.825,31.7
2017,ISERE,Villard-Bonnot,1410,305,1105,27,1078,1,EELV,55,7.825,31.7
2017,ISERE,Villard-Bonnot,1410,305,1105,27,1078,1,FN,273,7.825,31.7
2017,ISERE,Villard-Bonnot,1410,305,1105,27,1078,1,LFI,224,7.825,31.7
2017,ISERE,Villard-Bonnot,1410,305,1105,27,1078,1,LO,8,7.825,31.7
2017,ISERE,Villard-Bonnot,1410,305,1105,27,1078,1,LR,42,7.825,31.7
2017,ISERE,Villard-Bonnot,1410,305,1105,27,1078,1,LREM,307,7.825,31.7
2017,ISERE,Villard-Bonnot,1410,305,1105,27,1078,1,NPA,4,7.825,31.7
2017,ISERE,Villard-Bonnot,1410,305,1105,27,1078,1,PCF,31,7.825,31.7
2017,ISERE,Villard-Bonnot,1410,305,1105,27,1078,1,REC,59,7.825,31.7
2017,ISERE,Villard-Bonnot,1410,305,1105,27,1078,1,RES,19,7.825,31.7
2017,ISERE,Le Pont-de-Claix,1411,372,1039,10,1029,1,EELV,31,7.825,31.7
2017,ISERE,Le Pont-de-Claix,1411,372,1039,10,1029,1,FN,232,7.825,31.7
2017,ISERE,Le Pont-de-Claix,1411,372,1039,10,1029,1,LFI,359,7.825,31.7
2017,ISERE,Le Pont-de-Claix,1411,372,1039,10,1029,1,LO,8,7.825,31.7
2017,ISERE,Le Pont-de-Claix,1411,372,1039,10,1029,1,LR,26,7.825,31.7
2017,ISERE,Le Pont-de-Claix,1411,372,1039,10,1029,1,LREM,200,7.825,31.7
2017,ISERE,Le Pont-de-Claix,1411,372,1039,10,1029,1,NPA,8,7.825,31.7
2017,ISERE,Le Pont-de-Claix,1411,372,1039,10,1029,1,PCF,37,7.825,31.7
2017,ISERE,Le Pont-de-Claix,1411,372,1039,10,1029,1,REC,62,7.825,31.7
2017,ISERE,Le Pont-de-Claix,1411,372,1039,10,1029,1,RES,28,7.825,31.7
2017,ISERE,Chasse-sur-Rhône,1413,307,1106,22,1084,1,EELV,47,7.825,31.7
2017,ISERE,Chasse-sur-Rhône,1413,307,1106,22,1084,1,FN,304,7.825,31.7
2017,ISERE,Chasse-sur-Rhône,1413,307,1106,22,1084,1,LFI,197,7.825,31.7
2017,ISERE,Chasse-sur-Rhône,1413,307,1106,22,1084,1,LO,6,7.825,31.7
2017,ISERE,Chasse-sur-Rhône,1413,307,1106,22,1084,1,LR,39,7.825,31.7
2017,ISERE,Chasse-sur-Rhône,1413,307,1106,22,1084,1,LREM,283,7.825,31.7
2017,ISERE,Chasse-sur-Rhône,1413,307,1106,22,1084,1,NPA,4,7.825,31.7
2017,ISERE,Chasse-sur-Rhône,1413,307,1106,22,1084,1,PCF,12,7.825,31.7
2017,ISERE,Chasse-sur-Rhône,1413,307,1106,22,1084,1,REC,105,7.825,31.7
2017,ISERE,Chasse-sur-Rhône,1413,307,1106,22,1084,1,RES,30,7.825,31.7
2017,ISERE,Villard-de-Lans,1414,298,1116,17,1099,1,EELV,100,7.825,31.7
2017,ISERE,Villard-de-Lans,1414,298,1116,17,1099,1,FN,186,7.825,31.7
2017,ISERE,Villard-de-Lans,1414,298,1116,17,1099,1,LFI,223,7.825,31.7
2017,ISERE,Villard-de-Lans,1414,298,1116,17,1099,1,LO,3,7.825,31.7
2017,ISERE,Villard-de-Lans,1414,298,1116,17,1099,1,LR,60,7.825,31.7
2017,ISERE,Villard-de-Lans,1414,298,1116,17,1099,1,LREM,322,7.825,31.7
2017,ISERE,Villard-de-Lans,1414,298,1116,17,1099,1,NPA,15,7.825,31.7
2017,ISERE,Villard-de-Lans,1414,298,1116,17,1099,1,PCF,25,7.825,31.7
2017,ISERE,Villard-de-Lans,1414,298,1116,17,1099,1,REC,74,7.825,31.7
2017,ISERE,Villard-de-Lans,1414,298,1116,17,1099,1,RES,40,7.825,31.7
2017,ISERE,Fontaine,1416,370,1046,17,1029,1,EELV,56,7.825,31.7
2017,ISERE,Fontaine,1416,370,1046,17,1029,1,FN,226,7.825,31.7
2017,ISERE,Fontaine,1416,370,1046,17,1029,1,LFI,274,7.825,31.7
2017,ISERE,Fontaine,1416,370,1046,17,1029,1,LO,4,7.825,31.7
2017,ISERE,Fontaine,1416,370,1046,17,1029,1,LR,25,7.825,31.7
2017,ISERE,Fontaine,1416,370,1046,17,1029,1,LREM,268,7.825,31.7
2017,ISERE,Fontaine,1416,370,1046,17,1029,1,NPA,8,7.825,31.7
2017,ISERE,Fontaine,1416,370,1046,17,1029,1,PCF,35,7.825,31.7
2017,ISERE,Fontaine,1416,370,1046,17,1029,1,REC,70,7.825,31.7
2017,ISERE,Fontaine,1416,370,1046,17,1029,1,RES,27,7.825,31.7
2017,ISERE,Villard-de-Lans,1417,287,1130,16,1114,1,EELV,108,7.825,31.7
2017,ISERE,Villard-de-Lans,1417,287,1130,16,1114,1,FN,173,7.825,31.7
2017,ISERE,Villard-de-Lans,1417,287,1130,16,1114,1,LFI,286,7.825,31.7
2017,ISERE,Villard-de-Lans,1417,287,1130,16,1114,1,LO,4,7.825,31.7
2017,ISERE,Villard-de-Lans,1417,287,1130,16,1114,1,LR,42,7.825,31.7
2017,ISERE,Villard-de-Lans,1417,287,1130,16,1114,1,LREM,330,7.825,31.7
2017,ISERE,Villard-de-Lans,1417,287,1130,16,1114,1,NPA,10,7.825,31.7
2017,ISERE,Villard-de-Lans,1417,287,1130,16,1114,1,PCF,23,7.825,31.7
2017,ISERE,Villard-de-Lans,1417,287,1130,16,1114,1,REC,62,7.825,31.7
2017,ISERE,Villard-de-Lans,1417,287,1130,16,1114,1,RES,33,7.825,31.7
2017,ISERE,La Mure,1424,390,1034,31,1003,1,EELV,39,7.825,31.7
2017,ISERE,La Mure,1424,390,1034,31,1003,1,FN,326,7.825,31.7
2017,ISERE,La Mure,1424,390,1034,31,1003,1,LFI,205,7.825,31.7
2017,ISERE,La Mure,1424,390,1034,31,1003,1,LO,10,7.825,31.7
2017,ISERE,La Mure,1424,390,1034,31,1003,1,LR,49,7.825,31.7
2017,ISERE,La Mure,1424,390,1034,31,1003,1,LREM,193,7.825,31.7
2017,ISERE,La Mure,1424,390,1034,31,1003,1,NPA,7,7.825,31.7
2017,ISERE,La Mure,1424,390,1034,31,1003,1,PCF,32,7.825,31.7
2017,ISERE,La Mure,1424,390,1034,31,1003,1,REC,72,7.825,31.7
2017,ISERE,La Mure,1424,390,1034,31,1003,1,RES,30,7.825,31.7
2017,ISERE,Villefontaine,1436,481,955,26,929,1,EELV,25,7.825,31.7
2017,ISERE,Villefontaine,1436,481,955,26,929,1,FN,231,7.825,31.7
2017,ISERE,Villefontaine,1436,481,955,26,929,1,LFI,328,7.825,31.7
2017,ISERE,Villefontaine,1436,481,955,26,929,1,LO,4,7.825,31.7
2017,ISERE,Villefontaine,1436,481,955,26,929,1,LR,31,7.825,31.7
2017,ISERE,Villefontaine,1436,481,955,26,929,1,LREM,179,7.825,31.7
2017,ISERE,Villefontaine,1436,481,955,26,929,1,NPA,11,7.825,31.7
2017,ISERE,Villefontaine,1436,481,955,26,929,1,PCF,18,7.825,31.7
2017,ISERE,Villefontaine,1436,481,955,26,929,1,REC,44,7.825,31.7
2017,ISERE,Villefontaine,1436,481,955,26,929,1,RES,25,7.825,31.7
2017,ISERE,Villefontaine,1443,551,892,17,875,1,EELV,33,7.825,31.7
2017,ISERE,Villefontaine,1443,551,892,17,875,1,FN,254,7.825,31.7
2017,ISERE,Villefontaine,1443,551,892,17,875,1,LFI,311,7.825,31.7
2017,ISERE,Villefontaine,1443,551,892,17,875,1,LO,8,7.825,31.7
2017,ISERE,Villefontaine,1443,551,892,17,875,1,LR,17,7.825,31.7
2017,ISERE,Villefontaine,1443,551,892,17,875,1,LREM,140,7.825,31.7
2017,ISERE,Villefontaine,1443,551,892,17,875,1,NPA,2,7.825,31.7
2017,ISERE,Villefontaine,1443,551,892,17,875,1,PCF,13,7.825,31.7
2017,ISERE,Villefontaine,1443,551,892,17,875,1,REC,57,7.825,31.7
2017,ISERE,Villefontaine,1443,551,892,17,875,1,RES,12,7.825,31.7
2017,ISERE,Autrans-Méaudre en Vercors,1448,304,1144,24,1120,1,EELV,114,7.825,31.7
2017,ISERE,Autrans-Méaudre en Vercors,1448,304,1144,24,1120,1,FN,150,7.825,31.7
2017,ISERE,Autrans-Méaudre en Vercors,1448,304,1144,24,1120,1,LFI,297,7.825,31.7
2017,ISERE,Autrans-Méaudre en Vercors,1448,304,1144,24,1120,1,LO,10,7.825,31.7
2017,ISERE,Autrans-Méaudre en Vercors,1448,304,1144,24,1120,1,LR,61,7.825,31.7
2017,ISERE,Autrans-Méaudre en Vercors,1448,304,1144,24,1120,1,LREM,361,7.825,31.7
2017,ISERE,Autrans-Méaudre en Vercors,1448,304,1144,24,1120,1,NPA,10,7.825,31.7
2017,ISERE,Autrans-Méaudre en Vercors,1448,304,1144,24,1120,1,PCF,27,7.825,31.7
2017,ISERE,Autrans-Méaudre en Vercors,1448,304,1144,24,1120,1,REC,34,7.825,31.7
2017,ISERE,Autrans-Méaudre en Vercors,1448,304,1144,24,1120,1,RES,22,7.825,31.7
2017,ISERE,Sillans,1450,279,1171,33,1138,1,EELV,44,7.825,31.7
2017,ISERE,Sillans,1450,279,1171,33,1138,1,FN,358,7.825,31.7
2017,ISERE,Sillans,1450,279,1171,33,1138,1,LFI,185,7.825,31.7
2017,ISERE,Sillans,1450,279,1171,33,1138,1,LO,8,7.825,31.7
2017,ISERE,Sillans,1450,279,1171,33,1138,1,LR,45,7.825,31.7
2017,ISERE,Sillans,1450,279,1171,33,1138,1,LREM,289,7.825,31.7
2017,ISERE,Sillans,1450,279,1171,33,1138,1,NPA,7,7.825,31.7
2017,ISERE,Sillans,1450,279,1171,33,1138,1,PCF,28,7.825,31.7
2017,ISERE,Sillans,1450,279,1171,33,1138,1,REC,78,7.825,31.7
2017,ISERE,Sillans,1450,279,1171,33,1138,1,RES,54,7.825,31.7
2017,ISERE,Châtonnay,1457,324,1133,27,1106,1,EELV,33,7.825,31.7
2017,ISERE,Châtonnay,1457,324,1133,27,1106,1,FN,410,7.825,31.7
2017,ISERE,Châtonnay,1457,324,1133,27,1106,1,LFI,139,7.825,31.7
2017,ISERE,Châtonnay,1457,324,1133,27,1106,1,LO,10,7.825,31.7
2017,ISERE,Châtonnay,1457,324,1133,27,1106,1,LR,30,7.825,31.7
2017,ISERE,Châtonnay,1457,324,1133,27,1106,1,LREM,294,7.825,31.7
2017,ISERE,Châtonnay,1457,324,1133,27,1106,1,NPA,11,7.825,31.7
2017,ISERE,Châtonnay,1457,324,1133,27,1106,1,PCF,12,7.825,31.7
2017,ISERE,Châtonnay,1457,324,1133,27,1106,1,REC,89,7.825,31.7
2017,ISERE,Châtonnay,1457,324,1133,27,1106,1,RES,43,7.825,31.7
2017,ISERE,Miribel-les-Echelles,1457,360,1097,21,1076,1,EELV,72,7.825,31.7
2017,ISERE,Miribel-les-Echelles,1457,360,1097,21,1076,1,FN,207,7.825,31.7
2017,ISERE,Miribel-les-Echelles,1457,360,1097,21,1076,1,LFI,241,7.825,31.7
2017,ISERE,Miribel-les-Echelles,1457,360,1097,21,1076,1,LO,6,7.825,31.7
2017,ISERE,Miribel-les-Echelles,1457,360,1097,21,1076,1,LR,39,7.825,31.7
2017,ISERE,Miribel-les-Echelles,1457,360,1097,21,1076,1,LREM,282,7.825,31.7
2017,ISERE,Miribel-les-Echelles,1457,360,1097,21,1076,1,NPA,15,7.825,31.7
2017,ISERE,Miribel-les-Echelles,1457,360,1097,21,1076,1,PCF,22,7.825,31.7
2017,ISERE,Miribel-les-Echelles,1457,360,1097,21,1076,1,REC,79,7.825,31.7
2017,ISERE,Miribel-les-Echelles,1457,360,1097,21,1076,1,RES,48,7.825,31.7
2017,ISERE,Serpaize,1460,223,1237,17,1220,1,EELV,68,7.825,31.7
2017,ISERE,Serpaize,1460,223,1237,17,1220,1,FN,377,7.825,31.7
2017,ISERE,Serpaize,1460,223,1237,17,1220,1,LFI,197,7.825,31.7
2017,ISERE,Serpaize,1460,223,1237,17,1220,1,LO,3,7.825,31.7
2017,ISERE,Serpaize,1460,223,1237,17,1220,1,LR,39,7.825,31.7
2017,ISERE,Serpaize,1460,223,1237,17,1220,1,LREM,321,7.825,31.7
2017,ISERE,Serpaize,1460,223,1237,17,1220,1,NPA,9,7.825,31.7
2017,ISERE,Serpaize,1460,223,1237,17,1220,1,PCF,20,7.825,31.7
2017,ISERE,Serpaize,1460,223,1237,17,1220,1,REC,103,7.825,31.7
2017,ISERE,Serpaize,1460,223,1237,17,1220,1,RES,35,7.825,31.7
2017,ISERE,Voiron,1462,301,1161,23,1138,1,EELV,80,7.825,31.7
2017,ISERE,Voiron,1462,301,1161,23,1138,1,FN,198,7.825,31.7
2017,ISERE,Voiron,1462,301,1161,23,1138,1,LFI,248,7.825,31.7
2017,ISERE,Voiron,1462,301,1161,23,1138,1,LO,3,7.825,31.7
2017,ISERE,Voiron,1462,301,1161,23,1138,1,LR,68,7.825,31.7
2017,ISERE,Voiron,1462,301,1161,23,1138,1,LREM,357,7.825,31.7
2017,ISERE,Voiron,1462,301,1161,23,1138,1,NPA,6,7.825,31.7
2017,ISERE,Voiron,1462,301,1161,23,1138,1,PCF,27,7.825,31.7
2017,ISERE,Voiron,1462,301,1161,23,1138,1,REC,79,7.825,31.7
2017,ISERE,Voiron,1462,301,1161,23,1138,1,RES,22,7.825,31.7
2017,ISERE,Villette-de-Vienne,1465,216,1249,28,1221,1,EELV,58,7.825,31.7
2017,ISERE,Villette-de-Vienne,1465,216,1249,28,1221,1,FN,344,7.825,31.7
2017,ISERE,Villette-de-Vienne,1465,216,1249,28,1221,1,LFI,151,7.825,31.7
2017,ISERE,Villette-de-Vienne,1465,216,1249,28,1221,1,LO,2,7.825,31.7
2017,ISERE,Villette-de-Vienne,1465,216,1249,28,1221,1,LR,63,7.825,31.7
2017,ISERE,Villette-de-Vienne,1465,216,1249,28,1221,1,LREM,379,7.825,31.7
2017,ISERE,Villette-de-Vienne,1465,216,1249,28,1221,1,NPA,9,7.825,31.7
2017,ISERE,Villette-de-Vienne,1465,216,1249,28,1221,1,PCF,20,7.825,31.7
2017,ISERE,Villette-de-Vienne,1465,216,1249,28,1221,1,REC,110,7.825,31.7
2017,ISERE,Villette-de-Vienne,1465,216,1249,28,1221,1,RES,42,7.825,31.7
2017,ISERE,Villefontaine,1466,661,805,13,792,1,EELV,10,7.825,31.7
2017,ISERE,Villefontaine,1466,661,805,13,792,1,FN,178,7.825,31.7
2017,ISERE,Villefontaine,1466,661,805,13,792,1,LFI,378,7.825,31.7
2017,ISERE,Villefontaine,1466,661,805,13,792,1,LO,13,7.825,31.7
2017,ISERE,Villefontaine,1466,661,805,13,792,1,LR,16,7.825,31.7
2017,ISERE,Villefontaine,1466,661,805,13,792,1,LREM,108,7.825,31.7
2017,ISERE,Villefontaine,1466,661,805,13,792,1,NPA,5,7.825,31.7
2017,ISERE,Villefontaine,1466,661,805,13,792,1,PCF,14,7.825,31.7
2017,ISERE,Villefontaine,1466,661,805,13,792,1,REC,37,7.825,31.7
2017,ISERE,Villefontaine,1466,661,805,13,792,1,RES,12,7.825,31.7
2017,ISERE,La Chapelle-de-la-Tour,1497,259,1238,27,1211,1,EELV,41,7.825,31.7
2017,ISERE,La Chapelle-de-la-Tour,1497,259,1238,27,1211,1,FN,388,7.825,31.7
2017,ISERE,La Chapelle-de-la-Tour,1497,259,1238,27,1211,1,LFI,181,7.825,31.7
2017,ISERE,La Chapelle-de-la-Tour,1497,259,1238,27,1211,1,LO,8,7.825,31.7
2017,ISERE,La Chapelle-de-la-Tour,1497,259,1238,27,1211,1,LR,69,7.825,31.7
2017,ISERE,La Chapelle-de-la-Tour,1497,259,1238,27,1211,1,LREM,329,7.825,31.7
2017,ISERE,La Chapelle-de-la-Tour,1497,259,1238,27,1211,1,NPA,6,7.825,31.7
2017,ISERE,La Chapelle-de-la-Tour,1497,259,1238,27,1211,1,PCF,19,7.825,31.7
2017,ISERE,La Chapelle-de-la-Tour,1497,259,1238,27,1211,1,REC,100,7.825,31.7
2017,ISERE,La Chapelle-de-la-Tour,1497,259,1238,27,1211,1,RES,31,7.825,31.7
2017,ISERE,La Murette,1510,261,1249,30,1219,1,EELV,95,7.825,31.7
2017,ISERE,La Murette,1510,261,1249,30,1219,1,FN,214,7.825,31.7
2017,ISERE,La Murette,1510,261,1249,30,1219,1,LFI,205,7.825,31.7
2017,ISERE,La Murette,1510,261,1249,30,1219,1,LO,7,7.825,31.7
2017,ISERE,La Murette,1510,261,1249,30,1219,1,LR,60,7.825,31.7
2017,ISERE,La Murette,1510,261,1249,30,1219,1,LREM,442,7.825,31.7
2017,ISERE,La Murette,1510,261,1249,30,1219,1,NPA,2,7.825,31.7
2017,ISERE,La Murette,1510,261,1249,30,1219,1,PCF,24,7.825,31.7
2017,ISERE,La Murette,1510,261,1249,30,1219,1,REC,79,7.825,31.7
2017,ISERE,La Murette,1510,261,1249,30,1219,1,RES,28,7.825,31.7
2017,ISERE,Sablons,1514,352,1162,21,1141,1,EELV,28,7.825,31.7
2017,ISERE,Sablons,1514,352,1162,21,1141,1,FN,401,7.825,31.7
2017,ISERE,Sablons,1514,352,1162,21,1141,1,LFI,186,7.825,31.7
2017,ISERE,Sablons,1514,352,1162,21,1141,1,LO,5,7.825,31.7
2017,ISERE,Sablons,1514,352,1162,21,1141,1,LR,43,7.825,31.7
2017,ISERE,Sablons,1514,352,1162,21,1141,1,LREM,268,7.825,31.7
2017,ISERE,Sablons,1514,352,1162,21,1141,1,NPA,9,7.825,31.7
2017,ISERE,Sablons,1514,352,1162,21,1141,1,PCF,26,7.825,31.7
2017,ISERE,Sablons,1514,352,1162,21,1141,1,REC,88,7.825,31.7
2017,ISERE,Sablons,1514,352,1162,21,1141,1,RES,38,7.825,31.7
2017,ISERE,Vizille,1520,491,1029,27,1002,1,EELV,42,7.825,31.7
2017,ISERE,Vizille,1520,491,1029,27,1002,1,FN,234,7.825,31.7
2017,ISERE,Vizille,1520,491,1029,27,1002,1,LFI,272,7.825,31.7
2017,ISERE,Vizille,1520,491,1029,27,1002,1,LO,8,7.825,31.7
2017,ISERE,Vizille,1520,491,1029,27,1002,1,LR,25,7.825,31.7
2017,ISERE,Vizille,1520,491,1029,27,1002,1,LREM,266,7.825,31.7
2017,ISERE,Vizille,1520,491,1029,27,1002,1,NPA,10,7.825,31.7
2017,ISERE,Vizille,1520,491,1029,27,1002,1,PCF,40,7.825,31.7
2017,ISERE,Vizille,1520,491,1029,27,1002,1,REC,55,7.825,31.7
2017,ISERE,Vizille,1520,491,1029,27,1002,1,RES,15,7.825,31.7
2017,ISERE,L'Isle-d'Abeau,1539,559,980,13,967,1,EELV,30,7.825,31.7
2017,ISERE,L'Isle-d'Abeau,1539,559,980,13,967,1,FN,262,7.825,31.7
2017,ISERE,L'Isle-d'Abeau,1539,559,980,13,967,1,LFI,354,7.825,31.7
2017,ISERE,L'Isle-d'Abeau,1539,559,980,13,967,1,LO,6,7.825,31.7
2017,ISERE,L'Isle-d'Abeau,1539,559,980,13,967,1,LR,22,7.825,31.7
2017,ISERE,L'Isle-d'Abeau,1539,559,980,13,967,1,LREM,164,7.825,31.7
2017,ISERE,L'Isle-d'Abeau,1539,559,980,13,967,1,NPA,3,7.825,31.7
2017,ISERE,L'Isle-d'Abeau,1539,559,980,13,967,1,PCF,14,7.825,31.7
2017,ISERE,L'Isle-d'Abeau,1539,559,980,13,967,1,REC,63,7.825,31.7
2017,ISERE,L'Isle-d'Abeau,1539,559,980,13,967,1,RES,16,7.825,31.7
2017,ISERE,Charavines,1542,351,1191,24,1167,1,EELV,75,7.825,31.7
2017,ISERE,Charavines,1542,351,1191,24,1167,1,FN,302,7.825,31.7
2017,ISERE,Charavines,1542,351,1191,24,1167,1,LFI,244,7.825,31.7
2017,ISERE,Charavines,1542,351,1191,24,1167,1,LO,10,7.825,31.7
2017,ISERE,Charavines,1542,351,1191,24,1167,1,LR,38,7.825,31.7
2017,ISERE,Charavines,1542,351,1191,24,1167,1,LREM,311,7.825,31.7
2017,ISERE,Charavines,1542,351,1191,24,1167,1,NPA,11,7.825,31.7
2017,ISERE,Charavines,1542,351,1191,24,1167,1,PCF,25,7.825,31.7
2017,ISERE,Charavines,1542,351,1191,24,1167,1,REC,78,7.825,31.7
2017,ISERE,Charavines,1542,351,1191,24,1167,1,RES,33,7.825,31.7
2017,ISERE,L'Isle-d'Abeau,1547,308,1239,23,1216,1,EELV,102,7.825,31.7
2017,ISERE,L'Isle-d'Abeau,1547,308,1239,23,1216,1,FN,212,7.825,31.7
2017,ISERE,L'Isle-d'Abeau,1547,308,1239,23,1216,1,LFI,237,7.825,31.7
2017,ISERE,L'Isle-d'Abeau,1547,308,1239,23,1216,1,LO,6,7.825,31.7
2017,ISERE,L'Isle-d'Abeau,1547,308,1239,23,1216,1,LR,42,7.825,31.7
2017,ISERE,L'Isle-d'Abeau,1547,308,1239,23,1216,1,LREM,426,7.825,31.7
2017,ISERE,L'Isle-d'Abeau,1547,308,1239,23,1216,1,NPA,1,7.825,31.7
2017,ISERE,L'Isle-d'Abeau,1547,308,1239,23,1216,1,PCF,9,7.825,31.7
2017,ISERE,L'Isle-d'Abeau,1547,308,1239,23,1216,1,REC,98,7.825,31.7
2017,ISERE,L'Isle-d'Abeau,1547,308,1239,23,1216,1,RES,31,7.825,31.7
2017,ISERE,Vaulnaveys-le-Haut,1582,302,1280,29,1251,1,EELV,112,7.825,31.7
2017,ISERE,Vaulnaveys-le-Haut,1582,302,1280,29,1251,1,FN,263,7.825,31.7
2017,ISERE,Vaulnaveys-le-Haut,1582,302,1280,29,1251,1,LFI,211,7.825,31.7
2017,ISERE,Vaulnaveys-le-Haut,1582,302,1280,29,1251,1,LO,3,7.825,31.7
2017,ISERE,Vaulnaveys-le-Haut,1582,302,1280,29,1251,1,LR,63,7.825,31.7
2017,ISERE,Vaulnaveys-le-Haut,1582,302,1280,29,1251,1,LREM,391,7.825,31.7
2017,ISERE,Vaulnaveys-le-Haut,1582,302,1280,29,1251,1,NPA,7,7.825,31.7
2017,ISERE,Vaulnaveys-le-Haut,1582,302,1280,29,1251,1,PCF,24,7.825,31.7
2017,ISERE,Vaulnaveys-le-Haut,1582,302,1280,29,1251,1,REC,95,7.825,31.7
2017,ISERE,Vaulnaveys-le-Haut,1582,302,1280,29,1251,1,RES,35,7.825,31.7
2017,ISERE,Voiron,1616,442,1174,23,1151,1,EELV,75,7.825,31.7
2017,ISERE,Voiron,1616,442,1174,23,1151,1,FN,175,7.825,31.7
2017,ISERE,Voiron,1616,442,1174,23,1151,1,LFI,256,7.825,31.7
2017,ISERE,Voiron,1616,442,1174,23,1151,1,LO,6,7.825,31.7
2017,ISERE,Voiron,1616,442,1174,23,1151,1,LR,52,7.825,31.7
2017,ISERE,Voiron,1616,442,1174,23,1151,1,LREM,421,7.825,31.7
2017,ISERE,Voiron,1616,442,1174,23,1151,1,NPA,4,7.825,31.7
2017,ISERE,Voiron,1616,442,1174,23,1151,1,PCF,20,7.825,31.7
2017,ISERE,Voiron,1616,442,1174,23,1151,1,REC,76,7.825,31.7
2017,ISERE,Voiron,1616,442,1174,23,1151,1,RES,11,7.825,31.7
2017,ISERE,L'Isle-d'Abeau,1618,411,1207,22,1185,1,EELV,51,7.825,31.7
2017,ISERE,L'Isle-d'Abeau,1618,411,1207,22,1185,1,FN,346,7.825,31.7
2017,ISERE,L'Isle-d'Abeau,1618,411,1207,22,1185,1,LFI,271,7.825,31.7
2017,ISERE,L'Isle-d'Abeau,1618,411,1207,22,1185,1,LO,6,7.825,31.7
2017,ISERE,L'Isle-d'Abeau,1618,411,1207,22,1185,1,LR,52,7.825,31.7
2017,ISERE,L'Isle-d'Abeau,1618,411,1207,22,1185,1,LREM,290,7.825,31.7
2017,ISERE,L'Isle-d'Abeau,1618,411,1207,22,1185,1,NPA,12,7.825,31.7
2017,ISERE,L'Isle-d'Abeau,1618,411,1207,22,1185,1,PCF,24,7.825,31.7
2017,ISERE,L'Isle-d'Abeau,1618,411,1207,22,1185,1,REC,79,7.825,31.7
2017,ISERE,L'Isle-d'Abeau,1618,411,1207,22,1185,1,RES,22,7.825,31.7
2017,ISERE,Brézins,1624,425,1199,20,1179,1,EELV,57,7.825,31.7
2017,ISERE,Brézins,1624,425,1199,20,1179,1,FN,339,7.825,31.7
2017,ISERE,Brézins,1624,425,1199,20,1179,1,LFI,212,7.825,31.7
2017,ISERE,Brézins,1624,425,1199,20,1179,1,LO,10,7.825,31.7
2017,ISERE,Brézins,1624,425,1199,20,1179,1,LR,49,7.825,31.7
2017,ISERE,Brézins,1624,425,1199,20,1179,1,LREM,277,7.825,31.7
2017,ISERE,Brézins,1624,425,1199,20,1179,1,NPA,10,7.825,31.7
2017,ISERE,Brézins,1624,425,1199,20,1179,1,PCF,18,7.825,31.7
2017,ISERE,Brézins,1624,425,1199,20,1179,1,REC,87,7.825,31.7
2017,ISERE,Brézins,1624,425,1199,20,1179,1,RES,51,7.825,31.7
2017,ISERE,Saint-Alban-de-Roche,1634,330,1304,33,1271,1,EELV,83,7.825,31.7
2017,ISERE,Saint-Alban-de-Roche,1634,330,1304,33,1271,1,FN,250,7.825,31.7
2017,ISERE,Saint-Alban-de-Roche,1634,330,1304,33,1271,1,LFI,198,7.825,31.7
2017,ISERE,Saint-Alban-de-Roche,1634,330,1304,33,1271,1,LO,5,7.825,31.7
2017,ISERE,Saint-Alban-de-Roche,1634,330,1304,33,1271,1,LR,80,7.825,31.7
2017,ISERE,Saint-Alban-de-Roche,1634,330,1304,33,1271,1,LREM,416,7.825,31.7
2017,ISERE,Saint-Alban-de-Roche,1634,330,1304,33,1271,1,NPA,6,7.825,31.7
2017,ISERE,Saint-Alban-de-Roche,1634,330,1304,33,1271,1,PCF,23,7.825,31.7
2017,ISERE,Saint-Alban-de-Roche,1634,330,1304,33,1271,1,REC,116,7.825,31.7
2017,ISERE,Saint-Alban-de-Roche,1634,330,1304,33,1271,1,RES,33,7.825,31.7
2017,ISERE,Les Côtes-d'Arey,1677,306,1371,28,1343,1,EELV,79,7.825,31.7
2017,ISERE,Les Côtes-d'Arey,1677,306,1371,28,1343,1,FN,345,7.825,31.7
2017,ISERE,Les Côtes-d'Arey,1677,306,1371,28,1343,1,LFI,187,7.825,31.7
2017,ISERE,Les Côtes-d'Arey,1677,306,1371,28,1343,1,LO,5,7.825,31.7
2017,ISERE,Les Côtes-d'Arey,1677,306,1371,28,1343,1,LR,76,7.825,31.7
2017,ISERE,Les Côtes-d'Arey,1677,306,1371,28,1343,1,LREM,427,7.825,31.7
2017,ISERE,Les Côtes-d'Arey,1677,306,1371,28,1343,1,NPA,4,7.825,31.7
2017,ISERE,Les Côtes-d'Arey,1677,306,1371,28,1343,1,PCF,14,7.825,31.7
2017,ISERE,Les Côtes-d'Arey,1677,306,1371,28,1343,1,REC,115,7.825,31.7
2017,ISERE,Les Côtes-d'Arey,1677,306,1371,28,1343,1,RES,40,7.825,31.7
2017,ISERE,Villefontaine,1712,564,1148,18,1130,1,EELV,47,7.825,31.7
2017,ISERE,Villefontaine,1712,564,1148,18,1130,1,FN,297,7.825,31.7
2017,ISERE,Villefontaine,1712,564,1148,18,1130,1,LFI,390,7.825,31.7
2017,ISERE,Villefontaine,1712,564,1148,18,1130,1,LO,3,7.825,31.7
2017,ISERE,Villefontaine,1712,564,1148,18,1130,1,LR,36,7.825,31.7
2017,ISERE,Villefontaine,1712,564,1148,18,1130,1,LREM,209,7.825,31.7
2017,ISERE,Villefontaine,1712,564,1148,18,1130,1,NPA,5,7.825,31.7
2017,ISERE,Villefontaine,1712,564,1148,18,1130,1,PCF,16,7.825,31.7
2017,ISERE,Villefontaine,1712,564,1148,18,1130,1,REC,55,7.825,31.7
2017,ISERE,Villefontaine,1712,564,1148,18,1130,1,RES,26,7.825,31.7
2017,ISERE,Saint-Clair-de-la-Tour,1714,428,1286,27,1259,1,EELV,48,7.825,31.7
2017,ISERE,Saint-Clair-de-la-Tour,1714,428,1286,27,1259,1,FN,400,7.825,31.7
2017,ISERE,Saint-Clair-de-la-Tour,1714,428,1286,27,1259,1,LFI,227,7.825,31.7
2017,ISERE,Saint-Clair-de-la-Tour,1714,428,1286,27,1259,1,LO,10,7.825,31.7
2017,ISERE,Saint-Clair-de-la-Tour,1714,428,1286,27,1259,1,LR,44,7.825,31.7
2017,ISERE,Saint-Clair-de-la-Tour,1714,428,1286,27,1259,1,LREM,310,7.825,31.7
2017,ISERE,Saint-Clair-de-la-Tour,1714,428,1286,27,1259,1,NPA,5,7.825,31.7
2017,ISERE,Saint-Clair-de-la-Tour,1714,428,1286,27,1259,1,PCF,25,7.825,31.7
2017,ISERE,Saint-Clair-de-la-Tour,1714,428,1286,27,1259,1,REC,97,7.825,31.7
2017,ISERE,Saint-Clair-de-la-Tour,1714,428,1286,27,1259,1,RES,35,7.825,31.7
2017,ISERE,Corbelin,1843,376,1467,30,1437,1,EELV,65,7.825,31.7
2017,ISERE,Corbelin,1843,376,1467,30,1437,1,FN,470,7.825,31.7
2017,ISERE,Corbelin,1843,376,1467,30,1437,1,LFI,235,7.825,31.7
2017,ISERE,Corbelin,1843,376,1467,30,1437,1,LO,8,7.825,31.7
2017,ISERE,Corbelin,1843,376,1467,30,1437,1,LR,68,7.825,31.7
2017,ISERE,Corbelin,1843,376,1467,30,1437,1,LREM,324,7.825,31.7
2017,ISERE,Corbelin,1843,376,1467,30,1437,1,NPA,17,7.825,31.7
2017,ISERE,Corbelin,1843,376,1467,30,1437,1,PCF,31,7.825,31.7
2017,ISERE,Corbelin,1843,376,1467,30,1437,1,REC,112,7.825,31.7
2017,ISERE,Corbelin,1843,376,1467,30,1437,1,RES,49,7.825,31.7
2017,ISERE,Goncelin,1913,407,1506,30,1476,1,EELV,95,7.825,31.7
2017,ISERE,Goncelin,1913,407,1506,30,1476,1,FN,350,7.825,31.7
2017,ISERE,Goncelin,1913,407,1506,30,1476,1,LFI,315,7.825,31.7
2017,ISERE,Goncelin,1913,407,1506,30,1476,1,LO,5,7.825,31.7
2017,ISERE,Goncelin,1913,407,1506,30,1476,1,LR,61,7.825,31.7
2017,ISERE,Goncelin,1913,407,1506,30,1476,1,LREM,407,7.825,31.7
2017,ISERE,Goncelin,1913,407,1506,30,1476,1,NPA,6,7.825,31.7
2017,ISERE,Goncelin,1913,407,1506,30,1476,1,PCF,44,7.825,31.7
2017,ISERE,Goncelin,1913,407,1506,30,1476,1,REC,94,7.825,31.7
2017,ISERE,Goncelin,1913,407,1506,30,1476,1,RES,37,7.825,31.7
2017,ISERE,Montalieu-Vercieu,2132,654,1478,29,1449,1,EELV,31,7.825,31.7
2017,ISERE,Montalieu-Vercieu,2132,654,1478,29,1449,1,FN,579,7.825,31.7
2017,ISERE,Montalieu-Vercieu,2132,654,1478,29,1449,1,LFI,239,7.825,31.7
2017,ISERE,Montalieu-Vercieu,2132,654,1478,29,1449,1,LO,9,7.825,31.7
2017,ISERE,Montalieu-Vercieu,2132,654,1478,29,1449,1,LR,49,7.825,31.7
2017,ISERE,Montalieu-Vercieu,2132,654,1478,29,1449,1,LREM,310,7.825,31.7
2017,ISERE,Montalieu-Vercieu,2132,654,1478,29,1449,1,NPA,12,7.825,31.7
2017,ISERE,Montalieu-Vercieu,2132,654,1478,29,1449,1,PCF,28,7.825,31.7
2017,ISERE,Montalieu-Vercieu,2132,654,1478,29,1449,1,REC,100,7.825,31.7
2017,ISERE,Montalieu-Vercieu,2132,654,1478,29,1449,1,RES,37,7.825,31.7
2017,Isère,Monestier-d'Ambel,22,5,17,2,15,2,FN,5,7.825,31.7
2017,Isère,Monestier-d'Ambel,22,5,17,2,15,2,LREM,10,7.825,31.7
2017,Isère,Ambel,33,6,27,1,26,2,FN,10,7.825,31.7
2017,Isère,Ambel,33,6,27,1,26,2,LREM,16,7.825,31.7
2017,Isère,Beaufin,34,1,33,7,26,2,FN,12,7.825,31.7
2017,Isère,Beaufin,34,1,33,7,26,2,LREM,14,7.825,31.7
2017,Isère,Villard-Reymond,34,4,30,7,23,2,FN,6,7.825,31.7
2017,Isère,Villard-Reymond,34,4,30,7,23,2,LREM,17,7.825,31.7
2017,Isère,Villard-Notre-Dame,38,5,33,3,30,2,FN,6,7.825,31.7
2017,Isère,Villard-Notre-Dame,38,5,33,3,30,2,LREM,24,7.825,31.7
2017,Isère,Oulles,39,9,30,4,26,2,FN,18,7.825,31.7
2017,Isère,Oulles,39,9,30,4,26,2,LREM,8,7.825,31.7
2017,Isère,Cognet,41,8,33,7,26,2,FN,15,7.825,31.7
2017,Isère,Cognet,41,8,33,7,26,2,LREM,11,7.825,31.7
2017,Isère,Sainte-Luce,55,16,39,4,35,2,FN,13,7.825,31.7
2017,Isère,Sainte-Luce,55,16,39,4,35,2,LREM,22,7.825,31.7
2017,Isère,La Valette,62,12,50,7,43,2,FN,18,7.825,31.7
2017,Isère,La Valette,62,12,50,7,43,2,LREM,25,7.825,31.7
2017,Isère,Malleval-en-Vercors,63,10,53,4,49,2,FN,15,7.825,31.7
2017,Isère,Malleval-en-Vercors,63,10,53,4,49,2,LREM,34,7.825,31.7
2017,Isère,Saint-Michel-en-Beaumont,65,14,51,1,50,2,FN,20,7.825,31.7
2017,Isère,Saint-Michel-en-Beaumont,65,14,51,1,50,2,LREM,30,7.825,31.7
2017,Isère,Marcieu,68,6,62,7,55,2,FN,31,7.825,31.7
2017,Isère,Marcieu,68,6,62,7,55,2,LREM,24,7.825,31.7
2017,Isère,Saint-Arey,75,8,67,13,54,2,FN,21,7.825,31.7
2017,Isère,Saint-Arey,75,8,67,13,54,2,LREM,33,7.825,31.7
2017,Isère,Quincieu,76,15,61,11,50,2,FN,37,7.825,31.7
2017,Isère,Quincieu,76,15,61,11,50,2,LREM,13,7.825,31.7
2017,Isère,Bressieux,81,12,69,13,56,2,FN,15,7.825,31.7
2017,Isère,Bressieux,81,12,69,13,56,2,LREM,41,7.825,31.7
2017,Isère,Quet-en-Beaumont,83,22,61,8,53,2,FN,22,7.825,31.7
2017,Isère,Quet-en-Beaumont,83,22,61,8,53,2,LREM,31,7.825,31.7
2017,Isère,Beauvoir-en-Royans,85,13,72,14,58,2,FN,26,7.825,31.7
2017,Isère,Beauvoir-en-Royans,85,13,72,14,58,2,LREM,32,7.825,31.7
2017,Isère,Mont-Saint-Martin,90,14,76,17,59,2,FN,19,7.825,31.7
2017,Isère,Mont-Saint-Martin,90,14,76,17,59,2,LREM,40,7.825,31.7
2017,Isère,Mayres-Savel,91,27,64,10,54,2,FN,22,7.825,31.7
2017,Isère,Mayres-Savel,91,27,64,10,54,2,LREM,32,7.825,31.7
2017,Isère,Montfalcon,94,8,86,9,77,2,FN,39,7.825,31.7
2017,Isère,Montfalcon,94,8,86,9,77,2,LREM,38,7.825,31.7
2017,Isère,Bessins,95,16,79,6,73,2,FN,28,7.825,31.7
2017,Isère,Bessins,95,16,79,6,73,2,LREM,45,7.825,31.7
2017,Isère,Villard-Reculas,95,18,77,9,68,2,FN,9,7.825,31.7
2017,Isère,Villard-Reculas,95,18,77,9,68,2,LREM,59,7.825,31.7
2017,Isère,Châtelus,96,16,80,10,70,2,FN,52,7.825,31.7
2017,Isère,Châtelus,96,16,80,10,70,2,LREM,18,7.825,31.7
2017,Isère,Les Côtes-de-Corps,98,19,79,15,64,2,FN,19,7.825,31.7
2017,Isère,Les Côtes-de-Corps,98,19,79,15,64,2,LREM,45,7.825,31.7
2017,Isère,Oris-en-Rattier,102,31,71,13,58,2,FN,15,7.825,31.7
2017,Isère,Oris-en-Rattier,102,31,71,13,58,2,LREM,43,7.825,31.7
2017,Isère,Presles,106,28,78,19,59,2,FN,27,7.825,31.7
2017,Isère,Presles,106,28,78,19,59,2,LREM,32,7.825,31.7
2017,Isère,La Garde,108,25,83,14,69,2,FN,29,7.825,31.7
2017,Isère,La Garde,108,25,83,14,69,2,LREM,40,7.825,31.7
2017,Isère,Siévoz,110,15,95,18,77,2,FN,32,7.825,31.7
2017,Isère,Siévoz,110,15,95,18,77,2,LREM,45,7.825,31.7
2017,Isère,Clavans-en-Haut-Oisans,114,24,90,12,78,2,FN,31,7.825,31.7
2017,Isère,Clavans-en-Haut-Oisans,114,24,90,12,78,2,LREM,47,7.825,31.7
2017,Isère,Saint-Andéol,115,19,96,13,83,2,FN,20,7.825,31.7
2017,Isère,Saint-Andéol,115,19,96,13,83,2,LREM,63,7.825,31.7
2017,Isère,Blandin,118,25,93,6,87,2,FN,48,7.825,31.7
2017,Isère,Blandin,118,25,93,6,87,2,LREM,39,7.825,31.7
2017,Isère,Saint-Julien-de-l'Herms,121,29,92,7,85,2,FN,53,7.825,31.7
2017,Isère,Saint-Julien-de-l'Herms,121,29,92,7,85,2,LREM,32,7.825,31.7
2017,Isère,Brion,121,30,91,13,78,2,FN,44,7.825,31.7
2017,Isère,Brion,121,30,91,13,78,2,LREM,34,7.825,31.7
2017,Isère,Marnans,121,31,90,12,78,2,FN,45,7.825,31.7
2017,Isère,Marnans,121,31,90,12,78,2,LREM,33,7.825,31.7
2017,Isère,Saint-Christophe-en-Oisans,123,32,91,18,73,2,FN,15,7.825,31.7
2017,Isère,Saint-Christophe-en-Oisans,123,32,91,18,73,2,LREM,58,7.825,31.7
2017,Isère,Choranche,128,25,103,12,91,2,FN,49,7.825,31.7
2017,Isère,Choranche,128,25,103,12,91,2,LREM,42,7.825,31.7
2017,Isère,Percy,131,26,105,21,84,2,FN,25,7.825,31.7
2017,Isère,Percy,131,26,105,21,84,2,LREM,59,7.825,31.7
2017,Isère,Saint-Pierre-de-Méaroz,131,40,91,7,84,2,FN,53,7.825,31.7
2017,Isère,Saint-Pierre-de-Méaroz,131,40,91,7,84,2,LREM,31,7.825,31.7
2017,Isère,Chalon,135,16,119,6,113,2,FN,70,7.825,31.7
2017,Isère,Chalon,135,16,119,6,113,2,LREM,43,7.825,31.7
2017,Isère,La Salette-Fallavaux,137,41,96,9,87,2,FN,41,7.825,31.7
2017,Isère,La Salette-Fallavaux,137,41,96,9,87,2,LREM,46,7.825,31.7
2017,Isère,Saint-Maurice-en-Trièves,143,30,113,14,99,2,FN,55,7.825,31.7
2017,Isère,Saint-Maurice-en-Trièves,143,30,113,14,99,2,LREM,44,7.825,31.7
2017,Isère,Sousville,144,27,117,18,99,2,FN,52,7.825,31.7
2017,Isère,Sousville,144,27,117,18,99,2,LREM,47,7.825,31.7
2017,Isère,Besse,149,37,112,8,104,2,FN,37,7.825,31.7
2017,Isère,Besse,149,37,112,8,104,2,LREM,67,7.825,31.7
2017,Isère,Lavars,149,39,110,20,90,2,FN,40,7.825,31.7
2017,Isère,Lavars,149,39,110,20,90,2,LREM,50,7.825,31.7
2017,Isère,Saint-Martin-de-Clelles,153,24,129,16,113,2,FN,34,7.825,31.7
2017,Isère,Saint-Martin-de-Clelles,153,24,129,16,113,2,LREM,79,7.825,31.7
2017,Isère,Lavaldens,157,30,127,14,113,2,FN,49,7.825,31.7
2017,Isère,Lavaldens,157,30,127,14,113,2,LREM,64,7.825,31.7
2017,Isère,Cornillon-en-Trièves,161,24,137,16,121,2,FN,38,7.825,31.7
2017,Isère,Cornillon-en-Trièves,161,24,137,16,121,2,LREM,83,7.825,31.7
2017,Isère,Hurtières,163,33,130,14,116,2,FN,48,7.825,31.7
2017,Isère,Hurtières,163,33,130,14,116,2,LREM,68,7.825,31.7
2017,Isère,Prébois,163,51,112,13,99,2,FN,31,7.825,31.7
2017,Isère,Prébois,163,51,112,13,99,2,LREM,68,7.825,31.7
2017,Isère,Ornon,170,36,134,18,116,2,FN,26,7.825,31.7
2017,Isère,Ornon,170,36,134,18,116,2,LREM,90,7.825,31.7
2017,Isère,Mizoën,177,41,136,23,113,2,FN,50,7.825,31.7
2017,Isère,Mizoën,177,41,136,23,113,2,LREM,63,7.825,31.7
2017,Isère,Sainte-Marie-du-Mont,184,32,152,22,130,2,FN,39,7.825,31.7
2017,Isère,Sainte-Marie-du-Mont,184,32,152,22,130,2,LREM,91,7.825,31.7
2017,Isère,Pellafol,184,65,119,16,103,2,FN,42,7.825,31.7
2017,Isère,Pellafol,184,65,119,16,103,2,LREM,61,7.825,31.7
2017,Isère,Saint-Guillaume,189,22,167,20,147,2,FN,66,7.825,31.7
2017,Isère,Saint-Guillaume,189,22,167,20,147,2,LREM,81,7.825,31.7
2017,Isère,Voissant,189,41,148,14,134,2,FN,63,7.825,31.7
2017,Isère,Voissant,189,41,148,14,134,2,LREM,71,7.825,31.7
2017,Isère,Sarcenas,190,30,160,18,142,2,FN,33,7.825,31.7
2017,Isère,Sarcenas,190,30,160,18,142,2,LREM,109,7.825,31.7
2017,Isère,Lalley,192,55,137,22,115,2,FN,25,7.825,31.7
2017,Isère,Lalley,192,55,137,22,115,2,LREM,90,7.825,31.7
2017,Isère,Avignonet,195,42,153,21,132,2,FN,35,7.825,31.7
2017,Isère,Avignonet,195,42,153,21,132,2,LREM,97,7.825,31.7
2017,Isère,Entraigues,195,51,144,14,130,2,FN,64,7.825,31.7
2017,Isère,Entraigues,195,51,144,14,130,2,LREM,66,7.825,31.7
2017,Isère,La Morte,200,59,141,16,125,2,FN,45,7.825,31.7
2017,Isère,La Morte,200,59,141,16,125,2,LREM,80,7.825,31.7
2017,Isère,Tréminis,204,41,163,36,127,2,FN,54,7.825,31.7
2017,Isère,Tréminis,204,41,163,36,127,2,LREM,73,7.825,31.7
2017,Isère,Chassignieu,206,39,167,19,148,2,FN,87,7.825,31.7
2017,Isère,Chassignieu,206,39,167,19,148,2,LREM,61,7.825,31.7
2017,Isère,Valjouffrey,210,52,158,20,138,2,FN,41,7.825,31.7
2017,Isère,Valjouffrey,210,52,158,20,138,2,LREM,97,7.825,31.7
2017,Isère,Saint-Clair-sur-Galaure,212,46,166,13,153,2,FN,62,7.825,31.7
2017,Isère,Saint-Clair-sur-Galaure,212,46,166,13,153,2,LREM,91,7.825,31.7
2017,Isère,Le Moutaret,212,53,159,18,141,2,FN,60,7.825,31.7
2017,Isère,Le Moutaret,212,53,159,18,141,2,LREM,81,7.825,31.7
2017,Isère,Plan,213,39,174,19,155,2,FN,83,7.825,31.7
2017,Isère,Plan,213,39,174,19,155,2,LREM,72,7.825,31.7
2017,Isère,Vernas,213,50,163,13,150,2,FN,84,7.825,31.7
2017,Isère,Vernas,213,50,163,13,150,2,LREM,66,7.825,31.7
2017,Isère,Le Freney-d'Oisans,215,66,149,4,145,2,FN,66,7.825,31.7
2017,Isère,Le Freney-d'Oisans,215,66,149,4,145,2,LREM,79,7.825,31.7
2017,Isère,Lentiol,216,38,178,18,160,2,FN,77,7.825,31.7
2017,Isère,Lentiol,216,38,178,18,160,2,LREM,83,7.825,31.7
2017,Isère,Treffort,218,44,174,21,153,2,FN,55,7.825,31.7
2017,Isère,Treffort,218,44,174,21,153,2,LREM,98,7.825,31.7
2017,Isère,Chantepérier,218,47,171,26,145,2,FN,62,7.825,31.7
2017,Isère,Chantepérier,218,47,171,26,145,2,LREM,83,7.825,31.7
2017,Isère,Saint-Paul-lès-Monestier,222,37,185,20,165,2,FN,63,7.825,31.7
2017,Isère,Saint-Paul-lès-Monestier,222,37,185,20,165,2,LREM,102,7.825,31.7
2017,Isère,Ponsonnas,234,40,194,23,171,2,FN,61,7.825,31.7
2017,Isère,Ponsonnas,234,40,194,23,171,2,LREM,110,7.825,31.7
2017,Isère,Le Monestier-du-Percy,237,48,189,32,157,2,FN,45,7.825,31.7
2017,Isère,Le Monestier-du-Percy,237,48,189,32,157,2,LREM,112,7.825,31.7
2017,Isère,Auris,237,69,168,14,154,2,FN,59,7.825,31.7
2017,Isère,Auris,237,69,168,14,154,2,LREM,95,7.825,31.7
2017,Isère,Saint-Jean-le-Vieux,238,41,197,14,183,2,FN,54,7.825,31.7
2017,Isère,Saint-Jean-le-Vieux,238,41,197,14,183,2,LREM,129,7.825,31.7
2017,Isère,Saint-Didier-de-Bizonnes,238,42,196,27,169,2,FN,98,7.825,31.7
2017,Isère,Saint-Didier-de-Bizonnes,238,42,196,27,169,2,LREM,71,7.825,31.7
2017,Isère,Saint-Michel-de-Saint-Geoirs,240,40,200,28,172,2,FN,81,7.825,31.7
2017,Isère,Saint-Michel-de-Saint-Geoirs,240,40,200,28,172,2,LREM,91,7.825,31.7
2017,Isère,Montagne,240,62,178,21,157,2,FN,88,7.825,31.7
2017,Isère,Montagne,240,62,178,21,157,2,LREM,69,7.825,31.7
2017,Isère,Oz,246,67,179,26,153,2,FN,47,7.825,31.7
2017,Isère,Oz,246,67,179,26,153,2,LREM,106,7.825,31.7
2017,Isère,Saint-Martin-de-Vaulserre,247,50,197,25,172,2,FN,77,7.825,31.7
2017,Isère,Saint-Martin-de-Vaulserre,247,50,197,25,172,2,LREM,95,7.825,31.7
2017,Isère,Serre-Nerpol,247,74,173,21,152,2,FN,80,7.825,31.7
2017,Isère,Serre-Nerpol,247,74,173,21,152,2,LREM,72,7.825,31.7
2017,Isère,Saint-Michel-les-Portes,250,53,197,25,172,2,FN,50,7.825,31.7
2017,Isère,Saint-Michel-les-Portes,250,53,197,25,172,2,LREM,122,7.825,31.7
2017,Isère,La Forteresse,253,64,189,20,169,2,FN,92,7.825,31.7
2017,Isère,La Forteresse,253,64,189,20,169,2,LREM,77,7.825,31.7
2017,Isère,Saint-Paul-d'Izeaux,256,59,197,25,172,2,FN,103,7.825,31.7
2017,Isère,Saint-Paul-d'Izeaux,256,59,197,25,172,2,LREM,69,7.825,31.7
2017,Isère,Saint-Mury-Monteymond,258,48,210,28,182,2,FN,72,7.825,31.7
2017,Isère,Saint-Mury-Monteymond,258,48,210,28,182,2,LREM,110,7.825,31.7
2017,Isère,Lieudieu,259,68,191,21,170,2,FN,116,7.825,31.7
2017,Isère,Lieudieu,259,68,191,21,170,2,LREM,54,7.825,31.7
2017,Isère,Château-Bernard,262,72,190,16,174,2,FN,67,7.825,31.7
2017,Isère,Château-Bernard,262,72,190,16,174,2,LREM,107,7.825,31.7
2017,Isère,Roissard,263,47,216,14,202,2,FN,85,7.825,31.7
2017,Isère,Roissard,263,47,216,14,202,2,LREM,117,7.825,31.7
2017,Isère,Saint-Baudille-et-Pipet,266,54,212,25,187,2,FN,63,7.825,31.7
2017,Isère,Saint-Baudille-et-Pipet,266,54,212,25,187,2,LREM,124,7.825,31.7
2017,Isère,Bossieu,278,60,218,25,193,2,FN,123,7.825,31.7
2017,Isère,Bossieu,278,60,218,25,193,2,LREM,70,7.825,31.7
2017,Isère,Cholonge,280,50,230,30,200,2,FN,112,7.825,31.7
2017,Isère,Cholonge,280,50,230,30,200,2,LREM,88,7.825,31.7
2017,Isère,Rencurel,281,53,228,35,193,2,FN,72,7.825,31.7
2017,Isère,Rencurel,281,53,228,35,193,2,LREM,121,7.825,31.7
2017,Isère,Montchaboud,286,47,239,31,208,2,FN,67,7.825,31.7
2017,Isère,Montchaboud,286,47,239,31,208,2,LREM,141,7.825,31.7
2017,Isère,Morette,287,34,253,18,235,2,FN,113,7.825,31.7
2017,Isère,Morette,287,34,253,18,235,2,LREM,122,7.825,31.7
2017,Isère,Murinais,293,58,235,19,216,2,FN,114,7.825,31.7
2017,Isère,Murinais,293,58,235,19,216,2,LREM,102,7.825,31.7
2017,Isère,Saint-André-en-Royans,294,51,243,33,210,2,FN,92,7.825,31.7
2017,Isère,Saint-André-en-Royans,294,51,243,33,210,2,LREM,118,7.825,31.7
2017,Isère,Penol,295,50,245,17,228,2,FN,116,7.825,31.7
2017,Isère,Penol,295,50,245,17,228,2,LREM,112,7.825,31.7
2017,Isère,Chichilianne,297,45,252,31,221,2,FN,88,7.825,31.7
2017,Isère,Chichilianne,297,45,252,31,221,2,LREM,133,7.825,31.7
2017,Isère,Prunières,299,78,221,40,181,2,FN,102,7.825,31.7
2017,Isère,Prunières,299,78,221,40,181,2,LREM,79,7.825,31.7
2017,Isère,Auberives-en-Royans,300,67,233,23,210,2,FN,112,7.825,31.7
2017,Isère,Auberives-en-Royans,300,67,233,23,210,2,LREM,98,7.825,31.7
2017,Isère,Saint-Jean-d'Hérans,304,62,242,40,202,2,FN,95,7.825,31.7
2017,Isère,Saint-Jean-d'Hérans,304,62,242,40,202,2,LREM,107,7.825,31.7
2017,Isère,Veyssilieu,309,53,256,18,238,2,FN,99,7.825,31.7
2017,Isère,Veyssilieu,309,53,256,18,238,2,LREM,139,7.825,31.7
2017,Isère,Royas,311,50,261,25,236,2,FN,131,7.825,31.7
2017,Isère,Royas,311,50,261,25,236,2,LREM,105,7.825,31.7
2017,Isère,La Salle-en-Beaumont,312,69,243,28,215,2,FN,116,7.825,31.7
2017,Isère,La Salle-en-Beaumont,312,69,243,28,215,2,LREM,99,7.825,31.7
2017,Isère,Miribel-Lanchâtre,317,55,262,38,224,2,FN,102,7.825,31.7
2017,Isère,Miribel-Lanchâtre,317,55,262,38,224,2,LREM,122,7.825,31.7
2017,Isère,Chantesse,321,62,259,12,247,2,FN,122,7.825,31.7
2017,Isère,Chantesse,321,62,259,12,247,2,LREM,125,7.825,31.7
2017,Isère,Saint-Romain-de-Surieu,327,51,276,21,255,2,FN,133,7.825,31.7
2017,Isère,Saint-Romain-de-Surieu,327,51,276,21,255,2,LREM,122,7.825,31.7
2017,Isère,Saint-Barthélemy-de-Séchilienne,331,70,261,25,236,2,FN,107,7.825,31.7
2017,Isère,Saint-Barthélemy-de-Séchilienne,331,70,261,25,236,2,LREM,129,7.825,31.7
2017,Isère,Vatilieu,335,62,273,37,236,2,FN,89,7.825,31.7
2017,Isère,Vatilieu,335,62,273,37,236,2,LREM,147,7.825,31.7
2017,Isère,Burcin,336,45,291,23,268,2,FN,128,7.825,31.7
2017,Isère,Burcin,336,45,291,23,268,2,LREM,140,7.825,31.7
2017,Isère,Cras,337,53,284,39,245,2,FN,115,7.825,31.7
2017,Isère,Cras,337,53,284,39,245,2,LREM,130,7.825,31.7
2017,Isère,Saint-Albin-de-Vaulserre,338,64,274,31,243,2,FN,123,7.825,31.7
2017,Isère,Saint-Albin-de-Vaulserre,338,64,274,31,243,2,LREM,120,7.825,31.7
2017,Isère,Vasselin,341,63,278,25,253,2,FN,146,7.825,31.7
2017,Isère,Vasselin,341,63,278,25,253,2,LREM,107,7.825,31.7
2017,Isère,Saint-Appolinard,342,64,278,24,254,2,FN,128,7.825,31.7
2017,Isère,Saint-Appolinard,342,64,278,24,254,2,LREM,126,7.825,31.7
2017,Isère,Montrevel,346,70,276,276,0,2,FN,0,7.825,31.7
2017,Isère,Montrevel,346,70,276,276,0,2,LREM,0,7.825,31.7
2017,Isère,Laffrey,347,77,270,37,233,2,FN,127,7.825,31.7
2017,Isère,Laffrey,347,77,270,37,233,2,LREM,106,7.825,31.7
2017,Isère,Charette,350,63,287,23,264,2,FN,165,7.825,31.7
2017,Isère,Charette,350,63,287,23,264,2,LREM,99,7.825,31.7
2017,Isère,La Flachère,350,78,272,20,252,2,FN,114,7.825,31.7
2017,Isère,La Flachère,350,78,272,20,252,2,LREM,138,7.825,31.7
2017,Isère,Chasselay,353,88,265,32,233,2,FN,123,7.825,31.7
2017,Isère,Chasselay,353,88,265,32,233,2,LREM,110,7.825,31.7
2017,Isère,Villard-Saint-Christophe,354,100,254,32,222,2,FN,102,7.825,31.7
2017,Isère,Villard-Saint-Christophe,354,100,254,32,222,2,LREM,120,7.825,31.7
2017,Isère,La Motte-Saint-Martin,355,74,281,34,247,2,FN,113,7.825,31.7
2017,Isère,La Motte-Saint-Martin,355,74,281,34,247,2,LREM,134,7.825,31.7
2017,Isère,Châtenay,356,92,264,31,233,2,FN,112,7.825,31.7
2017,Isère,Châtenay,356,92,264,31,233,2,LREM,121,7.825,31.7
2017,Isère,Saint-Sulpice-des-Rivoires,358,67,291,21,270,2,FN,127,7.825,31.7
2017,Isère,Saint-Sulpice-des-Rivoires,358,67,291,21,270,2,LREM,143,7.825,31.7
2017,Isère,Granieu,361,58,303,16,287,2,FN,140,7.825,31.7
2017,Isère,Granieu,361,58,303,16,287,2,LREM,147,7.825,31.7
2017,Isère,Eydoche,366,55,311,22,289,2,FN,164,7.825,31.7
2017,Isère,Eydoche,366,55,311,22,289,2,LREM,125,7.825,31.7
2017,Isère,Notre-Dame-de-l'Osier,370,68,302,30,272,2,FN,137,7.825,31.7
2017,Isère,Notre-Dame-de-l'Osier,370,68,302,30,272,2,LREM,135,7.825,31.7
2017,Isère,Engins,371,73,298,26,272,2,FN,97,7.825,31.7
2017,Isère,Engins,371,73,298,26,272,2,LREM,175,7.825,31.7
2017,Isère,Saint-Laurent-en-Beaumont,376,74,302,23,279,2,FN,153,7.825,31.7
2017,Isère,Saint-Laurent-en-Beaumont,376,74,302,23,279,2,LREM,126,7.825,31.7
2017,Isère,Sainte-Marie-d'Alloix,382,66,316,29,287,2,FN,120,7.825,31.7
2017,Isère,Sainte-Marie-d'Alloix,382,66,316,29,287,2,LREM,167,7.825,31.7
2017,Isère,Corrençon-en-Vercors,382,72,310,20,290,2,FN,85,7.825,31.7
2017,Isère,Corrençon-en-Vercors,382,72,310,20,290,2,LREM,205,7.825,31.7
2017,Isère,Saint-Geoirs,386,84,302,31,271,2,FN,130,7.825,31.7
2017,Isère,Saint-Geoirs,386,84,302,31,271,2,LREM,141,7.825,31.7
2017,Isère,Gresse-en-Vercors,388,78,310,36,274,2,FN,75,7.825,31.7
2017,Isère,Gresse-en-Vercors,388,78,310,36,274,2,LREM,199,7.825,31.7
2017,Isère,Saint-Gervais,390,108,282,21,261,2,FN,143,7.825,31.7
2017,Isère,Saint-Gervais,390,108,282,21,261,2,LREM,118,7.825,31.7
2017,Isère,Monteynard,392,61,331,27,304,2,FN,167,7.825,31.7
2017,Isère,Monteynard,392,61,331,27,304,2,LREM,137,7.825,31.7
2017,Isère,Corps,401,75,326,25,301,2,FN,135,7.825,31.7
2017,Isère,Corps,401,75,326,25,301,2,LREM,166,7.825,31.7
2017,Isère,Notre-Dame-de-Commiers,403,73,330,30,300,2,FN,153,7.825,31.7
2017,Isère,Notre-Dame-de-Commiers,403,73,330,30,300,2,LREM,147,7.825,31.7
2017,Isère,Vaujany,405,100,305,16,289,2,FN,119,7.825,31.7
2017,Isère,Vaujany,405,100,305,16,289,2,LREM,170,7.825,31.7
2017,Isère,Proveysieux,406,75,331,33,298,2,FN,76,7.825,31.7
2017,Isère,Proveysieux,406,75,331,33,298,2,LREM,222,7.825,31.7
2017,Isère,Belmont,406,92,314,20,294,2,FN,176,7.825,31.7
2017,Isère,Belmont,406,92,314,20,294,2,LREM,118,7.825,31.7
2017,Isère,La Chapelle-du-Bard,408,104,304,37,267,2,FN,106,7.825,31.7
2017,Isère,La Chapelle-du-Bard,408,104,304,37,267,2,LREM,161,7.825,31.7
2017,Isère,Merlas,409,97,312,37,275,2,FN,147,7.825,31.7
2017,Isère,Merlas,409,97,312,37,275,2,LREM,128,7.825,31.7
2017,Isère,Nantes-en-Ratier,415,66,349,55,294,2,FN,110,7.825,31.7
2017,Isère,Nantes-en-Ratier,415,66,349,55,294,2,LREM,184,7.825,31.7
2017,Isère,Beaufort,422,70,352,30,322,2,FN,182,7.825,31.7
2017,Isère,Beaufort,422,70,352,30,322,2,LREM,140,7.825,31.7
2017,Isère,Velanne,429,106,323,34,289,2,FN,149,7.825,31.7
2017,Isère,Velanne,429,106,323,34,289,2,LREM,140,7.825,31.7
2017,Isère,Montcarra,435,72,363,39,324,2,FN,161,7.825,31.7
2017,Isère,Montcarra,435,72,363,39,324,2,LREM,163,7.825,31.7
2017,Isère,La Sône,435,98,337,41,296,2,FN,144,7.825,31.7
2017,Isère,La Sône,435,98,337,41,296,2,LREM,152,7.825,31.7
2017,Isère,Saint-Pierre-de-Chérennes,438,88,350,45,305,2,FN,133,7.825,31.7
2017,Isère,Saint-Pierre-de-Chérennes,438,88,350,45,305,2,LREM,172,7.825,31.7
2017,Isère,Longechenal,438,92,346,40,306,2,FN,152,7.825,31.7
2017,Isère,Longechenal,438,92,346,40,306,2,LREM,154,7.825,31.7
2017,Isère,Crachier,439,71,368,33,335,2,FN,174,7.825,31.7
2017,Isère,Crachier,439,71,368,33,335,2,LREM,161,7.825,31.7
2017,Isère,Châtel en Trièves,440,85,355,44,311,2,FN,116,7.825,31.7
2017,Isère,Châtel en Trièves,440,85,355,44,311,2,LREM,195,7.825,31.7
2017,Isère,Flachères,440,97,343,36,307,2,FN,169,7.825,31.7
2017,Isère,Flachères,440,97,343,36,307,2,LREM,138,7.825,31.7
2017,Isère,Saint-Théoffrey,443,101,342,50,292,2,FN,117,7.825,31.7
2017,Isère,Saint-Théoffrey,443,101,342,50,292,2,LREM,175,7.825,31.7
2017,Isère,Montaud,444,95,349,54,295,2,FN,63,7.825,31.7
2017,Isère,Montaud,444,95,349,54,295,2,LREM,232,7.825,31.7
2017,Isère,Pisieu,452,102,350,42,308,2,FN,161,7.825,31.7
2017,Isère,Pisieu,452,102,350,42,308,2,LREM,147,7.825,31.7
2017,Isère,Chèzeneuve,455,60,395,30,365,2,FN,186,7.825,31.7
2017,Isère,Chèzeneuve,455,60,395,30,365,2,LREM,179,7.825,31.7
2017,Isère,Le Haut-Bréda,455,97,358,44,314,2,FN,131,7.825,31.7
2017,Isère,Le Haut-Bréda,455,97,358,44,314,2,LREM,183,7.825,31.7
2017,Isère,Siccieu-Saint-Julien-et-Carisieu,456,95,361,33,328,2,FN,153,7.825,31.7
2017,Isère,Siccieu-Saint-Julien-et-Carisieu,456,95,361,33,328,2,LREM,175,7.825,31.7
2017,Isère,Saint-Ondras,460,90,370,41,329,2,FN,169,7.825,31.7
2017,Isère,Saint-Ondras,460,90,370,41,329,2,LREM,160,7.825,31.7
2017,Isère,Têche,460,117,343,32,311,2,FN,165,7.825,31.7
2017,Isère,Têche,460,117,343,32,311,2,LREM,146,7.825,31.7
2017,Isère,Le Bouchage,461,89,372,22,350,2,FN,222,7.825,31.7
2017,Isère,Le Bouchage,461,89,372,22,350,2,LREM,128,7.825,31.7
2017,Isère,Brangues,461,99,362,25,337,2,FN,183,7.825,31.7
2017,Isère,Brangues,461,99,362,25,337,2,LREM,154,7.825,31.7
2017,Isère,Saint-Sorlin-de-Morestel,461,105,356,19,337,2,FN,188,7.825,31.7
2017,Isère,Saint-Sorlin-de-Morestel,461,105,356,19,337,2,LREM,149,7.825,31.7
2017,Isère,Clelles,467,90,377,66,311,2,FN,134,7.825,31.7
2017,Isère,Clelles,467,90,377,66,311,2,LREM,177,7.825,31.7
2017,Isère,Moras,469,92,377,27,350,2,FN,172,7.825,31.7
2017,Isère,Moras,469,92,377,27,350,2,LREM,178,7.825,31.7
2017,Isère,La Pierre,469,96,373,45,328,2,FN,135,7.825,31.7
2017,Isère,La Pierre,469,96,373,45,328,2,LREM,193,7.825,31.7
2017,Isère,Saint-Jean-de-Vaulx,471,99,372,58,314,2,FN,138,7.825,31.7
2017,Isère,Saint-Jean-de-Vaulx,471,99,372,58,314,2,LREM,176,7.825,31.7
2017,Isère,Sainte-Agnès,473,78,395,47,348,2,FN,100,7.825,31.7
2017,Isère,Sainte-Agnès,473,78,395,47,348,2,LREM,248,7.825,31.7
2017,Isère,Chamrousse,474,121,353,23,330,2,FN,101,7.825,31.7
2017,Isère,Chamrousse,474,121,353,23,330,2,LREM,229,7.825,31.7
2017,Isère,Valbonnais,479,129,350,56,294,2,FN,109,7.825,31.7
2017,Isère,Valbonnais,479,129,350,56,294,2,LREM,185,7.825,31.7
2017,Isère,Vertrieu,481,92,389,31,358,2,FN,209,7.825,31.7
2017,Isère,Vertrieu,481,92,389,31,358,2,LREM,149,7.825,31.7
2017,Isère,Saint-Bueil,483,112,371,39,332,2,FN,179,7.825,31.7
2017,Isère,Saint-Bueil,483,112,371,39,332,2,LREM,153,7.825,31.7
2017,Isère,Notre-Dame-de-Vaulx,485,101,384,41,343,2,FN,137,7.825,31.7
2017,Isère,Notre-Dame-de-Vaulx,485,101,384,41,343,2,LREM,206,7.825,31.7
2017,Isère,Cognin-les-Gorges,486,117,369,45,324,2,FN,133,7.825,31.7
2017,Isère,Cognin-les-Gorges,486,117,369,45,324,2,LREM,191,7.825,31.7
2017,Isère,Saint-Hilaire-de-Brens,494,97,397,44,353,2,FN,162,7.825,31.7
2017,Isère,Saint-Hilaire-de-Brens,494,97,397,44,353,2,LREM,191,7.825,31.7
2017,Isère,Rovon,507,121,386,35,351,2,FN,205,7.825,31.7
2017,Isère,Rovon,507,121,386,35,351,2,LREM,146,7.825,31.7
2017,Isère,Saint-Pierre-d'Entremont,511,135,376,30,346,2,FN,125,7.825,31.7
2017,Isère,Saint-Pierre-d'Entremont,511,135,376,30,346,2,LREM,221,7.825,31.7
2017,Isère,Marcollin,515,143,372,27,345,2,FN,187,7.825,31.7
2017,Isère,Marcollin,515,143,372,27,345,2,LREM,158,7.825,31.7
2017,Isère,La Chapelle-de-Surieu,519,102,417,35,382,2,FN,226,7.825,31.7
2017,Isère,La Chapelle-de-Surieu,519,102,417,35,382,2,LREM,156,7.825,31.7
2017,Isère,Beaulieu,522,97,425,44,381,2,FN,174,7.825,31.7
2017,Isère,Beaulieu,522,97,425,44,381,2,LREM,207,7.825,31.7
2017,Isère,Annoisin-Chatelans,525,81,444,30,414,2,FN,205,7.825,31.7
2017,Isère,Annoisin-Chatelans,525,81,444,30,414,2,LREM,209,7.825,31.7
2017,Isère,La Buissière,526,93,433,41,392,2,FN,149,7.825,31.7
2017,Isère,La Buissière,526,93,433,41,392,2,LREM,243,7.825,31.7
2017,Isère,Sinard,533,115,418,53,365,2,FN,119,7.825,31.7
2017,Isère,Sinard,533,115,418,53,365,2,LREM,246,7.825,31.7
2017,Isère,Valencogne,535,124,411,36,375,2,FN,177,7.825,31.7
2017,Isère,Valencogne,535,124,411,36,375,2,LREM,198,7.825,31.7
2017,Isère,Panossas,536,86,450,34,416,2,FN,180,7.825,31.7
2017,Isère,Panossas,536,86,450,34,416,2,LREM,236,7.825,31.7
2017,Isère,Parmilieu,537,102,435,40,395,2,FN,221,7.825,31.7
2017,Isère,Parmilieu,537,102,435,40,395,2,LREM,174,7.825,31.7
2017,Isère,Meyssiez,538,106,432,37,395,2,FN,243,7.825,31.7
2017,Isère,Meyssiez,538,106,432,37,395,2,LREM,152,7.825,31.7
2017,Isère,Saint-Martin-de-la-Cluze,546,106,440,41,399,2,FN,182,7.825,31.7
2017,Isère,Saint-Martin-de-la-Cluze,546,106,440,41,399,2,LREM,217,7.825,31.7
2017,Isère,Saint-Maximin,553,114,439,51,388,2,FN,171,7.825,31.7
2017,Isère,Saint-Maximin,553,114,439,51,388,2,LREM,217,7.825,31.7
2017,Isère,Chevrières,556,130,426,43,383,2,FN,150,7.825,31.7
2017,Isère,Chevrières,556,130,426,43,383,2,LREM,233,7.825,31.7
2017,Isère,La Rivière,556,130,426,26,400,2,FN,218,7.825,31.7
2017,Isère,La Rivière,556,130,426,26,400,2,LREM,182,7.825,31.7
2017,Isère,Sainte-Anne-sur-Gervonde,557,114,443,36,407,2,FN,222,7.825,31.7
2017,Isère,Sainte-Anne-sur-Gervonde,557,114,443,36,407,2,LREM,185,7.825,31.7
2017,Isère,Tramolé,558,110,448,29,419,2,FN,162,7.825,31.7
2017,Isère,Tramolé,558,110,448,29,419,2,LREM,257,7.825,31.7
2017,Isère,Saint-Bonnet-de-Chavagne,572,126,446,41,405,2,FN,184,7.825,31.7
2017,Isère,Saint-Bonnet-de-Chavagne,572,126,446,41,405,2,LREM,221,7.825,31.7
2017,Isère,Torchefelon,573,104,469,53,416,2,FN,187,7.825,31.7
2017,Isère,Torchefelon,573,104,469,53,416,2,LREM,229,7.825,31.7
2017,Isère,Moissieu-sur-Dolon,575,127,448,31,417,2,FN,223,7.825,31.7
2017,Isère,Moissieu-sur-Dolon,575,127,448,31,417,2,LREM,194,7.825,31.7
2017,Isère,La Combe-de-Lancey,577,105,472,45,427,2,FN,138,7.825,31.7
2017,Isère,La Combe-de-Lancey,577,105,472,45,427,2,LREM,289,7.825,31.7
2017,Isère,Succieu,577,107,470,33,437,2,FN,245,7.825,31.7
2017,Isère,Succieu,577,107,470,33,437,2,LREM,192,7.825,31.7
2017,Isère,Thodure,581,101,480,51,429,2,FN,216,7.825,31.7
2017,Isère,Thodure,581,101,480,51,429,2,LREM,213,7.825,31.7
2017,Isère,Monsteroux-Milieu,593,107,486,45,441,2,FN,263,7.825,31.7
2017,Isère,Monsteroux-Milieu,593,107,486,45,441,2,LREM,178,7.825,31.7
2017,Isère,Primarette,593,121,472,48,424,2,FN,233,7.825,31.7
2017,Isère,Primarette,593,121,472,48,424,2,LREM,191,7.825,31.7
2017,Isère,Saint-Pierre-de-Mésage,598,120,478,51,427,2,FN,200,7.825,31.7
2017,Isère,Saint-Pierre-de-Mésage,598,120,478,51,427,2,LREM,227,7.825,31.7
2017,Isère,Saint-Pierre-de-Bressieux,599,121,478,42,436,2,FN,163,7.825,31.7
2017,Isère,Saint-Pierre-de-Bressieux,599,121,478,42,436,2,LREM,273,7.825,31.7
2017,Isère,Culin,601,120,481,38,443,2,FN,226,7.825,31.7
2017,Isère,Culin,601,120,481,38,443,2,LREM,217,7.825,31.7
2017,Isère,Izeron,603,126,477,45,432,2,FN,249,7.825,31.7
2017,Isère,Izeron,603,126,477,45,432,2,LREM,183,7.825,31.7
2017,Isère,Massieu,603,153,450,47,403,2,FN,168,7.825,31.7
2017,Isère,Massieu,603,153,450,47,403,2,LREM,235,7.825,31.7
2017,Isère,Mottier,604,137,467,37,430,2,FN,236,7.825,31.7
2017,Isère,Mottier,604,137,467,37,430,2,LREM,194,7.825,31.7
2017,Isère,Bresson,607,90,517,40,477,2,FN,134,7.825,31.7
2017,Isère,Bresson,607,90,517,40,477,2,LREM,343,7.825,31.7
2017,Isère,Chélieu,611,122,489,46,443,2,FN,250,7.825,31.7
2017,Isère,Chélieu,611,122,489,46,443,2,LREM,193,7.825,31.7
2017,Isère,Venon,612,89,523,70,453,2,FN,109,7.825,31.7
2017,Isère,Venon,612,89,523,70,453,2,LREM,344,7.825,31.7
2017,Isère,Pommier-de-Beaurepaire,612,157,455,35,420,2,FN,224,7.825,31.7
2017,Isère,Pommier-de-Beaurepaire,612,157,455,35,420,2,LREM,196,7.825,31.7
2017,Isère,Châteauvilain,615,107,508,38,470,2,FN,243,7.825,31.7
2017,Isère,Châteauvilain,615,107,508,38,470,2,LREM,227,7.825,31.7
2017,Isère,Dizimieu,620,138,482,28,454,2,FN,218,7.825,31.7
2017,Isère,Dizimieu,620,138,482,28,454,2,LREM,236,7.825,31.7
2017,Isère,Pont-en-Royans,620,212,408,51,357,2,FN,144,7.825,31.7
2017,Isère,Pont-en-Royans,620,212,408,51,357,2,LREM,213,7.825,31.7
2017,Isère,Vénérieu,625,124,501,32,469,2,FN,236,7.825,31.7
2017,Isère,Vénérieu,625,124,501,32,469,2,LREM,233,7.825,31.7
2017,Isère,Leyrieu,642,148,494,37,457,2,FN,242,7.825,31.7
2017,Isère,Leyrieu,642,148,494,37,457,2,LREM,215,7.825,31.7
2017,Isère,Pact,643,120,523,44,479,2,FN,297,7.825,31.7
2017,Isère,Pact,643,120,523,44,479,2,LREM,182,7.825,31.7
2017,Isère,Soleymieu,651,154,497,47,450,2,FN,251,7.825,31.7
2017,Isère,Soleymieu,651,154,497,47,450,2,LREM,199,7.825,31.7
2017,Isère,Charancieu,651,162,489,53,436,2,FN,237,7.825,31.7
2017,Isère,Charancieu,651,162,489,53,436,2,LREM,199,7.825,31.7
2017,Isère,Saint-Baudille-de-la-Tour,655,157,498,46,452,2,FN,255,7.825,31.7
2017,Isère,Saint-Baudille-de-la-Tour,655,157,498,46,452,2,LREM,197,7.825,31.7
2017,Isère,Saint-Honoré,658,130,528,87,441,2,FN,221,7.825,31.7
2017,Isère,Saint-Honoré,658,130,528,87,441,2,LREM,220,7.825,31.7
2017,Isère,Saint-Christophe-sur-Guiers,661,141,520,51,469,2,FN,225,7.825,31.7
2017,Isère,Saint-Christophe-sur-Guiers,661,141,520,51,469,2,LREM,244,7.825,31.7
2017,Isère,Doissin,664,106,558,50,508,2,FN,257,7.825,31.7
2017,Isère,Doissin,664,106,558,50,508,2,LREM,251,7.825,31.7
2017,Isère,Murianette,664,112,552,40,512,2,FN,210,7.825,31.7
2017,Isère,Murianette,664,112,552,40,512,2,LREM,302,7.825,31.7
2017,Isère,Optevoz,664,138,526,35,491,2,FN,284,7.825,31.7
2017,Isère,Optevoz,664,138,526,35,491,2,LREM,207,7.825,31.7
2017,Isère,Saint-Barthélemy,676,176,500,42,458,2,FN,247,7.825,31.7
2017,Isère,Saint-Barthélemy,676,176,500,42,458,2,LREM,211,7.825,31.7
2017,Isère,Cour-et-Buis,677,169,508,36,472,2,FN,254,7.825,31.7
2017,Isère,Cour-et-Buis,677,169,508,36,472,2,LREM,218,7.825,31.7
2017,Isère,Montseveroux,692,136,556,52,504,2,FN,279,7.825,31.7
2017,Isère,Montseveroux,692,136,556,52,504,2,LREM,225,7.825,31.7
2017,Isère,Le Passage,702,106,596,49,547,2,FN,245,7.825,31.7
2017,Isère,Le Passage,702,106,596,49,547,2,LREM,302,7.825,31.7
2017,Isère,Savas-Mépin,704,136,568,40,528,2,FN,328,7.825,31.7
2017,Isère,Savas-Mépin,704,136,568,40,528,2,LREM,200,7.825,31.7
2017,Isère,Saint-Jean-d'Avelanne,704,156,548,58,490,2,FN,249,7.825,31.7
2017,Isère,Saint-Jean-d'Avelanne,704,156,548,58,490,2,LREM,241,7.825,31.7
2017,Isère,Meyrieu-les-Etangs,718,130,588,54,534,2,FN,265,7.825,31.7
2017,Isère,Meyrieu-les-Etangs,718,130,588,54,534,2,LREM,269,7.825,31.7
2017,Isère,Saint-Alban-du-Rhône,718,195,523,45,478,2,FN,277,7.825,31.7
2017,Isère,Saint-Alban-du-Rhône,718,195,523,45,478,2,LREM,201,7.825,31.7
2017,Isère,Varacieux,719,142,577,51,526,2,FN,294,7.825,31.7
2017,Isère,Varacieux,719,142,577,51,526,2,LREM,232,7.825,31.7
2017,Isère,Ornacieux-Balbins,723,110,613,58,555,2,FN,244,7.825,31.7
2017,Isère,Ornacieux-Balbins,723,110,613,58,555,2,LREM,311,7.825,31.7
2017,Isère,La Balme-les-Grottes,728,162,566,41,525,2,FN,321,7.825,31.7
2017,Isère,La Balme-les-Grottes,728,162,566,41,525,2,LREM,204,7.825,31.7
2017,Isère,Saint-Sorlin-de-Vienne,729,105,624,56,568,2,FN,308,7.825,31.7
2017,Isère,Saint-Sorlin-de-Vienne,729,105,624,56,568,2,LREM,260,7.825,31.7
2017,Isère,Bizonnes,744,143,601,36,565,2,FN,346,7.825,31.7
2017,Isère,Bizonnes,744,143,601,36,565,2,LREM,219,7.825,31.7
2017,Isère,Pajay,749,160,589,61,528,2,FN,288,7.825,31.7
2017,Isère,Pajay,749,160,589,61,528,2,LREM,240,7.825,31.7
2017,Isère,Les Eparres,751,180,571,41,530,2,FN,271,7.825,31.7
2017,Isère,Les Eparres,751,180,571,41,530,2,LREM,259,7.825,31.7
2017,Isère,Marcilloles,751,188,563,35,528,2,FN,286,7.825,31.7
2017,Isère,Marcilloles,751,188,563,35,528,2,LREM,242,7.825,31.7
2017,Isère,Anjou,752,186,566,53,513,2,FN,259,7.825,31.7
2017,Isère,Anjou,752,186,566,53,513,2,LREM,254,7.825,31.7
2017,Isère,Oyeu,762,146,616,54,562,2,FN,243,7.825,31.7
2017,Isère,Oyeu,762,146,616,54,562,2,LREM,319,7.825,31.7
2017,Isère,Vignieu,773,178,595,46,549,2,FN,310,7.825,31.7
2017,Isère,Vignieu,773,178,595,46,549,2,LREM,239,7.825,31.7
2017,Isère,Saint-Agnin-sur-Bion,780,133,647,59,588,2,FN,332,7.825,31.7
2017,Isère,Saint-Agnin-sur-Bion,780,133,647,59,588,2,LREM,256,7.825,31.7
2017,Isère,Faramans,784,145,639,43,596,2,FN,333,7.825,31.7
2017,Isère,Faramans,784,145,639,43,596,2,LREM,263,7.825,31.7
2017,Isère,Sardieu,789,153,636,40,596,2,FN,349,7.825,31.7
2017,Isère,Sardieu,789,153,636,40,596,2,LREM,247,7.825,31.7
2017,Isère,Réaumont,790,147,643,50,593,2,FN,217,7.825,31.7
2017,Isère,Réaumont,790,147,643,50,593,2,LREM,376,7.825,31.7
2017,Isère,Saint-Blaise-du-Buis,802,154,648,67,581,2,FN,230,7.825,31.7
2017,Isère,Saint-Blaise-du-Buis,802,154,648,67,581,2,LREM,351,7.825,31.7
2017,Isère,Saint-Nicolas-de-Macherin,806,138,668,68,600,2,FN,220,7.825,31.7
2017,Isère,Saint-Nicolas-de-Macherin,806,138,668,68,600,2,LREM,380,7.825,31.7
2017,Isère,Séchilienne,810,220,590,50,540,2,FN,267,7.825,31.7
2017,Isère,Séchilienne,810,220,590,50,540,2,LREM,273,7.825,31.7
2017,Isère,Chozeau,816,140,676,53,623,2,FN,265,7.825,31.7
2017,Isère,Chozeau,816,140,676,53,623,2,LREM,358,7.825,31.7
2017,Isère,Villeneuve-de-Marc,817,164,653,71,582,2,FN,313,7.825,31.7
2017,Isère,Villeneuve-de-Marc,817,164,653,71,582,2,LREM,269,7.825,31.7
2017,Isère,Bévenais,822,174,648,67,581,2,FN,303,7.825,31.7
2017,Isère,Bévenais,822,174,648,67,581,2,LREM,278,7.825,31.7
2017,Isère,Bellegarde-Poussieu,823,165,658,48,610,2,FN,317,7.825,31.7
2017,Isère,Bellegarde-Poussieu,823,165,658,48,610,2,LREM,293,7.825,31.7
2017,Isère,Quaix-en-Chartreuse,825,163,662,49,613,2,FN,165,7.825,31.7
2017,Isère,Quaix-en-Chartreuse,825,163,662,49,613,2,LREM,448,7.825,31.7
2017,Isère,Hières-sur-Amby,825,236,589,26,563,2,FN,340,7.825,31.7
2017,Isère,Hières-sur-Amby,825,236,589,26,563,2,LREM,223,7.825,31.7
2017,Isère,Beauvoir-de-Marc,831,195,636,44,592,2,FN,312,7.825,31.7
2017,Isère,Beauvoir-de-Marc,831,195,636,44,592,2,LREM,280,7.825,31.7
2017,Isère,Sainte-Blandine,833,160,673,63,610,2,FN,345,7.825,31.7
2017,Isère,Sainte-Blandine,833,160,673,63,610,2,LREM,265,7.825,31.7
2017,Isère,Livet-et-Gavet,835,257,578,60,518,2,FN,315,7.825,31.7
2017,Isère,Livet-et-Gavet,835,257,578,60,518,2,LREM,203,7.825,31.7
2017,Isère,Sérézin-de-la-Tour,838,168,670,38,632,2,FN,320,7.825,31.7
2017,Isère,Sérézin-de-la-Tour,838,168,670,38,632,2,LREM,312,7.825,31.7
2017,Isère,Roybon,838,218,620,59,561,2,FN,230,7.825,31.7
2017,Isère,Roybon,838,218,620,59,561,2,LREM,331,7.825,31.7
2017,Isère,La Frette,842,194,648,42,606,2,FN,315,7.825,31.7
2017,Isère,La Frette,842,194,648,42,606,2,LREM,291,7.825,31.7
2017,Isère,Poliénas,847,170,677,78,599,2,FN,312,7.825,31.7
2017,Isère,Poliénas,847,170,677,78,599,2,LREM,287,7.825,31.7
2017,Isère,Les Adrets,855,187,668,62,606,2,FN,156,7.825,31.7
2017,Isère,Les Adrets,855,187,668,62,606,2,LREM,450,7.825,31.7
2017,Isère,Gillonnay,859,143,716,68,648,2,FN,332,7.825,31.7
2017,Isère,Gillonnay,859,143,716,68,648,2,LREM,316,7.825,31.7
2017,Isère,Jarcieu,866,196,670,69,601,2,FN,302,7.825,31.7
2017,Isère,Jarcieu,866,196,670,69,601,2,LREM,299,7.825,31.7
2017,Isère,Cheyssieu,867,224,643,46,597,2,FN,300,7.825,31.7
2017,Isère,Cheyssieu,867,224,643,46,597,2,LREM,297,7.825,31.7
2017,Isère,Susville,871,231,640,60,580,2,FN,376,7.825,31.7
2017,Isère,Susville,871,231,640,60,580,2,LREM,204,7.825,31.7
2017,Isère,Revel-Tourdan,873,174,699,58,641,2,FN,339,7.825,31.7
2017,Isère,Revel-Tourdan,873,174,699,58,641,2,LREM,302,7.825,31.7
2017,Isère,Laval-en-Belledonne,878,170,708,74,634,2,FN,195,7.825,31.7
2017,Isère,Laval-en-Belledonne,878,170,708,74,634,2,LREM,439,7.825,31.7
2017,Isère,Allemond,879,261,618,66,552,2,FN,208,7.825,31.7
2017,Isère,Allemond,879,261,618,66,552,2,LREM,344,7.825,31.7
2017,Isère,Agnin,881,187,694,52,642,2,FN,350,7.825,31.7
2017,Isère,Agnin,881,187,694,52,642,2,LREM,292,7.825,31.7
2017,Isère,La Sure en Chartreuse,884,178,706,62,644,2,FN,189,7.825,31.7
2017,Isère,La Sure en Chartreuse,884,178,706,62,644,2,LREM,455,7.825,31.7
2017,Isère,Anthon,894,201,693,40,653,2,FN,334,7.825,31.7
2017,Isère,Anthon,894,201,693,40,653,2,LREM,319,7.825,31.7
2017,Isère,Bonnefamille,898,199,699,45,654,2,FN,316,7.825,31.7
2017,Isère,Bonnefamille,898,199,699,45,654,2,LREM,338,7.825,31.7
2017,Isère,Montagnieu,904,157,747,68,679,2,FN,402,7.825,31.7
2017,Isère,Montagnieu,904,157,747,68,679,2,LREM,277,7.825,31.7
2017,Isère,Saint-Aupre,908,139,769,67,702,2,FN,247,7.825,31.7
2017,Isère,Saint-Aupre,908,139,769,67,702,2,LREM,455,7.825,31.7
2017,Isère,Ville-sous-Anjou,924,190,734,64,670,2,FN,349,7.825,31.7
2017,Isère,Ville-sous-Anjou,924,190,734,64,670,2,LREM,321,7.825,31.7
2017,Isère,Pressins,925,194,731,56,675,2,FN,371,7.825,31.7
2017,Isère,Pressins,925,194,731,56,675,2,LREM,304,7.825,31.7
2017,Isère,Courtenay,926,205,721,58,663,2,FN,384,7.825,31.7
2017,Isère,Courtenay,926,205,721,58,663,2,LREM,279,7.825,31.7
2017,Isère,Saint-Nizier-du-Moucherotte,927,240,687,81,606,2,FN,136,7.825,31.7
2017,Isère,Saint-Nizier-du-Moucherotte,927,240,687,81,606,2,LREM,470,7.825,31.7
2017,Isère,Rochetoirin,942,213,729,65,664,2,FN,360,7.825,31.7
2017,Isère,Rochetoirin,942,213,729,65,664,2,LREM,304,7.825,31.7
2017,Isère,Saint-Cassien,950,203,747,70,677,2,FN,256,7.825,31.7
2017,Isère,Saint-Cassien,950,203,747,70,677,2,LREM,421,7.825,31.7
2017,Isère,Notre-Dame-de-Mésage,950,221,729,71,658,2,FN,295,7.825,31.7
2017,Isère,Notre-Dame-de-Mésage,950,221,729,71,658,2,LREM,363,7.825,31.7
2017,Isère,Meyrié,953,164,789,77,712,2,FN,255,7.825,31.7
2017,Isère,Meyrié,953,164,789,77,712,2,LREM,457,7.825,31.7
2017,Isère,Saint-Victor-de-Morestel,954,243,711,65,646,2,FN,370,7.825,31.7
2017,Isère,Saint-Victor-de-Morestel,954,243,711,65,646,2,LREM,276,7.825,31.7
2017,Isère,L'Albenc,954,255,699,70,629,2,FN,308,7.825,31.7
2017,Isère,L'Albenc,954,255,699,70,629,2,LREM,321,7.825,31.7
2017,Isère,Saint-Pierre-de-Chartreuse,956,187,769,101,668,2,FN,169,7.825,31.7
2017,Isère,Saint-Pierre-de-Chartreuse,956,187,769,101,668,2,LREM,499,7.825,31.7
2017,Isère,Le Sappey-en-Chartreuse,965,154,811,57,754,2,FN,120,7.825,31.7
2017,Isère,Le Sappey-en-Chartreuse,965,154,811,57,754,2,LREM,634,7.825,31.7
2017,Isère,Saint-Just-de-Claix,977,255,722,53,669,2,FN,370,7.825,31.7
2017,Isère,Saint-Just-de-Claix,977,255,722,53,669,2,LREM,299,7.825,31.7
2017,Isère,Champier,982,213,769,63,706,2,FN,426,7.825,31.7
2017,Isère,Champier,982,213,769,63,706,2,LREM,280,7.825,31.7
2017,Isère,Monestier-de-Clermont,983,235,748,72,676,2,FN,312,7.825,31.7
2017,Isère,Monestier-de-Clermont,983,235,748,72,676,2,LREM,364,7.825,31.7
2017,Isère,Saint-Antoine-l'Abbaye,987,220,767,95,672,2,FN,299,7.825,31.7
2017,Isère,Saint-Antoine-l'Abbaye,987,220,767,95,672,2,LREM,373,7.825,31.7
2017,Isère,Saint-Joseph-de-Rivière,995,247,748,79,669,2,FN,287,7.825,31.7
2017,Isère,Saint-Joseph-de-Rivière,995,247,748,79,669,2,LREM,382,7.825,31.7
2017,Isère,Champagnier,1001,145,856,70,786,2,FN,241,7.825,31.7
2017,Isère,Champagnier,1001,145,856,70,786,2,LREM,545,7.825,31.7
2017,Isère,Vaulnaveys-le-Bas,1021,200,821,68,753,2,FN,306,7.825,31.7
2017,Isère,Vaulnaveys-le-Bas,1021,200,821,68,753,2,LREM,447,7.825,31.7
2017,Isère,Sonnay,1030,228,802,53,749,2,FN,423,7.825,31.7
2017,Isère,Sonnay,1030,228,802,53,749,2,LREM,326,7.825,31.7
2017,Isère,Bougé-Chambalud,1047,181,866,64,802,2,FN,420,7.825,31.7
2017,Isère,Bougé-Chambalud,1047,181,866,64,802,2,LREM,382,7.825,31.7
2017,Isère,Grenay,1054,218,836,58,778,2,FN,404,7.825,31.7
2017,Isère,Grenay,1054,218,836,58,778,2,LREM,374,7.825,31.7
2017,Isère,Le Champ-près-Froges,1054,265,789,71,718,2,FN,293,7.825,31.7
2017,Isère,Le Champ-près-Froges,1054,265,789,71,718,2,LREM,425,7.825,31.7
2017,Isère,Vernioz,1062,202,860,81,779,2,FN,418,7.825,31.7
2017,Isère,Vernioz,1062,202,860,81,779,2,LREM,361,7.825,31.7
2017,Isère,Eclose-Badinières,1079,216,863,65,798,2,FN,446,7.825,31.7
2017,Isère,Eclose-Badinières,1079,216,863,65,798,2,LREM,352,7.825,31.7
2017,Isère,Val-de-Virieu,1092,293,799,52,747,2,FN,366,7.825,31.7
2017,Isère,Val-de-Virieu,1092,293,799,52,747,2,LREM,381,7.825,31.7
2017,Isère,Saint-Quentin-sur-Isère,1096,241,855,84,771,2,FN,347,7.825,31.7
2017,Isère,Saint-Quentin-sur-Isère,1096,241,855,84,771,2,LREM,424,7.825,31.7
2017,Isère,Four,1097,182,915,97,818,2,FN,397,7.825,31.7
2017,Isère,Four,1097,182,915,97,818,2,LREM,421,7.825,31.7
2017,Isère,Chimilin,1097,253,844,67,777,2,FN,428,7.825,31.7
2017,Isère,Chimilin,1097,253,844,67,777,2,LREM,349,7.825,31.7
2017,Isère,Bouvesse-Quirieu,1105,272,833,89,744,2,FN,471,7.825,31.7
2017,Isère,Bouvesse-Quirieu,1105,272,833,89,744,2,LREM,273,7.825,31.7
2017,Isère,Veurey-Voroize,1108,253,855,58,797,2,FN,309,7.825,31.7
2017,Isère,Veurey-Voroize,1108,253,855,58,797,2,LREM,488,7.825,31.7
2017,Isère,Saint-Lattier,1110,256,854,83,771,2,FN,393,7.825,31.7
2017,Isère,Saint-Lattier,1110,256,854,83,771,2,LREM,378,7.825,31.7
2017,Isère,Pierre-Châtel,1113,256,857,101,756,2,FN,406,7.825,31.7
2017,Isère,Pierre-Châtel,1113,256,857,101,756,2,LREM,350,7.825,31.7
2017,Isère,Salagnon,1129,254,875,47,828,2,FN,462,7.825,31.7
2017,Isère,Salagnon,1129,254,875,47,828,2,LREM,366,7.825,31.7
2017,Isère,Faverges-de-la-Tour,1133,256,877,93,784,2,FN,407,7.825,31.7
2017,Isère,Faverges-de-la-Tour,1133,256,877,93,784,2,LREM,377,7.825,31.7
2017,Isère,Viriville,1135,263,872,74,798,2,FN,408,7.825,31.7
2017,Isère,Viriville,1135,263,872,74,798,2,LREM,390,7.825,31.7
2017,Isère,Saint-Hilaire-de-la-Côte,1144,235,909,84,825,2,FN,399,7.825,31.7
2017,Isère,Saint-Hilaire-de-la-Côte,1144,235,909,84,825,2,LREM,426,7.825,31.7
2017,Isère,Huez,1144,245,899,74,825,2,FN,301,7.825,31.7
2017,Isère,Huez,1144,245,899,74,825,2,LREM,524,7.825,31.7
2017,Isère,Auberives-sur-Varèze,1144,317,827,85,742,2,FN,421,7.825,31.7
2017,Isère,Auberives-sur-Varèze,1144,317,827,85,742,2,LREM,321,7.825,31.7
2017,Isère,Biol,1145,206,939,81,858,2,FN,468,7.825,31.7
2017,Isère,Biol,1145,206,939,81,858,2,LREM,390,7.825,31.7
2017,Isère,Saint-Prim,1146,268,878,58,820,2,FN,400,7.825,31.7
2017,Isère,Saint-Prim,1146,268,878,58,820,2,LREM,420,7.825,31.7
2017,Isère,Saint-Jean-de-Soudain,1148,286,862,83,779,2,FN,385,7.825,31.7
2017,Isère,Saint-Jean-de-Soudain,1148,286,862,83,779,2,LREM,394,7.825,31.7
2017,Isère,Herbeys,1165,204,961,84,877,2,FN,195,7.825,31.7
2017,Isère,Herbeys,1165,204,961,84,877,2,LREM,682,7.825,31.7
2017,Isère,Saint-Marcel-Bel-Accueil,1197,239,958,77,881,2,FN,340,7.825,31.7
2017,Isère,Saint-Marcel-Bel-Accueil,1197,239,958,77,881,2,LREM,541,7.825,31.7
2017,Isère,Assieu,1200,248,952,75,877,2,FN,455,7.825,31.7
2017,Isère,Assieu,1200,248,952,75,877,2,LREM,422,7.825,31.7
2017,Isère,Creys-Mépieu,1206,266,940,86,854,2,FN,523,7.825,31.7
2017,Isère,Creys-Mépieu,1206,266,940,86,854,2,LREM,331,7.825,31.7
2017,Isère,Revel,1213,257,956,85,871,2,FN,207,7.825,31.7
2017,Isère,Revel,1213,257,956,85,871,2,LREM,664,7.825,31.7
2017,Isère,Mens,1225,306,919,111,808,2,FN,299,7.825,31.7
2017,Isère,Mens,1225,306,919,111,808,2,LREM,509,7.825,31.7
2017,Isère,Beaucroissant,1231,230,1001,104,897,2,FN,433,7.825,31.7
2017,Isère,Beaucroissant,1231,230,1001,104,897,2,LREM,464,7.825,31.7
2017,Isère,Domarin,1232,301,931,77,854,2,FN,332,7.825,31.7
2017,Isère,Domarin,1232,301,931,77,854,2,LREM,522,7.825,31.7
2017,Isère,Clonas-sur-Varèze,1247,270,977,87,890,2,FN,432,7.825,31.7
2017,Isère,Clonas-sur-Varèze,1247,270,977,87,890,2,LREM,458,7.825,31.7
2017,Isère,Janneyrias,1265,245,1020,79,941,2,FN,524,7.825,31.7
2017,Isère,Janneyrias,1265,245,1020,79,941,2,LREM,417,7.825,31.7
2017,Isère,Chamagnieu,1271,250,1021,83,938,2,FN,435,7.825,31.7
2017,Isère,Chamagnieu,1271,250,1021,83,938,2,LREM,503,7.825,31.7
2017,Isère,Saint-Vincent-de-Mercuze,1273,252,1021,77,944,2,FN,304,7.825,31.7
2017,Isère,Saint-Vincent-de-Mercuze,1273,252,1021,77,944,2,LREM,640,7.825,31.7
2017,Isère,Charnècles,1282,269,1013,84,929,2,FN,359,7.825,31.7
2017,Isère,Charnècles,1282,269,1013,84,929,2,LREM,570,7.825,31.7
2017,Isère,Bilieu,1293,324,969,98,871,2,FN,371,7.825,31.7
2017,Isère,Bilieu,1293,324,969,98,871,2,LREM,500,7.825,31.7
2017,Isère,Chonas-l'Amballan,1316,248,1068,85,983,2,FN,398,7.825,31.7
2017,Isère,Chonas-l'Amballan,1316,248,1068,85,983,2,LREM,585,7.825,31.7
2017,Isère,Colombe,1323,254,1069,84,985,2,FN,441,7.825,31.7
2017,Isère,Colombe,1323,254,1069,84,985,2,LREM,544,7.825,31.7
2017,Isère,Montferrat,1327,279,1048,97,951,2,FN,428,7.825,31.7
2017,Isère,Montferrat,1327,279,1048,97,951,2,LREM,523,7.825,31.7
2017,Isère,Artas,1332,302,1030,98,932,2,FN,499,7.825,31.7
2017,Isère,Artas,1332,302,1030,98,932,2,LREM,433,7.825,31.7
2017,Isère,Sermérieu,1333,257,1076,79,997,2,FN,555,7.825,31.7
2017,Isère,Sermérieu,1333,257,1076,79,997,2,LREM,442,7.825,31.7
2017,Isère,La Motte-d'Aveillans,1333,347,986,83,903,2,FN,500,7.825,31.7
2017,Isère,La Motte-d'Aveillans,1333,347,986,83,903,2,LREM,403,7.825,31.7
2017,Isère,Entre-deux-Guiers,1334,345,989,85,904,2,FN,487,7.825,31.7
2017,Isère,Entre-deux-Guiers,1334,345,989,85,904,2,LREM,417,7.825,31.7
2017,Isère,Les Roches-de-Condrieu,1335,291,1044,87,957,2,FN,439,7.825,31.7
2017,Isère,Les Roches-de-Condrieu,1335,291,1044,87,957,2,LREM,518,7.825,31.7
2017,Isère,Romagnieu,1337,275,1062,70,992,2,FN,524,7.825,31.7
2017,Isère,Romagnieu,1337,275,1062,70,992,2,LREM,468,7.825,31.7
2017,Isère,Porcieu-Amblagnieu,1337,373,964,71,893,2,FN,507,7.825,31.7
2017,Isère,Porcieu-Amblagnieu,1337,373,964,71,893,2,LREM,386,7.825,31.7
2017,Isère,Saint-Vérand,1339,273,1066,96,970,2,FN,391,7.825,31.7
2017,Isère,Saint-Vérand,1339,273,1066,96,970,2,LREM,579,7.825,31.7
2017,Isère,Tencin,1339,320,1019,81,938,2,FN,449,7.825,31.7
2017,Isère,Tencin,1339,320,1019,81,938,2,LREM,489,7.825,31.7
2017,Isère,Oytier-Saint-Oblas,1341,309,1032,68,964,2,FN,506,7.825,31.7
2017,Isère,Oytier-Saint-Oblas,1341,309,1032,68,964,2,LREM,458,7.825,31.7
2017,Isère,Saint-Sauveur,1349,273,1076,83,993,2,FN,457,7.825,31.7
2017,Isère,Saint-Sauveur,1349,273,1076,83,993,2,LREM,536,7.825,31.7
2017,Isère,Arandon-Passins,1360,324,1036,71,965,2,FN,612,7.825,31.7
2017,Isère,Arandon-Passins,1360,324,1036,71,965,2,LREM,353,7.825,31.7
2017,Isère,La Bâtie-Montgascon,1361,299,1062,106,956,2,FN,528,7.825,31.7
2017,Isère,La Bâtie-Montgascon,1361,299,1062,106,956,2,LREM,428,7.825,31.7
2017,Isère,Vourey,1362,301,1061,73,988,2,FN,352,7.825,31.7
2017,Isère,Vourey,1362,301,1061,73,988,2,LREM,636,7.825,31.7
2017,Isère,Saint-Romans,1380,277,1103,108,995,2,FN,456,7.825,31.7
2017,Isère,Saint-Romans,1380,277,1103,108,995,2,LREM,539,7.825,31.7
2017,Isère,Sillans,1450,331,1119,97,1022,2,FN,548,7.825,31.7
2017,Isère,Sillans,1450,331,1119,97,1022,2,LREM,474,7.825,31.7
2017,Isère,Miribel-les-Echelles,1457,382,1075,107,968,2,FN,422,7.825,31.7
2017,Isère,Miribel-les-Echelles,1457,382,1075,107,968,2,LREM,546,7.825,31.7
2017,Isère,Serpaize,1459,267,1192,87,1105,2,FN,533,7.825,31.7
2017,Isère,Serpaize,1459,267,1192,87,1105,2,LREM,572,7.825,31.7
2017,Isère,Châtonnay,1459,327,1132,64,1068,2,FN,589,7.825,31.7
2017,Isère,Châtonnay,1459,327,1132,64,1068,2,LREM,479,7.825,31.7
2017,Isère,Villemoirieu,1465,310,1155,100,1055,2,FN,450,7.825,31.7
2017,Isère,Villemoirieu,1465,310,1155,100,1055,2,LREM,605,7.825,31.7
2017,Isère,Charantonnay,1467,301,1166,96,1070,2,FN,604,7.825,31.7
2017,Isère,Charantonnay,1467,301,1166,96,1070,2,LREM,466,7.825,31.7
2017,Isère,Villette-de-Vienne,1468,274,1194,78,1116,2,FN,525,7.825,31.7
2017,Isère,Villette-de-Vienne,1468,274,1194,78,1116,2,LREM,591,7.825,31.7
2017,Isère,Reventin-Vaugris,1484,298,1186,111,1075,2,FN,521,7.825,31.7
2017,Isère,Reventin-Vaugris,1484,298,1186,111,1075,2,LREM,554,7.825,31.7
2017,Isère,Maubec,1499,310,1189,97,1092,2,FN,413,7.825,31.7
2017,Isère,Maubec,1499,310,1189,97,1092,2,LREM,679,7.825,31.7
2017,Isère,La Chapelle-de-la-Tour,1506,273,1233,104,1129,2,FN,582,7.825,31.7
2017,Isère,La Chapelle-de-la-Tour,1506,273,1233,104,1129,2,LREM,547,7.825,31.7
2017,Isère,La Murette,1510,319,1191,85,1106,2,FN,345,7.825,31.7
2017,Isère,La Murette,1510,319,1191,85,1106,2,LREM,761,7.825,31.7
2017,Isère,Sablons,1516,372,1144,94,1050,2,FN,591,7.825,31.7
2017,Isère,Sablons,1516,372,1144,94,1050,2,LREM,459,7.825,31.7
2017,Isère,Le Gua,1523,352,1171,129,1042,2,FN,432,7.825,31.7
2017,Isère,Le Gua,1523,352,1171,129,1042,2,LREM,610,7.825,31.7
2017,Isère,Charavines,1542,401,1141,85,1056,2,FN,454,7.825,31.7
2017,Isère,Charavines,1542,401,1141,85,1056,2,LREM,602,7.825,31.7
2017,Isère,Moidieu-Détourbe,1553,339,1214,97,1117,2,FN,592,7.825,31.7
2017,Isère,Moidieu-Détourbe,1553,339,1214,97,1117,2,LREM,525,7.825,31.7
2017,Isère,Barraux,1555,303,1252,95,1157,2,FN,445,7.825,31.7
2017,Isère,Barraux,1555,303,1252,95,1157,2,LREM,712,7.825,31.7
2017,Isère,Izeaux,1555,406,1149,106,1043,2,FN,529,7.825,31.7
2017,Isère,Izeaux,1555,406,1149,106,1043,2,LREM,514,7.825,31.7
2017,Isère,Trept,1556,350,1206,89,1117,2,FN,614,7.825,31.7
2017,Isère,Trept,1556,350,1206,89,1117,2,LREM,503,7.825,31.7
2017,Isère,Châbons,1564,352,1212,105,1107,2,FN,582,7.825,31.7
2017,Isère,Châbons,1564,352,1212,105,1107,2,LREM,525,7.825,31.7
2017,Isère,Porte-des-Bonnevaux,1579,331,1248,104,1144,2,FN,621,7.825,31.7
2017,Isère,Porte-des-Bonnevaux,1579,331,1248,104,1144,2,LREM,523,7.825,31.7
2017,Isère,Saint-Victor-de-Cessieu,1589,373,1216,109,1107,2,FN,630,7.825,31.7
2017,Isère,Saint-Victor-de-Cessieu,1589,373,1216,109,1107,2,LREM,477,7.825,31.7
2017,Isère,Poisat,1592,304,1288,126,1162,2,FN,332,7.825,31.7
2017,Isère,Poisat,1592,304,1288,126,1162,2,LREM,830,7.825,31.7
2017,Isère,Brézins,1624,440,1184,99,1085,2,FN,564,7.825,31.7
2017,Isère,Brézins,1624,440,1184,99,1085,2,LREM,521,7.825,31.7
2017,Isère,Saint-Alban-de-Roche,1635,364,1271,93,1178,2,FN,444,7.825,31.7
2017,Isère,Saint-Alban-de-Roche,1635,364,1271,93,1178,2,LREM,734,7.825,31.7
2017,Isère,Saint-Hilaire-du-Rosier,1635,417,1218,111,1107,2,FN,600,7.825,31.7
2017,Isère,Saint-Hilaire-du-Rosier,1635,417,1218,111,1107,2,LREM,507,7.825,31.7
2017,Isère,Saint-Didier-de-la-Tour,1643,357,1286,93,1193,2,FN,686,7.825,31.7
2017,Isère,Saint-Didier-de-la-Tour,1643,357,1286,93,1193,2,LREM,507,7.825,31.7
2017,Isère,Septème,1647,357,1290,71,1219,2,FN,710,7.825,31.7
2017,Isère,Septème,1647,357,1290,71,1219,2,LREM,509,7.825,31.7
2017,Isère,Saint-Geoire-en-Valdaine,1662,426,1236,104,1132,2,FN,547,7.825,31.7
2017,Isère,Saint-Geoire-en-Valdaine,1662,426,1236,104,1132,2,LREM,585,7.825,31.7
2017,Isère,Les Côtes-d'Arey,1675,310,1365,107,1258,2,FN,534,7.825,31.7
2017,Isère,Les Côtes-d'Arey,1675,310,1365,107,1258,2,LREM,724,7.825,31.7
2017,Isère,Seyssuel,1678,326,1352,107,1245,2,FN,484,7.825,31.7
2017,Isère,Seyssuel,1678,326,1352,107,1245,2,LREM,761,7.825,31.7
2017,Isère,Noyarey,1704,366,1338,98,1240,2,FN,491,7.825,31.7
2017,Isère,Noyarey,1704,366,1338,98,1240,2,LREM,749,7.825,31.7
2017,Isère,Vézeronce-Curtin,1710,450,1260,100,1160,2,FN,685,7.825,31.7
2017,Isère,Vézeronce-Curtin,1710,450,1260,100,1160,2,LREM,475,7.825,31.7
2017,Isère,Frontonas,1711,305,1406,105,1301,2,FN,562,7.825,31.7
2017,Isère,Frontonas,1711,305,1406,105,1301,2,LREM,739,7.825,31.7
2017,Isère,Lumbin,1729,385,1344,88,1256,2,FN,397,7.825,31.7
2017,Isère,Lumbin,1729,385,1344,88,1256,2,LREM,859,7.825,31.7
2017,Isère,Chanas,1736,428,1308,109,1199,2,FN,685,7.825,31.7
2017,Isère,Chanas,1736,428,1308,109,1199,2,LREM,514,7.825,31.7
2017,Isère,Jardin,1751,347,1404,114,1290,2,FN,469,7.825,31.7
2017,Isère,Jardin,1751,347,1404,114,1290,2,LREM,821,7.825,31.7
2017,Isère,Roche,1766,325,1441,121,1320,2,FN,654,7.825,31.7
2017,Isère,Roche,1766,325,1441,121,1320,2,LREM,666,7.825,31.7
2017,Isère,Theys,1773,344,1429,133,1296,2,FN,462,7.825,31.7
2017,Isère,Theys,1773,344,1429,133,1296,2,LREM,834,7.825,31.7
2017,Isère,Les Deux-Alpes,1779,549,1230,91,1139,2,FN,430,7.825,31.7
2017,Isère,Les Deux-Alpes,1779,549,1230,91,1139,2,LREM,709,7.825,31.7
2017,Isère,Vaulx-Milieu,1783,354,1429,112,1317,2,FN,591,7.825,31.7
2017,Isère,Vaulx-Milieu,1783,354,1429,112,1317,2,LREM,726,7.825,31.7
2017,Isère,Chuzelles,1795,337,1458,116,1342,2,FN,602,7.825,31.7
2017,Isère,Chuzelles,1795,337,1458,116,1342,2,LREM,740,7.825,31.7
2017,Isère,Eyzin-Pinet,1800,403,1397,124,1273,2,FN,593,7.825,31.7
2017,Isère,Eyzin-Pinet,1800,403,1397,124,1273,2,LREM,680,7.825,31.7
2017,Isère,Plateau des Petites Roches,1828,510,1318,168,1150,2,FN,274,7.825,31.7
2017,Isère,Plateau des Petites Roches,1828,510,1318,168,1150,2,LREM,876,7.825,31.7
2017,Isère,Corbelin,1843,428,1415,106,1309,2,FN,690,7.825,31.7
2017,Isère,Corbelin,1843,428,1415,106,1309,2,LREM,619,7.825,31.7
2017,Isère,Aoste,1856,472,1384,97,1287,2,FN,730,7.825,31.7
2017,Isère,Aoste,1856,472,1384,97,1287,2,LREM,557,7.825,31.7
2017,Isère,Nivolas-Vermelle,1860,411,1449,114,1335,2,FN,607,7.825,31.7
2017,Isère,Nivolas-Vermelle,1860,411,1449,114,1335,2,LREM,728,7.825,31.7
2017,Isère,Saint-Georges-de-Commiers,1867,414,1453,125,1328,2,FN,646,7.825,31.7
2017,Isère,Saint-Georges-de-Commiers,1867,414,1453,125,1328,2,LREM,682,7.825,31.7
2017,Isère,Chirens,1873,469,1404,134,1270,2,FN,552,7.825,31.7
2017,Isère,Chirens,1873,469,1404,134,1270,2,LREM,718,7.825,31.7
2017,Isère,Goncelin,1914,483,1431,145,1286,2,FN,513,7.825,31.7
2017,Isère,Goncelin,1914,483,1431,145,1286,2,LREM,773,7.825,31.7
2017,Isère,Satolas-et-Bonce,1917,424,1493,88,1405,2,FN,763,7.825,31.7
2017,Isère,Satolas-et-Bonce,1917,424,1493,88,1405,2,LREM,642,7.825,31.7
2017,Isère,Saint-Paul-de-Varces,1945,350,1595,89,1506,2,FN,546,7.825,31.7
2017,Isère,Saint-Paul-de-Varces,1945,350,1595,89,1506,2,LREM,960,7.825,31.7
2017,Isère,Luzinay,1947,407,1540,118,1422,2,FN,651,7.825,31.7
2017,Isère,Luzinay,1947,407,1540,118,1422,2,LREM,771,7.825,31.7
2017,Isère,La Terrasse,1964,374,1590,130,1460,2,FN,517,7.825,31.7
2017,Isère,La Terrasse,1964,374,1590,130,1460,2,LREM,943,7.825,31.7
2017,Isère,Le Cheylas,1971,545,1426,154,1272,2,FN,538,7.825,31.7
2017,Isère,Le Cheylas,1971,545,1426,154,1272,2,LREM,734,7.825,31.7
2017,Isère,Biviers,2008,317,1691,120,1571,2,FN,344,7.825,31.7
2017,Isère,Biviers,2008,317,1691,120,1571,2,LREM,1227,7.825,31.7
2017,Isère,Le Grand-Lemps,2024,433,1591,142,1449,2,FN,652,7.825,31.7
2017,Isère,Le Grand-Lemps,2024,433,1591,142,1449,2,LREM,797,7.825,31.7
2017,Isère,Villages du lac de Paladru,2044,482,1562,132,1430,2,FN,667,7.825,31.7
2017,Isère,Villages du lac de Paladru,2044,482,1562,132,1430,2,LREM,763,7.825,31.7
2017,Isère,Valencin,2084,422,1662,126,1536,2,FN,751,7.825,31.7
2017,Isère,Valencin,2084,422,1662,126,1536,2,LREM,785,7.825,31.7
2017,Isère,Chatte,2092,505,1587,120,1467,2,FN,659,7.825,31.7
2017,Isère,Chatte,2092,505,1587,120,1467,2,LREM,808,7.825,31.7
2017,Isère,Saint-André-le-Gaz,2098,508,1590,133,1457,2,FN,822,7.825,31.7
2017,Isère,Saint-André-le-Gaz,2098,508,1590,133,1457,2,LREM,635,7.825,31.7
2017,Isère,Brié-et-Angonnes,2112,376,1736,113,1623,2,FN,581,7.825,31.7
2017,Isère,Brié-et-Angonnes,2112,376,1736,113,1623,2,LREM,1042,7.825,31.7
2017,Isère,Montalieu-Vercieu,2134,655,1479,110,1369,2,FN,831,7.825,31.7
2017,Isère,Montalieu-Vercieu,2134,655,1479,110,1369,2,LREM,538,7.825,31.7
2017,Isère,Saint-Siméon-de-Bressieux,2151,588,1563,150,1413,2,FN,714,7.825,31.7
2017,Isère,Saint-Siméon-de-Bressieux,2151,588,1563,150,1413,2,LREM,699,7.825,31.7
2017,Isère,Saint-Just-Chaleyssin,2155,464,1691,129,1562,2,FN,706,7.825,31.7
2017,Isère,Saint-Just-Chaleyssin,2155,464,1691,129,1562,2,LREM,856,7.825,31.7
2017,Isère,Diémoz,2213,486,1727,137,1590,2,FN,932,7.825,31.7
2017,Isère,Diémoz,2213,486,1727,137,1590,2,LREM,658,7.825,31.7
2017,Isère,Cessieu,2223,554,1669,121,1548,2,FN,865,7.825,31.7
2017,Isère,Cessieu,2223,554,1669,121,1548,2,LREM,683,7.825,31.7
2017,Isère,Le Pont-de-Beauvoisin,2250,578,1672,122,1550,2,FN,745,7.825,31.7
2017,Isère,Le Pont-de-Beauvoisin,2250,578,1672,122,1550,2,LREM,805,7.825,31.7
2017,Isère,Crémieu,2262,577,1685,125,1560,2,FN,652,7.825,31.7
2017,Isère,Crémieu,2262,577,1685,125,1560,2,LREM,908,7.825,31.7
2017,Isère,Lans-en-Vercors,2285,460,1825,175,1650,2,FN,419,7.825,31.7
2017,Isère,Lans-en-Vercors,2285,460,1825,175,1650,2,LREM,1231,7.825,31.7
2017,Isère,Renage,2294,614,1680,169,1511,2,FN,680,7.825,31.7
2017,Isère,Renage,2294,614,1680,169,1511,2,LREM,831,7.825,31.7
2017,Isère,Saint-Etienne-de-Crossey,2295,484,1811,140,1671,2,FN,450,7.825,31.7
2017,Isère,Saint-Etienne-de-Crossey,2295,484,1811,140,1671,2,LREM,1221,7.825,31.7
2017,Isère,Chapareillan,2307,498,1809,167,1642,2,FN,669,7.825,31.7
2017,Isère,Chapareillan,2307,498,1809,167,1642,2,LREM,973,7.825,31.7
2017,Isère,Saint-Etienne-de-Saint-Geoirs,2345,593,1752,131,1621,2,FN,807,7.825,31.7
2017,Isère,Saint-Etienne-de-Saint-Geoirs,2345,593,1752,131,1621,2,LREM,814,7.825,31.7
2017,Isère,Fontanil-Cornillon,2416,538,1878,160,1718,2,FN,587,7.825,31.7
2017,Isère,Fontanil-Cornillon,2416,538,1878,160,1718,2,LREM,1131,7.825,31.7
2017,Isère,Saint-Nazaire-les-Eymes,2421,427,1994,128,1866,2,FN,453,7.825,31.7
2017,Isère,Saint-Nazaire-les-Eymes,2421,427,1994,128,1866,2,LREM,1413,7.825,31.7
2017,Isère,Apprieu,2449,515,1934,197,1737,2,FN,754,7.825,31.7
2017,Isère,Apprieu,2449,515,1934,197,1737,2,LREM,983,7.825,31.7
2017,Isère,Saint-Romain-de-Jalionas,2469,491,1978,116,1862,2,FN,1056,7.825,31.7
2017,Isère,Saint-Romain-de-Jalionas,2469,491,1978,116,1862,2,LREM,806,7.825,31.7
2017,Isère,Dolomieu,2474,568,1906,139,1767,2,FN,937,7.825,31.7
2017,Isère,Dolomieu,2474,568,1906,139,1767,2,LREM,830,7.825,31.7
2017,Isère,Saint-Clair-de-la-Tour,2487,697,1790,132,1658,2,FN,852,7.825,31.7
2017,Isère,Saint-Clair-de-la-Tour,2487,697,1790,132,1658,2,LREM,806,7.825,31.7
2017,Isère,Champ-sur-Drac,2515,581,1934,182,1752,2,FN,909,7.825,31.7
2017,Isère,Champ-sur-Drac,2515,581,1934,182,1752,2,LREM,843,7.825,31.7
2017,Isère,Le Bourg-d'Oisans,2540,687,1853,149,1704,2,FN,739,7.825,31.7
2017,Isère,Le Bourg-d'Oisans,2540,687,1853,149,1704,2,LREM,965,7.825,31.7
2017,Isère,Le Touvet,2544,570,1974,171,1803,2,FN,629,7.825,31.7
2017,Isère,Le Touvet,2544,570,1974,171,1803,2,LREM,1174,7.825,31.7
2017,Isère,La Buisse,2578,580,1998,179,1819,2,FN,581,7.825,31.7
2017,Isère,La Buisse,2578,580,1998,179,1819,2,LREM,1238,7.825,31.7
2017,Isère,Crêts en Belledonne,2631,654,1977,165,1812,2,FN,810,7.825,31.7
2017,Isère,Crêts en Belledonne,2631,654,1977,165,1812,2,LREM,1002,7.825,31.7
2017,Isère,Froges,2655,736,1919,176,1743,2,FN,761,7.825,31.7
2017,Isère,Froges,2655,736,1919,176,1743,2,LREM,982,7.825,31.7
2017,Isère,Autrans-Méaudre en Vercors,2665,646,2019,210,1809,2,FN,487,7.825,31.7
2017,Isère,Autrans-Méaudre en Vercors,2665,646,2019,210,1809,2,LREM,1322,7.825,31.7
2017,Isère,Saint-Jean-de-Moirans,2668,659,2009,167,1842,2,FN,666,7.825,31.7
2017,Isère,Saint-Jean-de-Moirans,2668,659,2009,167,1842,2,LREM,1176,7.825,31.7
2017,Isère,Estrablin,2682,498,2184,190,1994,2,FN,928,7.825,31.7
2017,Isère,Estrablin,2682,498,2184,190,1994,2,LREM,1066,7.825,31.7
2017,Isère,Saint-Georges-d'Espéranche,2690,626,2064,171,1893,2,FN,967,7.825,31.7
2017,Isère,Saint-Georges-d'Espéranche,2690,626,2064,171,1893,2,LREM,926,7.825,31.7
2017,Isère,Saint-Chef,2698,600,2098,156,1942,2,FN,1009,7.825,31.7
2017,Isère,Saint-Chef,2698,600,2098,156,1942,2,LREM,933,7.825,31.7
2017,Isère,Bernin,2853,591,2262,146,2116,2,FN,504,7.825,31.7
2017,Isère,Bernin,2853,591,2262,146,2116,2,LREM,1612,7.825,31.7
2017,Isère,Morestel,2982,781,2201,141,2060,2,FN,1015,7.825,31.7
2017,Isère,Morestel,2982,781,2201,141,2060,2,LREM,1045,7.825,31.7
2017,Isère,Jarrie,3033,618,2415,202,2213,2,FN,811,7.825,31.7
2017,Isère,Jarrie,3033,618,2415,202,2213,2,LREM,1402,7.825,31.7
2017,Isère,Chavanoz,3037,834,2203,137,2066,2,FN,1042,7.825,31.7
2017,Isère,Chavanoz,3037,834,2203,137,2066,2,LREM,1024,7.825,31.7
2017,Isère,Saint-Clair-du-Rhône,3064,817,2247,205,2042,2,FN,1052,7.825,31.7
2017,Isère,Saint-Clair-du-Rhône,3064,817,2247,205,2042,2,LREM,990,7.825,31.7
2017,Isère,Vinay,3132,810,2322,199,2123,2,FN,1048,7.825,31.7
2017,Isère,Vinay,3132,810,2322,199,2123,2,LREM,1075,7.825,31.7
2017,Isère,Allevard,3135,945,2190,239,1951,2,FN,801,7.825,31.7
2017,Isère,Allevard,3135,945,2190,239,1951,2,LREM,1150,7.825,31.7
2017,Isère,Vaulnaveys-le-Haut,3225,754,2471,193,2278,2,FN,747,7.825,31.7
2017,Isère,Vaulnaveys-le-Haut,3225,754,2471,193,2278,2,LREM,1531,7.825,31.7
2017,Isère,Beaurepaire,3231,1011,2220,165,2055,2,FN,1088,7.825,31.7
2017,Isère,Beaurepaire,3231,1011,2220,165,2055,2,LREM,967,7.825,31.7
2017,Isère,Saint-Laurent-du-Pont,3260,755,2505,247,2258,2,FN,1091,7.825,31.7
2017,Isère,Saint-Laurent-du-Pont,3260,755,2505,247,2258,2,LREM,1167,7.825,31.7
2017,Isère,La Côte-Saint-André,3283,1041,2242,187,2055,2,FN,936,7.825,31.7
2017,Isère,La Côte-Saint-André,3283,1041,2242,187,2055,2,LREM,1119,7.825,31.7
2017,Isère,Pont-de-Chéruy,3305,1271,2034,128,1906,2,FN,965,7.825,31.7
2017,Isère,Pont-de-Chéruy,3305,1271,2034,128,1906,2,LREM,941,7.825,31.7
2017,Isère,Saint-Savin,3309,781,2528,182,2346,2,FN,1136,7.825,31.7
2017,Isère,Saint-Savin,3309,781,2528,182,2346,2,LREM,1210,7.825,31.7
2017,Isère,La Mure,3327,999,2328,236,2092,2,FN,1097,7.825,31.7
2017,Isère,La Mure,3327,999,2328,236,2092,2,LREM,995,7.825,31.7
2017,Isère,Salaise-sur-Sanne,3361,980,2381,211,2170,2,FN,1024,7.825,31.7
2017,Isère,Salaise-sur-Sanne,3361,980,2381,211,2170,2,LREM,1146,7.825,31.7
2017,Isère,Corenc,3364,626,2738,178,2560,2,FN,520,7.825,31.7
2017,Isère,Corenc,3364,626,2738,178,2560,2,LREM,2040,7.825,31.7
2017,Isère,Heyrieux,3423,744,2679,206,2473,2,FN,1290,7.825,31.7
2017,Isère,Heyrieux,3423,744,2679,206,2473,2,LREM,1183,7.825,31.7
2017,Isère,Villette-d'Anthon,3455,614,2841,165,2676,2,FN,1289,7.825,31.7
2017,Isère,Villette-d'Anthon,3455,614,2841,165,2676,2,LREM,1387,7.825,31.7
2017,Isère,Saint-Quentin-Fallavier,3458,918,2540,230,2310,2,FN,1136,7.825,31.7
2017,Isère,Saint-Quentin-Fallavier,3458,918,2540,230,2310,2,LREM,1174,7.825,31.7
2017,Isère,Saint-Jean-de-Bournay,3467,731,2736,248,2488,2,FN,1334,7.825,31.7
2017,Isère,Saint-Jean-de-Bournay,3467,731,2736,248,2488,2,LREM,1154,7.825,31.7
2017,Isère,Le Versoud,3509,707,2802,227,2575,2,FN,926,7.825,31.7
2017,Isère,Le Versoud,3509,707,2802,227,2575,2,LREM,1649,7.825,31.7
2017,Isère,Saint-Martin-le-Vinoux,3586,1075,2511,224,2287,2,FN,631,7.825,31.7
2017,Isère,Saint-Martin-le-Vinoux,3586,1075,2511,224,2287,2,LREM,1656,7.825,31.7
2017,Isère,Pont-Evêque,3658,1328,2330,195,2135,2,FN,838,7.825,31.7
2017,Isère,Pont-Evêque,3658,1328,2330,195,2135,2,LREM,1297,7.825,31.7
2017,Isère,Le Péage-de-Roussillon,3690,1322,2368,168,2200,2,FN,953,7.825,31.7
2017,Isère,Le Péage-de-Roussillon,3690,1322,2368,168,2200,2,LREM,1247,7.825,31.7
2017,Isère,Ruy-Montceau,3751,770,2981,228,2753,2,FN,1186,7.825,31.7
2017,Isère,Ruy-Montceau,3751,770,2981,228,2753,2,LREM,1567,7.825,31.7
2017,Isère,Chasse-sur-Rhône,3828,1193,2635,212,2423,2,FN,1212,7.825,31.7
2017,Isère,Chasse-sur-Rhône,3828,1193,2635,212,2423,2,LREM,1211,7.825,31.7
2017,Isère,Villard-de-Lans,4062,1007,3055,262,2793,2,FN,907,7.825,31.7
2017,Isère,Villard-de-Lans,4062,1007,3055,262,2793,2,LREM,1886,7.825,31.7
2017,Isère,La Tronche,4070,900,3170,215,2955,2,FN,553,7.825,31.7
2017,Isère,La Tronche,4070,900,3170,215,2955,2,LREM,2402,7.825,31.7
2017,Isère,Coublevie,4149,914,3235,247,2988,2,FN,751,7.825,31.7
2017,Isère,Coublevie,4149,914,3235,247,2988,2,LREM,2237,7.825,31.7
2017,Isère,Montbonnot-Saint-Martin,4202,744,3458,206,3252,2,FN,796,7.825,31.7
2017,Isère,Montbonnot-Saint-Martin,4202,744,3458,206,3252,2,LREM,2456,7.825,31.7
2017,Isère,Rives,4242,1124,3118,257,2861,2,FN,1300,7.825,31.7
2017,Isère,Rives,4242,1124,3118,257,2861,2,LREM,1561,7.825,31.7
2017,Isère,Saint-Maurice-l'Exil,4249,1386,2863,225,2638,2,FN,1359,7.825,31.7
2017,Isère,Saint-Maurice-l'Exil,4249,1386,2863,225,2638,2,LREM,1279,7.825,31.7
2017,Isère,Gières,4520,1063,3457,258,3199,2,FN,978,7.825,31.7
2017,Isère,Gières,4520,1063,3457,258,3199,2,LREM,2221,7.825,31.7
2017,Isère,Les Abrets en Dauphiné,4548,1106,3442,274,3168,2,FN,1794,7.825,31.7
2017,Isère,Les Abrets en Dauphiné,4548,1106,3442,274,3168,2,LREM,1374,7.825,31.7
2017,Isère,La Verpillière,4605,1391,3214,254,2960,2,FN,1386,7.825,31.7
2017,Isère,La Verpillière,4605,1391,3214,254,2960,2,LREM,1574,7.825,31.7
2017,Isère,Saint-Martin-d'Uriage,4674,890,3784,248,3536,2,FN,815,7.825,31.7
2017,Isère,Saint-Martin-d'Uriage,4674,890,3784,248,3536,2,LREM,2721,7.825,31.7
2017,Isère,La Tour-du-Pin,4924,1690,3234,243,2991,2,FN,1344,7.825,31.7
2017,Isère,La Tour-du-Pin,4924,1690,3234,243,2991,2,LREM,1647,7.825,31.7
2017,Isère,Vizille,4979,1667,3312,284,3028,2,FN,1377,7.825,31.7
2017,Isère,Vizille,4979,1667,3312,284,3028,2,LREM,1651,7.825,31.7
2017,Isère,Domène,5049,1350,3699,336,3363,2,FN,1375,7.825,31.7
2017,Isère,Domène,5049,1350,3699,336,3363,2,LREM,1988,7.825,31.7
2017,Isère,Villard-Bonnot,5144,1392,3752,317,3435,2,FN,1389,7.825,31.7
2017,Isère,Villard-Bonnot,5144,1392,3752,317,3435,2,LREM,2046,7.825,31.7
2017,Isère,Saint-Marcellin,5205,1462,3743,384,3359,2,FN,1366,7.825,31.7
2017,Isère,Saint-Marcellin,5205,1462,3743,384,3359,2,LREM,1993,7.825,31.7
2017,Isère,Pontcharra,5221,1398,3823,317,3506,2,FN,1508,7.825,31.7
2017,Isère,Pontcharra,5221,1398,3823,317,3506,2,LREM,1998,7.825,31.7
2017,Isère,Varces-Allières-et-Risset,5265,1309,3956,289,3667,2,FN,1493,7.825,31.7
2017,Isère,Varces-Allières-et-Risset,5265,1309,3956,289,3667,2,LREM,2174,7.825,31.7
2017,Isère,Tignieu-Jameyzieu,5324,1502,3822,237,3585,2,FN,1806,7.825,31.7
2017,Isère,Tignieu-Jameyzieu,5324,1502,3822,237,3585,2,LREM,1779,7.825,31.7
2017,Isère,Roussillon,5572,1792,3780,346,3434,2,FN,1590,7.825,31.7
2017,Isère,Roussillon,5572,1792,3780,346,3434,2,LREM,1844,7.825,31.7
2017,Isère,Tullins,5591,1703,3888,329,3559,2,FN,1502,7.825,31.7
2017,Isère,Tullins,5591,1703,3888,329,3559,2,LREM,2057,7.825,31.7
2017,Isère,Seyssins,5838,1088,4750,372,4378,2,FN,1315,7.825,31.7
2017,Isère,Seyssins,5838,1088,4750,372,4378,2,LREM,3063,7.825,31.7
2017,Isère,Les Avenières Veyrins-Thuellin,5918,1651,4267,309,3958,2,FN,2253,7.825,31.7
2017,Isère,Les Avenières Veyrins-Thuellin,5918,1651,4267,309,3958,2,LREM,1705,7.825,31.7
2017,Isère,Saint-Ismier,5974,1177,4797,275,4522,2,FN,1034,7.825,31.7
2017,Isère,Saint-Ismier,5974,1177,4797,275,4522,2,LREM,3488,7.825,31.7
2017,Isère,Moirans,6069,1839,4230,408,3822,2,FN,1547,7.825,31.7
2017,Isère,Moirans,6069,1839,4230,408,3822,2,LREM,2275,7.825,31.7
2017,Isère,Le Pont-de-Claix,6502,2355,4147,357,3790,2,FN,1581,7.825,31.7
2017,Isère,Le Pont-de-Claix,6502,2355,4147,357,3790,2,LREM,2209,7.825,31.7
2017,Isère,Charvieu-Chavagneux,6505,1971,4534,291,4243,2,FN,2321,7.825,31.7
2017,Isère,Charvieu-Chavagneux,6505,1971,4534,291,4243,2,LREM,1922,7.825,31.7
2017,Isère,Claix,6650,1540,5110,383,4727,2,FN,1360,7.825,31.7
2017,Isère,Claix,6650,1540,5110,383,4727,2,LREM,3367,7.825,31.7
2017,Isère,Crolles,6653,1487,5166,412,4754,2,FN,1195,7.825,31.7
2017,Isère,Crolles,6653,1487,5166,412,4754,2,LREM,3559,7.825,31.7
2017,Isère,Vif,6676,1638,5038,400,4638,2,FN,2073,7.825,31.7
2017,Isère,Vif,6676,1638,5038,400,4638,2,LREM,2565,7.825,31.7
2017,Isère,Voreppe,6903,1535,5368,443,4925,2,FN,1702,7.825,31.7
2017,Isère,Voreppe,6903,1535,5368,443,4925,2,LREM,3223,7.825,31.7
2017,Isère,Eybens,7042,1876,5166,431,4735,2,FN,1550,7.825,31.7
2017,Isère,Eybens,7042,1876,5166,431,4735,2,LREM,3185,7.825,31.7
2017,Isère,Sassenage,8033,1794,6239,449,5790,2,FN,2242,7.825,31.7
2017,Isère,Sassenage,8033,1794,6239,449,5790,2,LREM,3548,7.825,31.7
2017,Isère,Seyssinet-Pariset,8325,2103,6222,533,5689,2,FN,1967,7.825,31.7
2017,Isère,Seyssinet-Pariset,8325,2103,6222,533,5689,2,LREM,3722,7.825,31.7
2017,Isère,L'Isle-d'Abeau,9844,3371,6473,439,6034,2,FN,2740,7.825,31.7
2017,Isère,L'Isle-d'Abeau,9844,3371,6473,439,6034,2,LREM,3294,7.825,31.7
2017,Isère,Villefontaine,11142,4311,6831,534,6297,2,FN,2573,7.825,31.7
2017,Isère,Villefontaine,11142,4311,6831,534,6297,2,LREM,3724,7.825,31.7
2017,Isère,Saint-Egrève,11839,2901,8938,709,8229,2,FN,2360,7.825,31.7
2017,Isère,Saint-Egrève,11839,2901,8938,709,8229,2,LREM,5869,7.825,31.7
2017,Isère,Fontaine,12913,4086,8827,744,8083,2,FN,2879,7.825,31.7
2017,Isère,Fontaine,12913,4086,8827,744,8083,2,LREM,5204,7.825,31.7
2017,Isère,Meylan,14214,3110,11104,712,10392,2,FN,2396,7.825,31.7
2017,Isère,Meylan,14214,3110,11104,712,10392,2,LREM,7996,7.825,31.7
2017,Isère,Voiron,15093,4447,10646,949,9697,2,FN,3163,7.825,31.7
2017,Isère,Voiron,15093,4447,10646,949,9697,2,LREM,6534,7.825,31.7
2017,Isère,Bourgoin-Jallieu,17466,5822,11644,980,10664,2,FN,4132,7.825,31.7
2017,Isère,Bourgoin-Jallieu,17466,5822,11644,980,10664,2,LREM,6532,7.825,31.7
2017,Isère,Saint-Martin-d'Hères,18098,6191,11907,1074,10833,2,FN,3614,7.825,31.7
2017,Isère,Saint-Martin-d'Hères,18098,6191,11907,1074,10833,2,LREM,7219,7.825,31.7
2017,Isère,Vienne,19136,5977,13159,1212,11947,2,FN,4171,7.825,31.7
2017,Isère,Vienne,19136,5977,13159,1212,11947,2,LREM,7776,7.825,31.7
2017,Isère,Echirolles,20686,7376,13310,1152,12158,2,FN,4167,7.825,31.7
2017,Isère,Echirolles,20686,7376,13310,1152,12158,2,LREM,7991,7.825,31.7
2017,Isère,Grenoble,86584,27656,58928,4784,54144,2,FN,11511,7.825,31.7
2017,Isère,Grenoble,86584,27656,58928,4784,54144,2,LREM,42633,7.825,31.7
2012,ISERE,Clelles,1792,216,1576,30,1546,1,DLF,21,8.049999999999999,32.5
2012,ISERE,Clelles,1792,216,1576,30,1546,1,EELV,73,8.049999999999999,32.5
2012,ISERE,Clelles,1792,216,1576,30,1546,1,FN,266,8.049999999999999,32.5
2012,ISERE,Clelles,1792,216,1576,30,1546,1,LFI,248,8.049999999999999,32.5
2012,ISERE,Clelles,1792,216,1576,30,1546,1,LO,10,8.049999999999999,32.5
2012,ISERE,Clelles,1792,216,1576,30,1546,1,MODEM,107,8.049999999999999,32.5
2012,ISERE,Clelles,1792,216,1576,30,1546,1,NPA,17,8.049999999999999,32.5
2012,ISERE,Clelles,1792,216,1576,30,1546,1,PS,362,8.049999999999999,32.5
2012,ISERE,Clelles,1792,216,1576,30,1546,1,SP,2,8.049999999999999,32.5
2012,ISERE,Clelles,1792,216,1576,30,1546,1,UMP,440,8.049999999999999,32.5
2012,ISERE,Valbonnais,1879,314,1565,30,1535,1,DLF,43,8.049999999999999,32.5
2012,ISERE,Valbonnais,1879,314,1565,30,1535,1,EELV,56,8.049999999999999,32.5
2012,ISERE,Valbonnais,1879,314,1565,30,1535,1,FN,298,8.049999999999999,32.5
2012,ISERE,Valbonnais,1879,314,1565,30,1535,1,LFI,194,8.049999999999999,32.5
2012,ISERE,Valbonnais,1879,314,1565,30,1535,1,LO,13,8.049999999999999,32.5
2012,ISERE,Valbonnais,1879,314,1565,30,1535,1,MODEM,118,8.049999999999999,32.5
2012,ISERE,Valbonnais,1879,314,1565,30,1535,1,NPA,20,8.049999999999999,32.5
2012,ISERE,Valbonnais,1879,314,1565,30,1535,1,PS,476,8.049999999999999,32.5
2012,ISERE,Valbonnais,1879,314,1565,30,1535,1,SP,6,8.049999999999999,32.5
2012,ISERE,Valbonnais,1879,314,1565,30,1535,1,UMP,311,8.049999999999999,32.5
2012,ISERE,Corps,1927,326,1601,29,1572,1,DLF,49,8.049999999999999,32.5
2012,ISERE,Corps,1927,326,1601,29,1572,1,EELV,46,8.049999999999999,32.5
2012,ISERE,Corps,1927,326,1601,29,1572,1,FN,309,8.049999999999999,32.5
2012,ISERE,Corps,1927,326,1601,29,1572,1,LFI,173,8.049999999999999,32.5
2012,ISERE,Corps,1927,326,1601,29,1572,1,LO,9,8.049999999999999,32.5
2012,ISERE,Corps,1927,326,1601,29,1572,1,MODEM,108,8.049999999999999,32.5
2012,ISERE,Corps,1927,326,1601,29,1572,1,NPA,13,8.049999999999999,32.5
2012,ISERE,Corps,1927,326,1601,29,1572,1,PS,425,8.049999999999999,32.5
2012,ISERE,Corps,1927,326,1601,29,1572,1,SP,4,8.049999999999999,32.5
2012,ISERE,Corps,1927,326,1601,29,1572,1,UMP,436,8.049999999999999,32.5
2012,ISERE,Mens,2778,409,2369,41,2328,1,DLF,51,8.049999999999999,32.5
2012,ISERE,Mens,2778,409,2369,41,2328,1,EELV,155,8.049999999999999,32.5
2012,ISERE,Mens,2778,409,2369,41,2328,1,FN,334,8.049999999999999,32.5
2012,ISERE,Mens,2778,409,2369,41,2328,1,LFI,351,8.049999999999999,32.5
2012,ISERE,Mens,2778,409,2369,41,2328,1,LO,11,8.049999999999999,32.5
2012,ISERE,Mens,2778,409,2369,41,2328,1,MODEM,173,8.049999999999999,32.5
2012,ISERE,Mens,2778,409,2369,41,2328,1,NPA,33,8.049999999999999,32.5
2012,ISERE,Mens,2778,409,2369,41,2328,1,PS,651,8.049999999999999,32.5
2012,ISERE,Mens,2778,409,2369,41,2328,1,SP,4,8.049999999999999,32.5
2012,ISERE,Mens,2778,409,2369,41,2328,1,UMP,565,8.049999999999999,32.5
2012,ISERE,Monestier-de-Clermont,3764,479,3285,43,3242,1,DLF,84,8.049999999999999,32.5
2012,ISERE,Monestier-de-Clermont,3764,479,3285,43,3242,1,EELV,132,8.049999999999999,32.5
2012,ISERE,Monestier-de-Clermont,3764,479,3285,43,3242,1,FN,561,8.049999999999999,32.5
2012,ISERE,Monestier-de-Clermont,3764,479,3285,43,3242,1,LFI,460,8.049999999999999,32.5
2012,ISERE,Monestier-de-Clermont,3764,479,3285,43,3242,1,LO,18,8.049999999999999,32.5
2012,ISERE,Monestier-de-Clermont,3764,479,3285,43,3242,1,MODEM,348,8.049999999999999,32.5
2012,ISERE,Monestier-de-Clermont,3764,479,3285,43,3242,1,NPA,44,8.049999999999999,32.5
2012,ISERE,Monestier-de-Clermont,3764,479,3285,43,3242,1,PS,816,8.049999999999999,32.5
2012,ISERE,Monestier-de-Clermont,3764,479,3285,43,3242,1,SP,14,8.049999999999999,32.5
2012,ISERE,Monestier-de-Clermont,3764,479,3285,43,3242,1,UMP,765,8.049999999999999,32.5
2012,ISERE,Pont-en-Royans,4886,778,4108,113,3995,1,DLF,75,8.049999999999999,32.5
2012,ISERE,Pont-en-Royans,4886,778,4108,113,3995,1,EELV,120,8.049999999999999,32.5
2012,ISERE,Pont-en-Royans,4886,778,4108,113,3995,1,FN,885,8.049999999999999,32.5
2012,ISERE,Pont-en-Royans,4886,778,4108,113,3995,1,LFI,559,8.049999999999999,32.5
2012,ISERE,Pont-en-Royans,4886,778,4108,113,3995,1,LO,32,8.049999999999999,32.5
2012,ISERE,Pont-en-Royans,4886,778,4108,113,3995,1,MODEM,357,8.049999999999999,32.5
2012,ISERE,Pont-en-Royans,4886,778,4108,113,3995,1,NPA,56,8.049999999999999,32.5
2012,ISERE,Pont-en-Royans,4886,778,4108,113,3995,1,PS,954,8.049999999999999,32.5
2012,ISERE,Pont-en-Royans,4886,778,4108,113,3995,1,SP,10,8.049999999999999,32.5
2012,ISERE,Pont-en-Royans,4886,778,4108,113,3995,1,UMP,947,8.049999999999999,32.5
2012,ISERE,Roybon,5012,772,4240,104,4136,1,DLF,89,8.049999999999999,32.5
2012,ISERE,Roybon,5012,772,4240,104,4136,1,EELV,91,8.049999999999999,32.5
2012,ISERE,Roybon,5012,772,4240,104,4136,1,FN,957,8.049999999999999,32.5
2012,ISERE,Roybon,5012,772,4240,104,4136,1,LFI,500,8.049999999999999,32.5
2012,ISERE,Roybon,5012,772,4240,104,4136,1,LO,31,8.049999999999999,32.5
2012,ISERE,Roybon,5012,772,4240,104,4136,1,MODEM,405,8.049999999999999,32.5
2012,ISERE,Roybon,5012,772,4240,104,4136,1,NPA,58,8.049999999999999,32.5
2012,ISERE,Roybon,5012,772,4240,104,4136,1,PS,976,8.049999999999999,32.5
2012,ISERE,Roybon,5012,772,4240,104,4136,1,SP,7,8.049999999999999,32.5
2012,ISERE,Roybon,5012,772,4240,104,4136,1,UMP,1022,8.049999999999999,32.5
2012,ISERE,Allevard,5779,972,4807,75,4732,1,DLF,118,8.049999999999999,32.5
2012,ISERE,Allevard,5779,972,4807,75,4732,1,EELV,167,8.049999999999999,32.5
2012,ISERE,Allevard,5779,972,4807,75,4732,1,FN,823,8.049999999999999,32.5
2012,ISERE,Allevard,5779,972,4807,75,4732,1,LFI,718,8.049999999999999,32.5
2012,ISERE,Allevard,5779,972,4807,75,4732,1,LO,31,8.049999999999999,32.5
2012,ISERE,Allevard,5779,972,4807,75,4732,1,MODEM,404,8.049999999999999,32.5
2012,ISERE,Allevard,5779,972,4807,75,4732,1,NPA,64,8.049999999999999,32.5
2012,ISERE,Allevard,5779,972,4807,75,4732,1,PS,1377,8.049999999999999,32.5
2012,ISERE,Allevard,5779,972,4807,75,4732,1,SP,12,8.049999999999999,32.5
2012,ISERE,Allevard,5779,972,4807,75,4732,1,UMP,1018,8.049999999999999,32.5
2012,ISERE,Vinay,6752,1162,5590,140,5450,1,DLF,101,8.049999999999999,32.5
2012,ISERE,Vinay,6752,1162,5590,140,5450,1,EELV,154,8.049999999999999,32.5
2012,ISERE,Vinay,6752,1162,5590,140,5450,1,FN,1315,8.049999999999999,32.5
2012,ISERE,Vinay,6752,1162,5590,140,5450,1,LFI,695,8.049999999999999,32.5
2012,ISERE,Vinay,6752,1162,5590,140,5450,1,LO,44,8.049999999999999,32.5
2012,ISERE,Vinay,6752,1162,5590,140,5450,1,MODEM,480,8.049999999999999,32.5
2012,ISERE,Vinay,6752,1162,5590,140,5450,1,NPA,62,8.049999999999999,32.5
2012,ISERE,Vinay,6752,1162,5590,140,5450,1,PS,1269,8.049999999999999,32.5
2012,ISERE,Vinay,6752,1162,5590,140,5450,1,SP,17,8.049999999999999,32.5
2012,ISERE,Vinay,6752,1162,5590,140,5450,1,UMP,1313,8.049999999999999,32.5
2012,ISERE,SAINT-MARTIN-D'HERES-SUD,6769,1440,5329,87,5242,1,DLF,61,8.049999999999999,32.5
2012,ISERE,SAINT-MARTIN-D'HERES-SUD,6769,1440,5329,87,5242,1,EELV,155,8.049999999999999,32.5
2012,ISERE,SAINT-MARTIN-D'HERES-SUD,6769,1440,5329,87,5242,1,FN,882,8.049999999999999,32.5
2012,ISERE,SAINT-MARTIN-D'HERES-SUD,6769,1440,5329,87,5242,1,LFI,933,8.049999999999999,32.5
2012,ISERE,SAINT-MARTIN-D'HERES-SUD,6769,1440,5329,87,5242,1,LO,25,8.049999999999999,32.5
2012,ISERE,SAINT-MARTIN-D'HERES-SUD,6769,1440,5329,87,5242,1,MODEM,374,8.049999999999999,32.5
2012,ISERE,SAINT-MARTIN-D'HERES-SUD,6769,1440,5329,87,5242,1,NPA,60,8.049999999999999,32.5
2012,ISERE,SAINT-MARTIN-D'HERES-SUD,6769,1440,5329,87,5242,1,PS,1861,8.049999999999999,32.5
2012,ISERE,SAINT-MARTIN-D'HERES-SUD,6769,1440,5329,87,5242,1,SP,7,8.049999999999999,32.5
2012,ISERE,SAINT-MARTIN-D'HERES-SUD,6769,1440,5329,87,5242,1,UMP,884,8.049999999999999,32.5
2012,ISERE,Saint-Geoire-en-Valdaine,7138,1156,5982,103,5879,1,DLF,119,8.049999999999999,32.5
2012,ISERE,Saint-Geoire-en-Valdaine,7138,1156,5982,103,5879,1,EELV,171,8.049999999999999,32.5
2012,ISERE,Saint-Geoire-en-Valdaine,7138,1156,5982,103,5879,1,FN,1318,8.049999999999999,32.5
2012,ISERE,Saint-Geoire-en-Valdaine,7138,1156,5982,103,5879,1,LFI,665,8.049999999999999,32.5
2012,ISERE,Saint-Geoire-en-Valdaine,7138,1156,5982,103,5879,1,LO,37,8.049999999999999,32.5
2012,ISERE,Saint-Geoire-en-Valdaine,7138,1156,5982,103,5879,1,MODEM,539,8.049999999999999,32.5
2012,ISERE,Saint-Geoire-en-Valdaine,7138,1156,5982,103,5879,1,NPA,75,8.049999999999999,32.5
2012,ISERE,Saint-Geoire-en-Valdaine,7138,1156,5982,103,5879,1,PS,1311,8.049999999999999,32.5
2012,ISERE,Saint-Geoire-en-Valdaine,7138,1156,5982,103,5879,1,SP,18,8.049999999999999,32.5
2012,ISERE,Saint-Geoire-en-Valdaine,7138,1156,5982,103,5879,1,UMP,1626,8.049999999999999,32.5
2012,ISERE,ECHIROLLES-EST,8325,1642,6683,104,6579,1,DLF,72,8.049999999999999,32.5
2012,ISERE,ECHIROLLES-EST,8325,1642,6683,104,6579,1,EELV,183,8.049999999999999,32.5
2012,ISERE,ECHIROLLES-EST,8325,1642,6683,104,6579,1,FN,1046,8.049999999999999,32.5
2012,ISERE,ECHIROLLES-EST,8325,1642,6683,104,6579,1,LFI,1274,8.049999999999999,32.5
2012,ISERE,ECHIROLLES-EST,8325,1642,6683,104,6579,1,LO,42,8.049999999999999,32.5
2012,ISERE,ECHIROLLES-EST,8325,1642,6683,104,6579,1,MODEM,439,8.049999999999999,32.5
2012,ISERE,ECHIROLLES-EST,8325,1642,6683,104,6579,1,NPA,69,8.049999999999999,32.5
2012,ISERE,ECHIROLLES-EST,8325,1642,6683,104,6579,1,PS,2342,8.049999999999999,32.5
2012,ISERE,ECHIROLLES-EST,8325,1642,6683,104,6579,1,SP,7,8.049999999999999,32.5
2012,ISERE,ECHIROLLES-EST,8325,1642,6683,104,6579,1,UMP,1105,8.049999999999999,32.5
2012,ISERE,VIRIEU,8346,1257,7089,137,6952,1,DLF,150,8.049999999999999,32.5
2012,ISERE,VIRIEU,8346,1257,7089,137,6952,1,EELV,161,8.049999999999999,32.5
2012,ISERE,VIRIEU,8346,1257,7089,137,6952,1,FN,1560,8.049999999999999,32.5
2012,ISERE,VIRIEU,8346,1257,7089,137,6952,1,LFI,800,8.049999999999999,32.5
2012,ISERE,VIRIEU,8346,1257,7089,137,6952,1,LO,48,8.049999999999999,32.5
2012,ISERE,VIRIEU,8346,1257,7089,137,6952,1,MODEM,728,8.049999999999999,32.5
2012,ISERE,VIRIEU,8346,1257,7089,137,6952,1,NPA,91,8.049999999999999,32.5
2012,ISERE,VIRIEU,8346,1257,7089,137,6952,1,PS,1581,8.049999999999999,32.5
2012,ISERE,VIRIEU,8346,1257,7089,137,6952,1,SP,19,8.049999999999999,32.5
2012,ISERE,VIRIEU,8346,1257,7089,137,6952,1,UMP,1814,8.049999999999999,32.5
2012,ISERE,Saint-Laurent-du-Pont,8625,1475,7150,142,7008,1,DLF,155,8.049999999999999,32.5
2012,ISERE,Saint-Laurent-du-Pont,8625,1475,7150,142,7008,1,EELV,230,8.049999999999999,32.5
2012,ISERE,Saint-Laurent-du-Pont,8625,1475,7150,142,7008,1,FN,1450,8.049999999999999,32.5
2012,ISERE,Saint-Laurent-du-Pont,8625,1475,7150,142,7008,1,LFI,891,8.049999999999999,32.5
2012,ISERE,Saint-Laurent-du-Pont,8625,1475,7150,142,7008,1,LO,46,8.049999999999999,32.5
2012,ISERE,Saint-Laurent-du-Pont,8625,1475,7150,142,7008,1,MODEM,740,8.049999999999999,32.5
2012,ISERE,Saint-Laurent-du-Pont,8625,1475,7150,142,7008,1,NPA,101,8.049999999999999,32.5
2012,ISERE,Saint-Laurent-du-Pont,8625,1475,7150,142,7008,1,PS,1560,8.049999999999999,32.5
2012,ISERE,Saint-Laurent-du-Pont,8625,1475,7150,142,7008,1,SP,24,8.049999999999999,32.5
2012,ISERE,Saint-Laurent-du-Pont,8625,1475,7150,142,7008,1,UMP,1811,8.049999999999999,32.5
2012,ISERE,Saint-Etienne-de-Saint-Geoirs,9182,1502,7680,167,7513,1,DLF,155,8.049999999999999,32.5
2012,ISERE,Saint-Etienne-de-Saint-Geoirs,9182,1502,7680,167,7513,1,EELV,150,8.049999999999999,32.5
2012,ISERE,Saint-Etienne-de-Saint-Geoirs,9182,1502,7680,167,7513,1,FN,1636,8.049999999999999,32.5
2012,ISERE,Saint-Etienne-de-Saint-Geoirs,9182,1502,7680,167,7513,1,LFI,812,8.049999999999999,32.5
2012,ISERE,Saint-Etienne-de-Saint-Geoirs,9182,1502,7680,167,7513,1,LO,54,8.049999999999999,32.5
2012,ISERE,Saint-Etienne-de-Saint-Geoirs,9182,1502,7680,167,7513,1,MODEM,698,8.049999999999999,32.5
2012,ISERE,Saint-Etienne-de-Saint-Geoirs,9182,1502,7680,167,7513,1,NPA,95,8.049999999999999,32.5
2012,ISERE,Saint-Etienne-de-Saint-Geoirs,9182,1502,7680,167,7513,1,PS,1886,8.049999999999999,32.5
2012,ISERE,Saint-Etienne-de-Saint-Geoirs,9182,1502,7680,167,7513,1,SP,17,8.049999999999999,32.5
2012,ISERE,Saint-Etienne-de-Saint-Geoirs,9182,1502,7680,167,7513,1,UMP,2010,8.049999999999999,32.5
2012,ISERE,Tullins,9260,1550,7710,168,7542,1,DLF,165,8.049999999999999,32.5
2012,ISERE,Tullins,9260,1550,7710,168,7542,1,EELV,210,8.049999999999999,32.5
2012,ISERE,Tullins,9260,1550,7710,168,7542,1,FN,1624,8.049999999999999,32.5
2012,ISERE,Tullins,9260,1550,7710,168,7542,1,LFI,923,8.049999999999999,32.5
2012,ISERE,Tullins,9260,1550,7710,168,7542,1,LO,42,8.049999999999999,32.5
2012,ISERE,Tullins,9260,1550,7710,168,7542,1,MODEM,711,8.049999999999999,32.5
2012,ISERE,Tullins,9260,1550,7710,168,7542,1,NPA,76,8.049999999999999,32.5
2012,ISERE,Tullins,9260,1550,7710,168,7542,1,PS,2085,8.049999999999999,32.5
2012,ISERE,Tullins,9260,1550,7710,168,7542,1,SP,28,8.049999999999999,32.5
2012,ISERE,Tullins,9260,1550,7710,168,7542,1,UMP,1678,8.049999999999999,32.5
2012,ISERE,LE-BOURG-D'OISANS,9271,1928,7343,139,7204,1,DLF,144,8.049999999999999,32.5
2012,ISERE,LE-BOURG-D'OISANS,9271,1928,7343,139,7204,1,EELV,220,8.049999999999999,32.5
2012,ISERE,LE-BOURG-D'OISANS,9271,1928,7343,139,7204,1,FN,1233,8.049999999999999,32.5
2012,ISERE,LE-BOURG-D'OISANS,9271,1928,7343,139,7204,1,LFI,890,8.049999999999999,32.5
2012,ISERE,LE-BOURG-D'OISANS,9271,1928,7343,139,7204,1,LO,38,8.049999999999999,32.5
2012,ISERE,LE-BOURG-D'OISANS,9271,1928,7343,139,7204,1,MODEM,572,8.049999999999999,32.5
2012,ISERE,LE-BOURG-D'OISANS,9271,1928,7343,139,7204,1,NPA,84,8.049999999999999,32.5
2012,ISERE,LE-BOURG-D'OISANS,9271,1928,7343,139,7204,1,PS,1689,8.049999999999999,32.5
2012,ISERE,LE-BOURG-D'OISANS,9271,1928,7343,139,7204,1,SP,21,8.049999999999999,32.5
2012,ISERE,LE-BOURG-D'OISANS,9271,1928,7343,139,7204,1,UMP,2313,8.049999999999999,32.5
2012,ISERE,Villard-de-Lans,9757,1361,8396,112,8284,1,DLF,177,8.049999999999999,32.5
2012,ISERE,Villard-de-Lans,9757,1361,8396,112,8284,1,EELV,492,8.049999999999999,32.5
2012,ISERE,Villard-de-Lans,9757,1361,8396,112,8284,1,FN,975,8.049999999999999,32.5
2012,ISERE,Villard-de-Lans,9757,1361,8396,112,8284,1,LFI,1201,8.049999999999999,32.5
2012,ISERE,Villard-de-Lans,9757,1361,8396,112,8284,1,LO,40,8.049999999999999,32.5
2012,ISERE,Villard-de-Lans,9757,1361,8396,112,8284,1,MODEM,776,8.049999999999999,32.5
2012,ISERE,Villard-de-Lans,9757,1361,8396,112,8284,1,NPA,97,8.049999999999999,32.5
2012,ISERE,Villard-de-Lans,9757,1361,8396,112,8284,1,PS,2110,8.049999999999999,32.5
2012,ISERE,Villard-de-Lans,9757,1361,8396,112,8284,1,SP,25,8.049999999999999,32.5
2012,ISERE,Villard-de-Lans,9757,1361,8396,112,8284,1,UMP,2391,8.049999999999999,32.5
2012,ISERE,LA-COTE-SAINT-ANDRE,10717,1747,8970,167,8803,1,DLF,190,8.049999999999999,32.5
2012,ISERE,LA-COTE-SAINT-ANDRE,10717,1747,8970,167,8803,1,EELV,209,8.049999999999999,32.5
2012,ISERE,LA-COTE-SAINT-ANDRE,10717,1747,8970,167,8803,1,FN,2177,8.049999999999999,32.5
2012,ISERE,LA-COTE-SAINT-ANDRE,10717,1747,8970,167,8803,1,LFI,889,8.049999999999999,32.5
2012,ISERE,LA-COTE-SAINT-ANDRE,10717,1747,8970,167,8803,1,LO,54,8.049999999999999,32.5
2012,ISERE,LA-COTE-SAINT-ANDRE,10717,1747,8970,167,8803,1,MODEM,886,8.049999999999999,32.5
2012,ISERE,LA-COTE-SAINT-ANDRE,10717,1747,8970,167,8803,1,NPA,105,8.049999999999999,32.5
2012,ISERE,LA-COTE-SAINT-ANDRE,10717,1747,8970,167,8803,1,PS,1938,8.049999999999999,32.5
2012,ISERE,LA-COTE-SAINT-ANDRE,10717,1747,8970,167,8803,1,SP,27,8.049999999999999,32.5
2012,ISERE,LA-COTE-SAINT-ANDRE,10717,1747,8970,167,8803,1,UMP,2328,8.049999999999999,32.5
2012,ISERE,Beaurepaire,10762,1883,8879,188,8691,1,DLF,217,8.049999999999999,32.5
2012,ISERE,Beaurepaire,10762,1883,8879,188,8691,1,EELV,206,8.049999999999999,32.5
2012,ISERE,Beaurepaire,10762,1883,8879,188,8691,1,FN,2332,8.049999999999999,32.5
2012,ISERE,Beaurepaire,10762,1883,8879,188,8691,1,LFI,1019,8.049999999999999,32.5
2012,ISERE,Beaurepaire,10762,1883,8879,188,8691,1,LO,58,8.049999999999999,32.5
2012,ISERE,Beaurepaire,10762,1883,8879,188,8691,1,MODEM,671,8.049999999999999,32.5
2012,ISERE,Beaurepaire,10762,1883,8879,188,8691,1,NPA,104,8.049999999999999,32.5
2012,ISERE,Beaurepaire,10762,1883,8879,188,8691,1,PS,2013,8.049999999999999,32.5
2012,ISERE,Beaurepaire,10762,1883,8879,188,8691,1,SP,28,8.049999999999999,32.5
2012,ISERE,Beaurepaire,10762,1883,8879,188,8691,1,UMP,2043,8.049999999999999,32.5
2012,ISERE,La Mure,10784,1880,8904,178,8726,1,DLF,222,8.049999999999999,32.5
2012,ISERE,La Mure,10784,1880,8904,178,8726,1,EELV,264,8.049999999999999,32.5
2012,ISERE,La Mure,10784,1880,8904,178,8726,1,FN,1906,8.049999999999999,32.5
2012,ISERE,La Mure,10784,1880,8904,178,8726,1,LFI,1318,8.049999999999999,32.5
2012,ISERE,La Mure,10784,1880,8904,178,8726,1,LO,53,8.049999999999999,32.5
2012,ISERE,La Mure,10784,1880,8904,178,8726,1,MODEM,570,8.049999999999999,32.5
2012,ISERE,La Mure,10784,1880,8904,178,8726,1,NPA,129,8.049999999999999,32.5
2012,ISERE,La Mure,10784,1880,8904,178,8726,1,PS,2581,8.049999999999999,32.5
2012,ISERE,La Mure,10784,1880,8904,178,8726,1,SP,18,8.049999999999999,32.5
2012,ISERE,La Mure,10784,1880,8904,178,8726,1,UMP,1665,8.049999999999999,32.5
2012,ISERE,LE-GRAND-LEMPS,11030,1512,9518,169,9349,1,DLF,197,8.049999999999999,32.5
2012,ISERE,LE-GRAND-LEMPS,11030,1512,9518,169,9349,1,EELV,197,8.049999999999999,32.5
2012,ISERE,LE-GRAND-LEMPS,11030,1512,9518,169,9349,1,FN,2092,8.049999999999999,32.5
2012,ISERE,LE-GRAND-LEMPS,11030,1512,9518,169,9349,1,LFI,1060,8.049999999999999,32.5
2012,ISERE,LE-GRAND-LEMPS,11030,1512,9518,169,9349,1,LO,53,8.049999999999999,32.5
2012,ISERE,LE-GRAND-LEMPS,11030,1512,9518,169,9349,1,MODEM,919,8.049999999999999,32.5
2012,ISERE,LE-GRAND-LEMPS,11030,1512,9518,169,9349,1,NPA,111,8.049999999999999,32.5
2012,ISERE,LE-GRAND-LEMPS,11030,1512,9518,169,9349,1,PS,2362,8.049999999999999,32.5
2012,ISERE,LE-GRAND-LEMPS,11030,1512,9518,169,9349,1,SP,22,8.049999999999999,32.5
2012,ISERE,LE-GRAND-LEMPS,11030,1512,9518,169,9349,1,UMP,2336,8.049999999999999,32.5
2012,ISERE,GRENOBLE-4,11323,2164,9159,127,9032,1,DLF,120,8.049999999999999,32.5
2012,ISERE,GRENOBLE-4,11323,2164,9159,127,9032,1,EELV,465,8.049999999999999,32.5
2012,ISERE,GRENOBLE-4,11323,2164,9159,127,9032,1,FN,850,8.049999999999999,32.5
2012,ISERE,GRENOBLE-4,11323,2164,9159,127,9032,1,LFI,1245,8.049999999999999,32.5
2012,ISERE,GRENOBLE-4,11323,2164,9159,127,9032,1,LO,29,8.049999999999999,32.5
2012,ISERE,GRENOBLE-4,11323,2164,9159,127,9032,1,MODEM,859,8.049999999999999,32.5
2012,ISERE,GRENOBLE-4,11323,2164,9159,127,9032,1,NPA,66,8.049999999999999,32.5
2012,ISERE,GRENOBLE-4,11323,2164,9159,127,9032,1,PS,3174,8.049999999999999,32.5
2012,ISERE,GRENOBLE-4,11323,2164,9159,127,9032,1,SP,17,8.049999999999999,32.5
2012,ISERE,GRENOBLE-4,11323,2164,9159,127,9032,1,UMP,2207,8.049999999999999,32.5
2012,ISERE,SAINT-MARTIN-D'HÈRES-NORD,11350,2197,9153,167,8986,1,DLF,140,8.049999999999999,32.5
2012,ISERE,SAINT-MARTIN-D'HÈRES-NORD,11350,2197,9153,167,8986,1,EELV,317,8.049999999999999,32.5
2012,ISERE,SAINT-MARTIN-D'HÈRES-NORD,11350,2197,9153,167,8986,1,FN,1297,8.049999999999999,32.5
2012,ISERE,SAINT-MARTIN-D'HÈRES-NORD,11350,2197,9153,167,8986,1,LFI,1686,8.049999999999999,32.5
2012,ISERE,SAINT-MARTIN-D'HÈRES-NORD,11350,2197,9153,167,8986,1,LO,56,8.049999999999999,32.5
2012,ISERE,SAINT-MARTIN-D'HÈRES-NORD,11350,2197,9153,167,8986,1,MODEM,672,8.049999999999999,32.5
2012,ISERE,SAINT-MARTIN-D'HÈRES-NORD,11350,2197,9153,167,8986,1,NPA,100,8.049999999999999,32.5
2012,ISERE,SAINT-MARTIN-D'HÈRES-NORD,11350,2197,9153,167,8986,1,PS,3166,8.049999999999999,32.5
2012,ISERE,SAINT-MARTIN-D'HÈRES-NORD,11350,2197,9153,167,8986,1,SP,23,8.049999999999999,32.5
2012,ISERE,SAINT-MARTIN-D'HÈRES-NORD,11350,2197,9153,167,8986,1,UMP,1529,8.049999999999999,32.5
2012,ISERE,GRENOBLE-6,11421,2875,8546,149,8397,1,DLF,99,8.049999999999999,32.5
2012,ISERE,GRENOBLE-6,11421,2875,8546,149,8397,1,EELV,267,8.049999999999999,32.5
2012,ISERE,GRENOBLE-6,11421,2875,8546,149,8397,1,FN,1144,8.049999999999999,32.5
2012,ISERE,GRENOBLE-6,11421,2875,8546,149,8397,1,LFI,1362,8.049999999999999,32.5
2012,ISERE,GRENOBLE-6,11421,2875,8546,149,8397,1,LO,37,8.049999999999999,32.5
2012,ISERE,GRENOBLE-6,11421,2875,8546,149,8397,1,MODEM,499,8.049999999999999,32.5
2012,ISERE,GRENOBLE-6,11421,2875,8546,149,8397,1,NPA,71,8.049999999999999,32.5
2012,ISERE,GRENOBLE-6,11421,2875,8546,149,8397,1,PS,3399,8.049999999999999,32.5
2012,ISERE,GRENOBLE-6,11421,2875,8546,149,8397,1,SP,23,8.049999999999999,32.5
2012,ISERE,GRENOBLE-6,11421,2875,8546,149,8397,1,UMP,1496,8.049999999999999,32.5
2012,ISERE,Saint-Jean-de-Bournay,11910,1718,10192,261,9931,1,DLF,239,8.049999999999999,32.5
2012,ISERE,Saint-Jean-de-Bournay,11910,1718,10192,261,9931,1,EELV,171,8.049999999999999,32.5
2012,ISERE,Saint-Jean-de-Bournay,11910,1718,10192,261,9931,1,FN,2626,8.049999999999999,32.5
2012,ISERE,Saint-Jean-de-Bournay,11910,1718,10192,261,9931,1,LFI,886,8.049999999999999,32.5
2012,ISERE,Saint-Jean-de-Bournay,11910,1718,10192,261,9931,1,LO,66,8.049999999999999,32.5
2012,ISERE,Saint-Jean-de-Bournay,11910,1718,10192,261,9931,1,MODEM,919,8.049999999999999,32.5
2012,ISERE,Saint-Jean-de-Bournay,11910,1718,10192,261,9931,1,NPA,105,8.049999999999999,32.5
2012,ISERE,Saint-Jean-de-Bournay,11910,1718,10192,261,9931,1,PS,2044,8.049999999999999,32.5
2012,ISERE,Saint-Jean-de-Bournay,11910,1718,10192,261,9931,1,SP,20,8.049999999999999,32.5
2012,ISERE,Saint-Jean-de-Bournay,11910,1718,10192,261,9931,1,UMP,2855,8.049999999999999,32.5
2012,ISERE,La Verpillière,12404,2022,10382,191,10191,1,DLF,210,8.049999999999999,32.5
2012,ISERE,La Verpillière,12404,2022,10382,191,10191,1,EELV,197,8.049999999999999,32.5
2012,ISERE,La Verpillière,12404,2022,10382,191,10191,1,FN,2413,8.049999999999999,32.5
2012,ISERE,La Verpillière,12404,2022,10382,191,10191,1,LFI,1085,8.049999999999999,32.5
2012,ISERE,La Verpillière,12404,2022,10382,191,10191,1,LO,69,8.049999999999999,32.5
2012,ISERE,La Verpillière,12404,2022,10382,191,10191,1,MODEM,835,8.049999999999999,32.5
2012,ISERE,La Verpillière,12404,2022,10382,191,10191,1,NPA,130,8.049999999999999,32.5
2012,ISERE,La Verpillière,12404,2022,10382,191,10191,1,PS,2523,8.049999999999999,32.5
2012,ISERE,La Verpillière,12404,2022,10382,191,10191,1,SP,30,8.049999999999999,32.5
2012,ISERE,La Verpillière,12404,2022,10382,191,10191,1,UMP,2699,8.049999999999999,32.5
2012,ISERE,ECHIROLLES-OUEST,12843,2195,10648,179,10469,1,DLF,150,8.049999999999999,32.5
2012,ISERE,ECHIROLLES-OUEST,12843,2195,10648,179,10469,1,EELV,254,8.049999999999999,32.5
2012,ISERE,ECHIROLLES-OUEST,12843,2195,10648,179,10469,1,FN,1885,8.049999999999999,32.5
2012,ISERE,ECHIROLLES-OUEST,12843,2195,10648,179,10469,1,LFI,1808,8.049999999999999,32.5
2012,ISERE,ECHIROLLES-OUEST,12843,2195,10648,179,10469,1,LO,55,8.049999999999999,32.5
2012,ISERE,ECHIROLLES-OUEST,12843,2195,10648,179,10469,1,MODEM,795,8.049999999999999,32.5
2012,ISERE,ECHIROLLES-OUEST,12843,2195,10648,179,10469,1,NPA,91,8.049999999999999,32.5
2012,ISERE,ECHIROLLES-OUEST,12843,2195,10648,179,10469,1,PS,3335,8.049999999999999,32.5
2012,ISERE,ECHIROLLES-OUEST,12843,2195,10648,179,10469,1,SP,18,8.049999999999999,32.5
2012,ISERE,ECHIROLLES-OUEST,12843,2195,10648,179,10469,1,UMP,2078,8.049999999999999,32.5
2012,ISERE,GRENOBLE-3,13451,2803,10648,148,10500,1,DLF,138,8.049999999999999,32.5
2012,ISERE,GRENOBLE-3,13451,2803,10648,148,10500,1,EELV,452,8.049999999999999,32.5
2012,ISERE,GRENOBLE-3,13451,2803,10648,148,10500,1,FN,1378,8.049999999999999,32.5
2012,ISERE,GRENOBLE-3,13451,2803,10648,148,10500,1,LFI,1776,8.049999999999999,32.5
2012,ISERE,GRENOBLE-3,13451,2803,10648,148,10500,1,LO,57,8.049999999999999,32.5
2012,ISERE,GRENOBLE-3,13451,2803,10648,148,10500,1,MODEM,764,8.049999999999999,32.5
2012,ISERE,GRENOBLE-3,13451,2803,10648,148,10500,1,NPA,107,8.049999999999999,32.5
2012,ISERE,GRENOBLE-3,13451,2803,10648,148,10500,1,PS,3945,8.049999999999999,32.5
2012,ISERE,GRENOBLE-3,13451,2803,10648,148,10500,1,SP,38,8.049999999999999,32.5
2012,ISERE,GRENOBLE-3,13451,2803,10648,148,10500,1,UMP,1845,8.049999999999999,32.5
2012,ISERE,Eybens,13574,1911,11663,201,11462,1,DLF,198,8.049999999999999,32.5
2012,ISERE,Eybens,13574,1911,11663,201,11462,1,EELV,429,8.049999999999999,32.5
2012,ISERE,Eybens,13574,1911,11663,201,11462,1,FN,1595,8.049999999999999,32.5
2012,ISERE,Eybens,13574,1911,11663,201,11462,1,LFI,1422,8.049999999999999,32.5
2012,ISERE,Eybens,13574,1911,11663,201,11462,1,LO,34,8.049999999999999,32.5
2012,ISERE,Eybens,13574,1911,11663,201,11462,1,MODEM,1121,8.049999999999999,32.5
2012,ISERE,Eybens,13574,1911,11663,201,11462,1,NPA,93,8.049999999999999,32.5
2012,ISERE,Eybens,13574,1911,11663,201,11462,1,PS,3792,8.049999999999999,32.5
2012,ISERE,Eybens,13574,1911,11663,201,11462,1,SP,20,8.049999999999999,32.5
2012,ISERE,Eybens,13574,1911,11663,201,11462,1,UMP,2758,8.049999999999999,32.5
2012,ISERE,GRENOBLE-2,14128,2840,11288,173,11115,1,DLF,119,8.049999999999999,32.5
2012,ISERE,GRENOBLE-2,14128,2840,11288,173,11115,1,EELV,619,8.049999999999999,32.5
2012,ISERE,GRENOBLE-2,14128,2840,11288,173,11115,1,FN,886,8.049999999999999,32.5
2012,ISERE,GRENOBLE-2,14128,2840,11288,173,11115,1,LFI,1532,8.049999999999999,32.5
2012,ISERE,GRENOBLE-2,14128,2840,11288,173,11115,1,LO,28,8.049999999999999,32.5
2012,ISERE,GRENOBLE-2,14128,2840,11288,173,11115,1,MODEM,1064,8.049999999999999,32.5
2012,ISERE,GRENOBLE-2,14128,2840,11288,173,11115,1,NPA,89,8.049999999999999,32.5
2012,ISERE,GRENOBLE-2,14128,2840,11288,173,11115,1,PS,3577,8.049999999999999,32.5
2012,ISERE,GRENOBLE-2,14128,2840,11288,173,11115,1,SP,29,8.049999999999999,32.5
2012,ISERE,GRENOBLE-2,14128,2840,11288,173,11115,1,UMP,3172,8.049999999999999,32.5
2012,ISERE,Heyrieux,15059,2343,12716,219,12497,1,DLF,281,8.049999999999999,32.5
2012,ISERE,Heyrieux,15059,2343,12716,219,12497,1,EELV,224,8.049999999999999,32.5
2012,ISERE,Heyrieux,15059,2343,12716,219,12497,1,FN,3135,8.049999999999999,32.5
2012,ISERE,Heyrieux,15059,2343,12716,219,12497,1,LFI,1078,8.049999999999999,32.5
2012,ISERE,Heyrieux,15059,2343,12716,219,12497,1,LO,66,8.049999999999999,32.5
2012,ISERE,Heyrieux,15059,2343,12716,219,12497,1,MODEM,1076,8.049999999999999,32.5
2012,ISERE,Heyrieux,15059,2343,12716,219,12497,1,NPA,128,8.049999999999999,32.5
2012,ISERE,Heyrieux,15059,2343,12716,219,12497,1,PS,2668,8.049999999999999,32.5
2012,ISERE,Heyrieux,15059,2343,12716,219,12497,1,SP,28,8.049999999999999,32.5
2012,ISERE,Heyrieux,15059,2343,12716,219,12497,1,UMP,3813,8.049999999999999,32.5
2012,ISERE,Saint-Ismier,15631,1908,13723,176,13547,1,DLF,235,8.049999999999999,32.5
2012,ISERE,Saint-Ismier,15631,1908,13723,176,13547,1,EELV,533,8.049999999999999,32.5
2012,ISERE,Saint-Ismier,15631,1908,13723,176,13547,1,FN,1293,8.049999999999999,32.5
2012,ISERE,Saint-Ismier,15631,1908,13723,176,13547,1,LFI,941,8.049999999999999,32.5
2012,ISERE,Saint-Ismier,15631,1908,13723,176,13547,1,LO,31,8.049999999999999,32.5
2012,ISERE,Saint-Ismier,15631,1908,13723,176,13547,1,MODEM,1896,8.049999999999999,32.5
2012,ISERE,Saint-Ismier,15631,1908,13723,176,13547,1,NPA,69,8.049999999999999,32.5
2012,ISERE,Saint-Ismier,15631,1908,13723,176,13547,1,PS,3555,8.049999999999999,32.5
2012,ISERE,Saint-Ismier,15631,1908,13723,176,13547,1,SP,37,8.049999999999999,32.5
2012,ISERE,Saint-Ismier,15631,1908,13723,176,13547,1,UMP,4957,8.049999999999999,32.5
2012,ISERE,LE-PONT-DE-BEAUVOISIN,16161,2884,13277,253,13024,1,DLF,292,8.049999999999999,32.5
2012,ISERE,LE-PONT-DE-BEAUVOISIN,16161,2884,13277,253,13024,1,EELV,235,8.049999999999999,32.5
2012,ISERE,LE-PONT-DE-BEAUVOISIN,16161,2884,13277,253,13024,1,FN,3393,8.049999999999999,32.5
2012,ISERE,LE-PONT-DE-BEAUVOISIN,16161,2884,13277,253,13024,1,LFI,1323,8.049999999999999,32.5
2012,ISERE,LE-PONT-DE-BEAUVOISIN,16161,2884,13277,253,13024,1,LO,82,8.049999999999999,32.5
2012,ISERE,LE-PONT-DE-BEAUVOISIN,16161,2884,13277,253,13024,1,MODEM,1177,8.049999999999999,32.5
2012,ISERE,LE-PONT-DE-BEAUVOISIN,16161,2884,13277,253,13024,1,NPA,144,8.049999999999999,32.5
2012,ISERE,LE-PONT-DE-BEAUVOISIN,16161,2884,13277,253,13024,1,PS,2962,8.049999999999999,32.5
2012,ISERE,LE-PONT-DE-BEAUVOISIN,16161,2884,13277,253,13024,1,SP,31,8.049999999999999,32.5
2012,ISERE,LE-PONT-DE-BEAUVOISIN,16161,2884,13277,253,13024,1,UMP,3385,8.049999999999999,32.5
2012,ISERE,PONT-DE-CHERUY,16273,3725,12548,185,12363,1,DLF,234,8.049999999999999,32.5
2012,ISERE,PONT-DE-CHERUY,16273,3725,12548,185,12363,1,EELV,160,8.049999999999999,32.5
2012,ISERE,PONT-DE-CHERUY,16273,3725,12548,185,12363,1,FN,3191,8.049999999999999,32.5
2012,ISERE,PONT-DE-CHERUY,16273,3725,12548,185,12363,1,LFI,1180,8.049999999999999,32.5
2012,ISERE,PONT-DE-CHERUY,16273,3725,12548,185,12363,1,LO,84,8.049999999999999,32.5
2012,ISERE,PONT-DE-CHERUY,16273,3725,12548,185,12363,1,MODEM,921,8.049999999999999,32.5
2012,ISERE,PONT-DE-CHERUY,16273,3725,12548,185,12363,1,NPA,102,8.049999999999999,32.5
2012,ISERE,PONT-DE-CHERUY,16273,3725,12548,185,12363,1,PS,3083,8.049999999999999,32.5
2012,ISERE,PONT-DE-CHERUY,16273,3725,12548,185,12363,1,SP,24,8.049999999999999,32.5
2012,ISERE,PONT-DE-CHERUY,16273,3725,12548,185,12363,1,UMP,3384,8.049999999999999,32.5
2012,ISERE,Goncelin,16443,2656,13787,251,13536,1,DLF,291,8.049999999999999,32.5
2012,ISERE,Goncelin,16443,2656,13787,251,13536,1,EELV,440,8.049999999999999,32.5
2012,ISERE,Goncelin,16443,2656,13787,251,13536,1,FN,2589,8.049999999999999,32.5
2012,ISERE,Goncelin,16443,2656,13787,251,13536,1,LFI,1837,8.049999999999999,32.5
2012,ISERE,Goncelin,16443,2656,13787,251,13536,1,LO,63,8.049999999999999,32.5
2012,ISERE,Goncelin,16443,2656,13787,251,13536,1,MODEM,1197,8.049999999999999,32.5
2012,ISERE,Goncelin,16443,2656,13787,251,13536,1,NPA,195,8.049999999999999,32.5
2012,ISERE,Goncelin,16443,2656,13787,251,13536,1,PS,3965,8.049999999999999,32.5
2012,ISERE,Goncelin,16443,2656,13787,251,13536,1,SP,41,8.049999999999999,32.5
2012,ISERE,Goncelin,16443,2656,13787,251,13536,1,UMP,2918,8.049999999999999,32.5
2012,ISERE,Saint-Marcellin,16594,2741,13853,284,13569,1,DLF,301,8.049999999999999,32.5
2012,ISERE,Saint-Marcellin,16594,2741,13853,284,13569,1,EELV,349,8.049999999999999,32.5
2012,ISERE,Saint-Marcellin,16594,2741,13853,284,13569,1,FN,3014,8.049999999999999,32.5
2012,ISERE,Saint-Marcellin,16594,2741,13853,284,13569,1,LFI,1548,8.049999999999999,32.5
2012,ISERE,Saint-Marcellin,16594,2741,13853,284,13569,1,LO,87,8.049999999999999,32.5
2012,ISERE,Saint-Marcellin,16594,2741,13853,284,13569,1,MODEM,1356,8.049999999999999,32.5
2012,ISERE,Saint-Marcellin,16594,2741,13853,284,13569,1,NPA,143,8.049999999999999,32.5
2012,ISERE,Saint-Marcellin,16594,2741,13853,284,13569,1,PS,3124,8.049999999999999,32.5
2012,ISERE,Saint-Marcellin,16594,2741,13853,284,13569,1,SP,32,8.049999999999999,32.5
2012,ISERE,Saint-Marcellin,16594,2741,13853,284,13569,1,UMP,3615,8.049999999999999,32.5
2012,ISERE,GRENOBLE-5,16615,3173,13442,172,13270,1,DLF,164,8.049999999999999,32.5
2012,ISERE,GRENOBLE-5,16615,3173,13442,172,13270,1,EELV,744,8.049999999999999,32.5
2012,ISERE,GRENOBLE-5,16615,3173,13442,172,13270,1,FN,1418,8.049999999999999,32.5
2012,ISERE,GRENOBLE-5,16615,3173,13442,172,13270,1,LFI,2173,8.049999999999999,32.5
2012,ISERE,GRENOBLE-5,16615,3173,13442,172,13270,1,LO,86,8.049999999999999,32.5
2012,ISERE,GRENOBLE-5,16615,3173,13442,172,13270,1,MODEM,1148,8.049999999999999,32.5
2012,ISERE,GRENOBLE-5,16615,3173,13442,172,13270,1,NPA,125,8.049999999999999,32.5
2012,ISERE,GRENOBLE-5,16615,3173,13442,172,13270,1,PS,4783,8.049999999999999,32.5
2012,ISERE,GRENOBLE-5,16615,3173,13442,172,13270,1,SP,29,8.049999999999999,32.5
2012,ISERE,GRENOBLE-5,16615,3173,13442,172,13270,1,UMP,2600,8.049999999999999,32.5
2012,ISERE,BOURGOIN-JALLIEU-SUD,17235,3060,14175,232,13943,1,DLF,288,8.049999999999999,32.5
2012,ISERE,BOURGOIN-JALLIEU-SUD,17235,3060,14175,232,13943,1,EELV,328,8.049999999999999,32.5
2012,ISERE,BOURGOIN-JALLIEU-SUD,17235,3060,14175,232,13943,1,FN,2836,8.049999999999999,32.5
2012,ISERE,BOURGOIN-JALLIEU-SUD,17235,3060,14175,232,13943,1,LFI,1324,8.049999999999999,32.5
2012,ISERE,BOURGOIN-JALLIEU-SUD,17235,3060,14175,232,13943,1,LO,60,8.049999999999999,32.5
2012,ISERE,BOURGOIN-JALLIEU-SUD,17235,3060,14175,232,13943,1,MODEM,1461,8.049999999999999,32.5
2012,ISERE,BOURGOIN-JALLIEU-SUD,17235,3060,14175,232,13943,1,NPA,127,8.049999999999999,32.5
2012,ISERE,BOURGOIN-JALLIEU-SUD,17235,3060,14175,232,13943,1,PS,3450,8.049999999999999,32.5
2012,ISERE,BOURGOIN-JALLIEU-SUD,17235,3060,14175,232,13943,1,SP,46,8.049999999999999,32.5
2012,ISERE,BOURGOIN-JALLIEU-SUD,17235,3060,14175,232,13943,1,UMP,4023,8.049999999999999,32.5
2012,ISERE,GRENOBLE-1,17598,3775,13823,175,13648,1,DLF,187,8.049999999999999,32.5
2012,ISERE,GRENOBLE-1,17598,3775,13823,175,13648,1,EELV,730,8.049999999999999,32.5
2012,ISERE,GRENOBLE-1,17598,3775,13823,175,13648,1,FN,1494,8.049999999999999,32.5
2012,ISERE,GRENOBLE-1,17598,3775,13823,175,13648,1,LFI,2073,8.049999999999999,32.5
2012,ISERE,GRENOBLE-1,17598,3775,13823,175,13648,1,LO,74,8.049999999999999,32.5
2012,ISERE,GRENOBLE-1,17598,3775,13823,175,13648,1,MODEM,1132,8.049999999999999,32.5
2012,ISERE,GRENOBLE-1,17598,3775,13823,175,13648,1,NPA,121,8.049999999999999,32.5
2012,ISERE,GRENOBLE-1,17598,3775,13823,175,13648,1,PS,5064,8.049999999999999,32.5
2012,ISERE,GRENOBLE-1,17598,3775,13823,175,13648,1,SP,26,8.049999999999999,32.5
2012,ISERE,GRENOBLE-1,17598,3775,13823,175,13648,1,UMP,2747,8.049999999999999,32.5
2012,ISERE,FONTAINE-SASSENAGE,18389,3221,15168,243,14925,1,DLF,251,8.049999999999999,32.5
2012,ISERE,FONTAINE-SASSENAGE,18389,3221,15168,243,14925,1,EELV,413,8.049999999999999,32.5
2012,ISERE,FONTAINE-SASSENAGE,18389,3221,15168,243,14925,1,FN,2784,8.049999999999999,32.5
2012,ISERE,FONTAINE-SASSENAGE,18389,3221,15168,243,14925,1,LFI,2128,8.049999999999999,32.5
2012,ISERE,FONTAINE-SASSENAGE,18389,3221,15168,243,14925,1,LO,89,8.049999999999999,32.5
2012,ISERE,FONTAINE-SASSENAGE,18389,3221,15168,243,14925,1,MODEM,1193,8.049999999999999,32.5
2012,ISERE,FONTAINE-SASSENAGE,18389,3221,15168,243,14925,1,NPA,152,8.049999999999999,32.5
2012,ISERE,FONTAINE-SASSENAGE,18389,3221,15168,243,14925,1,PS,4636,8.049999999999999,32.5
2012,ISERE,FONTAINE-SASSENAGE,18389,3221,15168,243,14925,1,SP,30,8.049999999999999,32.5
2012,ISERE,FONTAINE-SASSENAGE,18389,3221,15168,243,14925,1,UMP,3249,8.049999999999999,32.5
2012,ISERE,BOURGOIN-JALLIEU-NORD,18559,3563,14996,276,14720,1,DLF,327,8.049999999999999,32.5
2012,ISERE,BOURGOIN-JALLIEU-NORD,18559,3563,14996,276,14720,1,EELV,312,8.049999999999999,32.5
2012,ISERE,BOURGOIN-JALLIEU-NORD,18559,3563,14996,276,14720,1,FN,3183,8.049999999999999,32.5
2012,ISERE,BOURGOIN-JALLIEU-NORD,18559,3563,14996,276,14720,1,LFI,1438,8.049999999999999,32.5
2012,ISERE,BOURGOIN-JALLIEU-NORD,18559,3563,14996,276,14720,1,LO,71,8.049999999999999,32.5
2012,ISERE,BOURGOIN-JALLIEU-NORD,18559,3563,14996,276,14720,1,MODEM,1410,8.049999999999999,32.5
2012,ISERE,BOURGOIN-JALLIEU-NORD,18559,3563,14996,276,14720,1,NPA,130,8.049999999999999,32.5
2012,ISERE,BOURGOIN-JALLIEU-NORD,18559,3563,14996,276,14720,1,PS,3774,8.049999999999999,32.5
2012,ISERE,BOURGOIN-JALLIEU-NORD,18559,3563,14996,276,14720,1,SP,45,8.049999999999999,32.5
2012,ISERE,BOURGOIN-JALLIEU-NORD,18559,3563,14996,276,14720,1,UMP,4030,8.049999999999999,32.5
2012,ISERE,Saint-Egrève,19011,3465,15546,235,15311,1,DLF,279,8.049999999999999,32.5
2012,ISERE,Saint-Egrève,19011,3465,15546,235,15311,1,EELV,692,8.049999999999999,32.5
2012,ISERE,Saint-Egrève,19011,3465,15546,235,15311,1,FN,2132,8.049999999999999,32.5
2012,ISERE,Saint-Egrève,19011,3465,15546,235,15311,1,LFI,1989,8.049999999999999,32.5
2012,ISERE,Saint-Egrève,19011,3465,15546,235,15311,1,LO,51,8.049999999999999,32.5
2012,ISERE,Saint-Egrève,19011,3465,15546,235,15311,1,MODEM,1540,8.049999999999999,32.5
2012,ISERE,Saint-Egrève,19011,3465,15546,235,15311,1,NPA,150,8.049999999999999,32.5
2012,ISERE,Saint-Egrève,19011,3465,15546,235,15311,1,PS,4959,8.049999999999999,32.5
2012,ISERE,Saint-Egrève,19011,3465,15546,235,15311,1,SP,39,8.049999999999999,32.5
2012,ISERE,Saint-Egrève,19011,3465,15546,235,15311,1,UMP,3480,8.049999999999999,32.5
2012,ISERE,Le Touvet,19169,2335,16834,256,16578,1,DLF,286,8.049999999999999,32.5
2012,ISERE,Le Touvet,19169,2335,16834,256,16578,1,EELV,768,8.049999999999999,32.5
2012,ISERE,Le Touvet,19169,2335,16834,256,16578,1,FN,2369,8.049999999999999,32.5
2012,ISERE,Le Touvet,19169,2335,16834,256,16578,1,LFI,2236,8.049999999999999,32.5
2012,ISERE,Le Touvet,19169,2335,16834,256,16578,1,LO,46,8.049999999999999,32.5
2012,ISERE,Le Touvet,19169,2335,16834,256,16578,1,MODEM,1717,8.049999999999999,32.5
2012,ISERE,Le Touvet,19169,2335,16834,256,16578,1,NPA,182,8.049999999999999,32.5
2012,ISERE,Le Touvet,19169,2335,16834,256,16578,1,PS,4939,8.049999999999999,32.5
2012,ISERE,Le Touvet,19169,2335,16834,256,16578,1,SP,54,8.049999999999999,32.5
2012,ISERE,Le Touvet,19169,2335,16834,256,16578,1,UMP,3981,8.049999999999999,32.5
2012,ISERE,FONTAINE-SEYSSINET,19388,3297,16091,252,15839,1,DLF,284,8.049999999999999,32.5
2012,ISERE,FONTAINE-SEYSSINET,19388,3297,16091,252,15839,1,EELV,532,8.049999999999999,32.5
2012,ISERE,FONTAINE-SEYSSINET,19388,3297,16091,252,15839,1,FN,2580,8.049999999999999,32.5
2012,ISERE,FONTAINE-SEYSSINET,19388,3297,16091,252,15839,1,LFI,2001,8.049999999999999,32.5
2012,ISERE,FONTAINE-SEYSSINET,19388,3297,16091,252,15839,1,LO,74,8.049999999999999,32.5
2012,ISERE,FONTAINE-SEYSSINET,19388,3297,16091,252,15839,1,MODEM,1426,8.049999999999999,32.5
2012,ISERE,FONTAINE-SEYSSINET,19388,3297,16091,252,15839,1,NPA,143,8.049999999999999,32.5
2012,ISERE,FONTAINE-SEYSSINET,19388,3297,16091,252,15839,1,PS,5156,8.049999999999999,32.5
2012,ISERE,FONTAINE-SEYSSINET,19388,3297,16091,252,15839,1,SP,25,8.049999999999999,32.5
2012,ISERE,FONTAINE-SEYSSINET,19388,3297,16091,252,15839,1,UMP,3618,8.049999999999999,32.5
2012,ISERE,Morestel,19950,3638,16312,334,15978,1,DLF,365,8.049999999999999,32.5
2012,ISERE,Morestel,19950,3638,16312,334,15978,1,EELV,268,8.049999999999999,32.5
2012,ISERE,Morestel,19950,3638,16312,334,15978,1,FN,4485,8.049999999999999,32.5
2012,ISERE,Morestel,19950,3638,16312,334,15978,1,LFI,1724,8.049999999999999,32.5
2012,ISERE,Morestel,19950,3638,16312,334,15978,1,LO,111,8.049999999999999,32.5
2012,ISERE,Morestel,19950,3638,16312,334,15978,1,MODEM,1287,8.049999999999999,32.5
2012,ISERE,Morestel,19950,3638,16312,334,15978,1,NPA,193,8.049999999999999,32.5
2012,ISERE,Morestel,19950,3638,16312,334,15978,1,PS,3318,8.049999999999999,32.5
2012,ISERE,Morestel,19950,3638,16312,334,15978,1,SP,50,8.049999999999999,32.5
2012,ISERE,Morestel,19950,3638,16312,334,15978,1,UMP,4177,8.049999999999999,32.5
2012,ISERE,LA-TOUR-DU-PIN,20774,3556,17218,350,16868,1,DLF,427,8.049999999999999,32.5
2012,ISERE,LA-TOUR-DU-PIN,20774,3556,17218,350,16868,1,EELV,347,8.049999999999999,32.5
2012,ISERE,LA-TOUR-DU-PIN,20774,3556,17218,350,16868,1,FN,4284,8.049999999999999,32.5
2012,ISERE,LA-TOUR-DU-PIN,20774,3556,17218,350,16868,1,LFI,1728,8.049999999999999,32.5
2012,ISERE,LA-TOUR-DU-PIN,20774,3556,17218,350,16868,1,LO,109,8.049999999999999,32.5
2012,ISERE,LA-TOUR-DU-PIN,20774,3556,17218,350,16868,1,MODEM,1431,8.049999999999999,32.5
2012,ISERE,LA-TOUR-DU-PIN,20774,3556,17218,350,16868,1,NPA,188,8.049999999999999,32.5
2012,ISERE,LA-TOUR-DU-PIN,20774,3556,17218,350,16868,1,PS,3942,8.049999999999999,32.5
2012,ISERE,LA-TOUR-DU-PIN,20774,3556,17218,350,16868,1,SP,56,8.049999999999999,32.5
2012,ISERE,LA-TOUR-DU-PIN,20774,3556,17218,350,16868,1,UMP,4356,8.049999999999999,32.5
2012,ISERE,L'Isle-d'Abeau,20991,5010,15981,288,15693,1,DLF,345,8.049999999999999,32.5
2012,ISERE,L'Isle-d'Abeau,20991,5010,15981,288,15693,1,EELV,415,8.049999999999999,32.5
2012,ISERE,L'Isle-d'Abeau,20991,5010,15981,288,15693,1,FN,3302,8.049999999999999,32.5
2012,ISERE,L'Isle-d'Abeau,20991,5010,15981,288,15693,1,LFI,2279,8.049999999999999,32.5
2012,ISERE,L'Isle-d'Abeau,20991,5010,15981,288,15693,1,LO,96,8.049999999999999,32.5
2012,ISERE,L'Isle-d'Abeau,20991,5010,15981,288,15693,1,MODEM,1408,8.049999999999999,32.5
2012,ISERE,L'Isle-d'Abeau,20991,5010,15981,288,15693,1,NPA,173,8.049999999999999,32.5
2012,ISERE,L'Isle-d'Abeau,20991,5010,15981,288,15693,1,PS,4741,8.049999999999999,32.5
2012,ISERE,L'Isle-d'Abeau,20991,5010,15981,288,15693,1,SP,31,8.049999999999999,32.5
2012,ISERE,L'Isle-d'Abeau,20991,5010,15981,288,15693,1,UMP,2903,8.049999999999999,32.5
2012,ISERE,DOMENE,21303,3328,17975,323,17652,1,DLF,330,8.049999999999999,32.5
2012,ISERE,DOMENE,21303,3328,17975,323,17652,1,EELV,671,8.049999999999999,32.5
2012,ISERE,DOMENE,21303,3328,17975,323,17652,1,FN,3059,8.049999999999999,32.5
2012,ISERE,DOMENE,21303,3328,17975,323,17652,1,LFI,2437,8.049999999999999,32.5
2012,ISERE,DOMENE,21303,3328,17975,323,17652,1,LO,99,8.049999999999999,32.5
2012,ISERE,DOMENE,21303,3328,17975,323,17652,1,MODEM,1640,8.049999999999999,32.5
2012,ISERE,DOMENE,21303,3328,17975,323,17652,1,NPA,148,8.049999999999999,32.5
2012,ISERE,DOMENE,21303,3328,17975,323,17652,1,PS,5258,8.049999999999999,32.5
2012,ISERE,DOMENE,21303,3328,17975,323,17652,1,SP,58,8.049999999999999,32.5
2012,ISERE,DOMENE,21303,3328,17975,323,17652,1,UMP,3952,8.049999999999999,32.5
2012,ISERE,Meylan,21869,3368,18501,261,18240,1,DLF,253,8.049999999999999,32.5
2012,ISERE,Meylan,21869,3368,18501,261,18240,1,EELV,869,8.049999999999999,32.5
2012,ISERE,Meylan,21869,3368,18501,261,18240,1,FN,1602,8.049999999999999,32.5
2012,ISERE,Meylan,21869,3368,18501,261,18240,1,LFI,1634,8.049999999999999,32.5
2012,ISERE,Meylan,21869,3368,18501,261,18240,1,LO,44,8.049999999999999,32.5
2012,ISERE,Meylan,21869,3368,18501,261,18240,1,MODEM,2102,8.049999999999999,32.5
2012,ISERE,Meylan,21869,3368,18501,261,18240,1,NPA,105,8.049999999999999,32.5
2012,ISERE,Meylan,21869,3368,18501,261,18240,1,PS,5078,8.049999999999999,32.5
2012,ISERE,Meylan,21869,3368,18501,261,18240,1,SP,42,8.049999999999999,32.5
2012,ISERE,Meylan,21869,3368,18501,261,18240,1,UMP,6511,8.049999999999999,32.5
2012,ISERE,VIENNE-SUD,22197,3261,18936,361,18575,1,DLF,359,8.049999999999999,32.5
2012,ISERE,VIENNE-SUD,22197,3261,18936,361,18575,1,EELV,510,8.049999999999999,32.5
2012,ISERE,VIENNE-SUD,22197,3261,18936,361,18575,1,FN,3669,8.049999999999999,32.5
2012,ISERE,VIENNE-SUD,22197,3261,18936,361,18575,1,LFI,1831,8.049999999999999,32.5
2012,ISERE,VIENNE-SUD,22197,3261,18936,361,18575,1,LO,84,8.049999999999999,32.5
2012,ISERE,VIENNE-SUD,22197,3261,18936,361,18575,1,MODEM,1733,8.049999999999999,32.5
2012,ISERE,VIENNE-SUD,22197,3261,18936,361,18575,1,NPA,183,8.049999999999999,32.5
2012,ISERE,VIENNE-SUD,22197,3261,18936,361,18575,1,PS,4598,8.049999999999999,32.5
2012,ISERE,VIENNE-SUD,22197,3261,18936,361,18575,1,SP,44,8.049999999999999,32.5
2012,ISERE,VIENNE-SUD,22197,3261,18936,361,18575,1,UMP,5564,8.049999999999999,32.5
2012,ISERE,Crémieu,22272,3274,18998,342,18656,1,DLF,396,8.049999999999999,32.5
2012,ISERE,Crémieu,22272,3274,18998,342,18656,1,EELV,374,8.049999999999999,32.5
2012,ISERE,Crémieu,22272,3274,18998,342,18656,1,FN,4620,8.049999999999999,32.5
2012,ISERE,Crémieu,22272,3274,18998,342,18656,1,LFI,1659,8.049999999999999,32.5
2012,ISERE,Crémieu,22272,3274,18998,342,18656,1,LO,83,8.049999999999999,32.5
2012,ISERE,Crémieu,22272,3274,18998,342,18656,1,MODEM,1670,8.049999999999999,32.5
2012,ISERE,Crémieu,22272,3274,18998,342,18656,1,NPA,186,8.049999999999999,32.5
2012,ISERE,Crémieu,22272,3274,18998,342,18656,1,PS,4150,8.049999999999999,32.5
2012,ISERE,Crémieu,22272,3274,18998,342,18656,1,SP,53,8.049999999999999,32.5
2012,ISERE,Crémieu,22272,3274,18998,342,18656,1,UMP,5465,8.049999999999999,32.5
2012,ISERE,Vizille,22415,3579,18836,319,18517,1,DLF,340,8.049999999999999,32.5
2012,ISERE,Vizille,22415,3579,18836,319,18517,1,EELV,531,8.049999999999999,32.5
2012,ISERE,Vizille,22415,3579,18836,319,18517,1,FN,3709,8.049999999999999,32.5
2012,ISERE,Vizille,22415,3579,18836,319,18517,1,LFI,2545,8.049999999999999,32.5
2012,ISERE,Vizille,22415,3579,18836,319,18517,1,LO,108,8.049999999999999,32.5
2012,ISERE,Vizille,22415,3579,18836,319,18517,1,MODEM,1585,8.049999999999999,32.5
2012,ISERE,Vizille,22415,3579,18836,319,18517,1,NPA,192,8.049999999999999,32.5
2012,ISERE,Vizille,22415,3579,18836,319,18517,1,PS,5200,8.049999999999999,32.5
2012,ISERE,Vizille,22415,3579,18836,319,18517,1,SP,57,8.049999999999999,32.5
2012,ISERE,Vizille,22415,3579,18836,319,18517,1,UMP,4250,8.049999999999999,32.5
2012,ISERE,Rives,22700,3882,18818,352,18466,1,DLF,378,8.049999999999999,32.5
2012,ISERE,Rives,22700,3882,18818,352,18466,1,EELV,429,8.049999999999999,32.5
2012,ISERE,Rives,22700,3882,18818,352,18466,1,FN,3463,8.049999999999999,32.5
2012,ISERE,Rives,22700,3882,18818,352,18466,1,LFI,2369,8.049999999999999,32.5
2012,ISERE,Rives,22700,3882,18818,352,18466,1,LO,89,8.049999999999999,32.5
2012,ISERE,Rives,22700,3882,18818,352,18466,1,MODEM,1828,8.049999999999999,32.5
2012,ISERE,Rives,22700,3882,18818,352,18466,1,NPA,201,8.049999999999999,32.5
2012,ISERE,Rives,22700,3882,18818,352,18466,1,PS,5244,8.049999999999999,32.5
2012,ISERE,Rives,22700,3882,18818,352,18466,1,SP,42,8.049999999999999,32.5
2012,ISERE,Rives,22700,3882,18818,352,18466,1,UMP,4423,8.049999999999999,32.5
2012,ISERE,VIENNE-NORD,24380,4459,19921,376,19545,1,DLF,323,8.049999999999999,32.5
2012,ISERE,VIENNE-NORD,24380,4459,19921,376,19545,1,EELV,442,8.049999999999999,32.5
2012,ISERE,VIENNE-NORD,24380,4459,19921,376,19545,1,FN,3954,8.049999999999999,32.5
2012,ISERE,VIENNE-NORD,24380,4459,19921,376,19545,1,LFI,2138,8.049999999999999,32.5
2012,ISERE,VIENNE-NORD,24380,4459,19921,376,19545,1,LO,103,8.049999999999999,32.5
2012,ISERE,VIENNE-NORD,24380,4459,19921,376,19545,1,MODEM,1684,8.049999999999999,32.5
2012,ISERE,VIENNE-NORD,24380,4459,19921,376,19545,1,NPA,163,8.049999999999999,32.5
2012,ISERE,VIENNE-NORD,24380,4459,19921,376,19545,1,PS,5710,8.049999999999999,32.5
2012,ISERE,VIENNE-NORD,24380,4459,19921,376,19545,1,SP,41,8.049999999999999,32.5
2012,ISERE,VIENNE-NORD,24380,4459,19921,376,19545,1,UMP,4987,8.049999999999999,32.5
2012,ISERE,Vif,26433,4528,21905,360,21545,1,DLF,360,8.049999999999999,32.5
2012,ISERE,Vif,26433,4528,21905,360,21545,1,EELV,560,8.049999999999999,32.5
2012,ISERE,Vif,26433,4528,21905,360,21545,1,FN,4047,8.049999999999999,32.5
2012,ISERE,Vif,26433,4528,21905,360,21545,1,LFI,2834,8.049999999999999,32.5
2012,ISERE,Vif,26433,4528,21905,360,21545,1,LO,98,8.049999999999999,32.5
2012,ISERE,Vif,26433,4528,21905,360,21545,1,MODEM,1910,8.049999999999999,32.5
2012,ISERE,Vif,26433,4528,21905,360,21545,1,NPA,189,8.049999999999999,32.5
2012,ISERE,Vif,26433,4528,21905,360,21545,1,PS,6005,8.049999999999999,32.5
2012,ISERE,Vif,26433,4528,21905,360,21545,1,SP,61,8.049999999999999,32.5
2012,ISERE,Vif,26433,4528,21905,360,21545,1,UMP,5481,8.049999999999999,32.5
2012,ISERE,Voiron,33027,5835,27192,534,26658,1,DLF,488,8.049999999999999,32.5
2012,ISERE,Voiron,33027,5835,27192,534,26658,1,EELV,884,8.049999999999999,32.5
2012,ISERE,Voiron,33027,5835,27192,534,26658,1,FN,4216,8.049999999999999,32.5
2012,ISERE,Voiron,33027,5835,27192,534,26658,1,LFI,3056,8.049999999999999,32.5
2012,ISERE,Voiron,33027,5835,27192,534,26658,1,LO,96,8.049999999999999,32.5
2012,ISERE,Voiron,33027,5835,27192,534,26658,1,MODEM,2953,8.049999999999999,32.5
2012,ISERE,Voiron,33027,5835,27192,534,26658,1,NPA,286,8.049999999999999,32.5
2012,ISERE,Voiron,33027,5835,27192,534,26658,1,PS,7634,8.049999999999999,32.5
2012,ISERE,Voiron,33027,5835,27192,534,26658,1,SP,83,8.049999999999999,32.5
2012,ISERE,Voiron,33027,5835,27192,534,26658,1,UMP,6962,8.049999999999999,32.5
2012,ISERE,Roussillon,33904,6557,27347,562,26785,1,DLF,526,8.049999999999999,32.5
2012,ISERE,Roussillon,33904,6557,27347,562,26785,1,EELV,416,8.049999999999999,32.5
2012,ISERE,Roussillon,33904,6557,27347,562,26785,1,FN,6503,8.049999999999999,32.5
2012,ISERE,Roussillon,33904,6557,27347,562,26785,1,LFI,3779,8.049999999999999,32.5
2012,ISERE,Roussillon,33904,6557,27347,562,26785,1,LO,146,8.049999999999999,32.5
2012,ISERE,Roussillon,33904,6557,27347,562,26785,1,MODEM,2076,8.049999999999999,32.5
2012,ISERE,Roussillon,33904,6557,27347,562,26785,1,NPA,312,8.049999999999999,32.5
2012,ISERE,Roussillon,33904,6557,27347,562,26785,1,PS,6962,8.049999999999999,32.5
2012,ISERE,Roussillon,33904,6557,27347,562,26785,1,SP,66,8.049999999999999,32.5
2012,ISERE,Roussillon,33904,6557,27347,562,26785,1,UMP,5999,8.049999999999999,32.5
2012,ISERE,Clelles,1792,224,1568,103,1465,2,PS,755,8.049999999999999,32.5
2012,ISERE,Clelles,1792,224,1568,103,1465,2,UMP,710,8.049999999999999,32.5
2012,ISERE,Valbonnais,1882,297,1585,95,1490,2,PS,854,8.049999999999999,32.5
2012,ISERE,Valbonnais,1882,297,1585,95,1490,2,UMP,636,8.049999999999999,32.5
2012,ISERE,Corps,1927,252,1675,109,1566,2,PS,793,8.049999999999999,32.5
2012,ISERE,Corps,1927,252,1675,109,1566,2,UMP,773,8.049999999999999,32.5
2012,ISERE,Mens,2777,397,2380,127,2253,2,PS,1291,8.049999999999999,32.5
2012,ISERE,Mens,2777,397,2380,127,2253,2,UMP,962,8.049999999999999,32.5
2012,ISERE,Monestier-de-Clermont,3764,479,3285,156,3129,2,PS,1622,8.049999999999999,32.5
2012,ISERE,Monestier-de-Clermont,3764,479,3285,156,3129,2,UMP,1507,8.049999999999999,32.5
2012,ISERE,Pont-en-Royans,4885,795,4090,289,3801,2,PS,1937,8.049999999999999,32.5
2012,ISERE,Pont-en-Royans,4885,795,4090,289,3801,2,UMP,1864,8.049999999999999,32.5
2012,ISERE,Roybon,4999,764,4235,313,3922,2,PS,1913,8.049999999999999,32.5
2012,ISERE,Roybon,4999,764,4235,313,3922,2,UMP,2009,8.049999999999999,32.5
2012,ISERE,Allevard,5778,1015,4763,272,4491,2,PS,2616,8.049999999999999,32.5
2012,ISERE,Allevard,5778,1015,4763,272,4491,2,UMP,1875,8.049999999999999,32.5
2012,ISERE,Vinay,6752,1211,5541,406,5135,2,PS,2484,8.049999999999999,32.5
2012,ISERE,Vinay,6752,1211,5541,406,5135,2,UMP,2651,8.049999999999999,32.5
2012,ISERE,SAINT-MARTIN-D'HERES-SUD,6769,1501,5268,223,5045,2,PS,3300,8.049999999999999,32.5
2012,ISERE,SAINT-MARTIN-D'HERES-SUD,6769,1501,5268,223,5045,2,UMP,1745,8.049999999999999,32.5
2012,ISERE,Saint-Geoire-en-Valdaine,7140,1134,6006,411,5595,2,PS,2560,8.049999999999999,32.5
2012,ISERE,Saint-Geoire-en-Valdaine,7140,1134,6006,411,5595,2,UMP,3035,8.049999999999999,32.5
2012,ISERE,ECHIROLLES-EST,8330,1653,6677,297,6380,2,PS,4276,8.049999999999999,32.5
2012,ISERE,ECHIROLLES-EST,8330,1653,6677,297,6380,2,UMP,2104,8.049999999999999,32.5
2012,ISERE,VIRIEU,8347,1260,7087,466,6621,2,PS,3068,8.049999999999999,32.5
2012,ISERE,VIRIEU,8347,1260,7087,466,6621,2,UMP,3553,8.049999999999999,32.5
2012,ISERE,Saint-Laurent-du-Pont,8629,1476,7153,506,6647,2,PS,3261,8.049999999999999,32.5
2012,ISERE,Saint-Laurent-du-Pont,8629,1476,7153,506,6647,2,UMP,3386,8.049999999999999,32.5
2012,ISERE,Saint-Etienne-de-Saint-Geoirs,9180,1604,7576,511,7065,2,PS,3365,8.049999999999999,32.5
2012,ISERE,Saint-Etienne-de-Saint-Geoirs,9180,1604,7576,511,7065,2,UMP,3700,8.049999999999999,32.5
2012,ISERE,Tullins,9261,1681,7580,561,7019,2,PS,3753,8.049999999999999,32.5
2012,ISERE,Tullins,9261,1681,7580,561,7019,2,UMP,3266,8.049999999999999,32.5
2012,ISERE,LE-BOURG-D'OISANS,9284,2019,7265,393,6872,2,PS,3057,8.049999999999999,32.5
2012,ISERE,LE-BOURG-D'OISANS,9284,2019,7265,393,6872,2,UMP,3815,8.049999999999999,32.5
2012,ISERE,Villard-de-Lans,9716,1340,8376,383,7993,2,PS,4110,8.049999999999999,32.5
2012,ISERE,Villard-de-Lans,9716,1340,8376,383,7993,2,UMP,3883,8.049999999999999,32.5
2012,ISERE,LA-COTE-SAINT-ANDRE,10707,1762,8945,603,8342,2,PS,3761,8.049999999999999,32.5
2012,ISERE,LA-COTE-SAINT-ANDRE,10707,1762,8945,603,8342,2,UMP,4581,8.049999999999999,32.5
2012,ISERE,Beaurepaire,10757,1988,8769,640,8129,2,PS,3925,8.049999999999999,32.5
2012,ISERE,Beaurepaire,10757,1988,8769,640,8129,2,UMP,4204,8.049999999999999,32.5
2012,ISERE,La Mure,10786,1968,8818,615,8203,2,PS,4845,8.049999999999999,32.5
2012,ISERE,La Mure,10786,1968,8818,615,8203,2,UMP,3358,8.049999999999999,32.5
2012,ISERE,LE-GRAND-LEMPS,11029,1664,9365,611,8754,2,PS,4218,8.049999999999999,32.5
2012,ISERE,LE-GRAND-LEMPS,11029,1664,9365,611,8754,2,UMP,4536,8.049999999999999,32.5
2012,ISERE,GRENOBLE-4,11342,2247,9095,289,8806,2,PS,5326,8.049999999999999,32.5
2012,ISERE,GRENOBLE-4,11342,2247,9095,289,8806,2,UMP,3480,8.049999999999999,32.5
2012,ISERE,SAINT-MARTIN-D'HÈRES-NORD,11353,2304,9049,441,8608,2,PS,5749,8.049999999999999,32.5
2012,ISERE,SAINT-MARTIN-D'HÈRES-NORD,11353,2304,9049,441,8608,2,UMP,2859,8.049999999999999,32.5
2012,ISERE,GRENOBLE-6,11428,2864,8564,336,8228,2,PS,5608,8.049999999999999,32.5
2012,ISERE,GRENOBLE-6,11428,2864,8564,336,8228,2,UMP,2620,8.049999999999999,32.5
2012,ISERE,Saint-Jean-de-Bournay,11913,1942,9971,739,9232,2,PS,3803,8.049999999999999,32.5
2012,ISERE,Saint-Jean-de-Bournay,11913,1942,9971,739,9232,2,UMP,5429,8.049999999999999,32.5
2012,ISERE,La Verpillière,12406,2096,10310,607,9703,2,PS,4497,8.049999999999999,32.5
2012,ISERE,La Verpillière,12406,2096,10310,607,9703,2,UMP,5206,8.049999999999999,32.5
2012,ISERE,ECHIROLLES-OUEST,12848,2306,10542,548,9994,2,PS,6020,8.049999999999999,32.5
2012,ISERE,ECHIROLLES-OUEST,12848,2306,10542,548,9994,2,UMP,3974,8.049999999999999,32.5
2012,ISERE,GRENOBLE-3,13475,2843,10632,444,10188,2,PS,6812,8.049999999999999,32.5
2012,ISERE,GRENOBLE-3,13475,2843,10632,444,10188,2,UMP,3376,8.049999999999999,32.5
2012,ISERE,Eybens,13582,2002,11580,495,11085,2,PS,6343,8.049999999999999,32.5
2012,ISERE,Eybens,13582,2002,11580,495,11085,2,UMP,4742,8.049999999999999,32.5
2012,ISERE,GRENOBLE-2,14147,2838,11309,374,10935,2,PS,6368,8.049999999999999,32.5
2012,ISERE,GRENOBLE-2,14147,2838,11309,374,10935,2,UMP,4567,8.049999999999999,32.5
2012,ISERE,Heyrieux,15061,2564,12497,807,11690,2,PS,4661,8.049999999999999,32.5
2012,ISERE,Heyrieux,15061,2564,12497,807,11690,2,UMP,7029,8.049999999999999,32.5
2012,ISERE,Saint-Ismier,15626,1878,13748,585,13163,2,PS,5772,8.049999999999999,32.5
2012,ISERE,Saint-Ismier,15626,1878,13748,585,13163,2,UMP,7391,8.049999999999999,32.5
2012,ISERE,LE-PONT-DE-BEAUVOISIN,16168,2949,13219,908,12311,2,PS,5497,8.049999999999999,32.5
2012,ISERE,LE-PONT-DE-BEAUVOISIN,16168,2949,13219,908,12311,2,UMP,6814,8.049999999999999,32.5
2012,ISERE,PONT-DE-CHERUY,16274,3726,12548,657,11891,2,PS,5103,8.049999999999999,32.5
2012,ISERE,PONT-DE-CHERUY,16274,3726,12548,657,11891,2,UMP,6788,8.049999999999999,32.5
2012,ISERE,Goncelin,16437,2822,13615,799,12816,2,PS,7196,8.049999999999999,32.5
2012,ISERE,Goncelin,16437,2822,13615,799,12816,2,UMP,5620,8.049999999999999,32.5
2012,ISERE,Saint-Marcellin,16597,2748,13849,927,12922,2,PS,6097,8.049999999999999,32.5
2012,ISERE,Saint-Marcellin,16597,2748,13849,927,12922,2,UMP,6825,8.049999999999999,32.5
2012,ISERE,GRENOBLE-5,16633,3308,13325,505,12820,2,PS,8504,8.049999999999999,32.5
2012,ISERE,GRENOBLE-5,16633,3308,13325,505,12820,2,UMP,4316,8.049999999999999,32.5
2012,ISERE,BOURGOIN-JALLIEU-SUD,17250,3189,14061,806,13255,2,PS,6041,8.049999999999999,32.5
2012,ISERE,BOURGOIN-JALLIEU-SUD,17250,3189,14061,806,13255,2,UMP,7214,8.049999999999999,32.5
2012,ISERE,GRENOBLE-1,17623,3821,13802,562,13240,2,PS,8670,8.049999999999999,32.5
2012,ISERE,GRENOBLE-1,17623,3821,13802,562,13240,2,UMP,4570,8.049999999999999,32.5
2012,ISERE,FONTAINE-SASSENAGE,18392,3408,14984,805,14179,2,PS,8152,8.049999999999999,32.5
2012,ISERE,FONTAINE-SASSENAGE,18392,3408,14984,805,14179,2,UMP,6027,8.049999999999999,32.5
2012,ISERE,BOURGOIN-JALLIEU-NORD,18560,3598,14962,819,14143,2,PS,6610,8.049999999999999,32.5
2012,ISERE,BOURGOIN-JALLIEU-NORD,18560,3598,14962,819,14143,2,UMP,7533,8.049999999999999,32.5
2012,ISERE,Saint-Egrève,19012,3578,15434,778,14656,2,PS,8516,8.049999999999999,32.5
2012,ISERE,Saint-Egrève,19012,3578,15434,778,14656,2,UMP,6140,8.049999999999999,32.5
2012,ISERE,Le Touvet,19199,2503,16696,810,15886,2,PS,8949,8.049999999999999,32.5
2012,ISERE,Le Touvet,19199,2503,16696,810,15886,2,UMP,6937,8.049999999999999,32.5
2012,ISERE,FONTAINE-SEYSSINET,19402,3466,15936,795,15141,2,PS,8657,8.049999999999999,32.5
2012,ISERE,FONTAINE-SEYSSINET,19402,3466,15936,795,15141,2,UMP,6484,8.049999999999999,32.5
2012,ISERE,Morestel,20005,3836,16169,1112,15057,2,PS,6380,8.049999999999999,32.5
2012,ISERE,Morestel,20005,3836,16169,1112,15057,2,UMP,8677,8.049999999999999,32.5
2012,ISERE,LA-TOUR-DU-PIN,20771,3721,17050,1166,15884,2,PS,7168,8.049999999999999,32.5
2012,ISERE,LA-TOUR-DU-PIN,20771,3721,17050,1166,15884,2,UMP,8716,8.049999999999999,32.5
2012,ISERE,L'Isle-d'Abeau,20997,5304,15693,882,14811,2,PS,8541,8.049999999999999,32.5
2012,ISERE,L'Isle-d'Abeau,20997,5304,15693,882,14811,2,UMP,6270,8.049999999999999,32.5
2012,ISERE,DOMENE,21314,3467,17847,995,16852,2,PS,9468,8.049999999999999,32.5
2012,ISERE,DOMENE,21314,3467,17847,995,16852,2,UMP,7384,8.049999999999999,32.5
2012,ISERE,Meylan,21874,3283,18591,760,17831,2,PS,8379,8.049999999999999,32.5
2012,ISERE,Meylan,21874,3283,18591,760,17831,2,UMP,9452,8.049999999999999,32.5
2012,ISERE,VIENNE-SUD,22204,3363,18841,1084,17757,2,PS,8021,8.049999999999999,32.5
2012,ISERE,VIENNE-SUD,22204,3363,18841,1084,17757,2,UMP,9736,8.049999999999999,32.5
2012,ISERE,Crémieu,22278,3573,18705,1112,17593,2,PS,7321,8.049999999999999,32.5
2012,ISERE,Crémieu,22278,3573,18705,1112,17593,2,UMP,10272,8.049999999999999,32.5
2012,ISERE,Vizille,22414,3896,18518,1050,17468,2,PS,9332,8.049999999999999,32.5
2012,ISERE,Vizille,22414,3896,18518,1050,17468,2,UMP,8136,8.049999999999999,32.5
2012,ISERE,Rives,22705,3908,18797,1037,17760,2,PS,9447,8.049999999999999,32.5
2012,ISERE,Rives,22705,3908,18797,1037,17760,2,UMP,8313,8.049999999999999,32.5
2012,ISERE,VIENNE-NORD,24384,4486,19898,1189,18709,2,PS,9607,8.049999999999999,32.5
2012,ISERE,VIENNE-NORD,24384,4486,19898,1189,18709,2,UMP,9102,8.049999999999999,32.5
2012,ISERE,Vif,26444,4637,21807,1111,20696,2,PS,10660,8.049999999999999,32.5
2012,ISERE,Vif,26444,4637,21807,1111,20696,2,UMP,10036,8.049999999999999,32.5
2012,ISERE,Voiron,33046,5915,27131,1653,25478,2,PS,13298,8.049999999999999,32.5
2012,ISERE,Voiron,33046,5915,27131,1653,25478,2,UMP,12180,8.049999999999999,32.5
2012,ISERE,Roussillon,33899,6918,26981,1809,25172,2,PS,13111,8.049999999999999,32.5
2012,ISERE,Roussillon,33899,6918,26981,1809,25172,2,UMP,12061,8.049999999999999,32.5
2007,ISERE,Clelles,1700,160,1540,10,1530,1,CPNT,37,6.550000000000001,33.2
2007,ISERE,Clelles,1700,160,1540,10,1530,1,DVG,66,6.550000000000001,33.2
2007,ISERE,Clelles,1700,160,1540,10,1530,1,FN,138,6.550000000000001,33.2
2007,ISERE,Clelles,1700,160,1540,10,1530,1,LCR,30,6.550000000000001,33.2
2007,ISERE,Clelles,1700,160,1540,10,1530,1,LO,13,6.550000000000001,33.2
2007,ISERE,Clelles,1700,160,1540,10,1530,1,LV,35,6.550000000000001,33.2
2007,ISERE,Clelles,1700,160,1540,10,1530,1,MODEM,266,6.550000000000001,33.2
2007,ISERE,Clelles,1700,160,1540,10,1530,1,MPF,25,6.550000000000001,33.2
2007,ISERE,Clelles,1700,160,1540,10,1530,1,PCF,35,6.550000000000001,33.2
2007,ISERE,Clelles,1700,160,1540,10,1530,1,PS,373,6.550000000000001,33.2
2007,ISERE,Clelles,1700,160,1540,10,1530,1,PT,9,6.550000000000001,33.2
2007,ISERE,Clelles,1700,160,1540,10,1530,1,UMP,503,6.550000000000001,33.2
2007,ISERE,Valbonnais,1874,267,1607,18,1589,1,CPNT,44,6.550000000000001,33.2
2007,ISERE,Valbonnais,1874,267,1607,18,1589,1,DVG,40,6.550000000000001,33.2
2007,ISERE,Valbonnais,1874,267,1607,18,1589,1,FN,148,6.550000000000001,33.2
2007,ISERE,Valbonnais,1874,267,1607,18,1589,1,LCR,57,6.550000000000001,33.2
2007,ISERE,Valbonnais,1874,267,1607,18,1589,1,LO,27,6.550000000000001,33.2
2007,ISERE,Valbonnais,1874,267,1607,18,1589,1,LV,19,6.550000000000001,33.2
2007,ISERE,Valbonnais,1874,267,1607,18,1589,1,MODEM,332,6.550000000000001,33.2
2007,ISERE,Valbonnais,1874,267,1607,18,1589,1,MPF,22,6.550000000000001,33.2
2007,ISERE,Valbonnais,1874,267,1607,18,1589,1,PCF,34,6.550000000000001,33.2
2007,ISERE,Valbonnais,1874,267,1607,18,1589,1,PS,464,6.550000000000001,33.2
2007,ISERE,Valbonnais,1874,267,1607,18,1589,1,PT,13,6.550000000000001,33.2
2007,ISERE,Valbonnais,1874,267,1607,18,1589,1,UMP,389,6.550000000000001,33.2
2007,ISERE,Corps,1941,252,1689,16,1673,1,CPNT,32,6.550000000000001,33.2
2007,ISERE,Corps,1941,252,1689,16,1673,1,DVG,37,6.550000000000001,33.2
2007,ISERE,Corps,1941,252,1689,16,1673,1,FN,195,6.550000000000001,33.2
2007,ISERE,Corps,1941,252,1689,16,1673,1,LCR,49,6.550000000000001,33.2
2007,ISERE,Corps,1941,252,1689,16,1673,1,LO,25,6.550000000000001,33.2
2007,ISERE,Corps,1941,252,1689,16,1673,1,LV,29,6.550000000000001,33.2
2007,ISERE,Corps,1941,252,1689,16,1673,1,MODEM,251,6.550000000000001,33.2
2007,ISERE,Corps,1941,252,1689,16,1673,1,MPF,48,6.550000000000001,33.2
2007,ISERE,Corps,1941,252,1689,16,1673,1,PCF,32,6.550000000000001,33.2
2007,ISERE,Corps,1941,252,1689,16,1673,1,PS,424,6.550000000000001,33.2
2007,ISERE,Corps,1941,252,1689,16,1673,1,PT,7,6.550000000000001,33.2
2007,ISERE,Corps,1941,252,1689,16,1673,1,UMP,544,6.550000000000001,33.2
2007,ISERE,Mens,2700,332,2368,25,2343,1,CPNT,41,6.550000000000001,33.2
2007,ISERE,Mens,2700,332,2368,25,2343,1,DVG,71,6.550000000000001,33.2
2007,ISERE,Mens,2700,332,2368,25,2343,1,FN,193,6.550000000000001,33.2
2007,ISERE,Mens,2700,332,2368,25,2343,1,LCR,89,6.550000000000001,33.2
2007,ISERE,Mens,2700,332,2368,25,2343,1,LO,22,6.550000000000001,33.2
2007,ISERE,Mens,2700,332,2368,25,2343,1,LV,56,6.550000000000001,33.2
2007,ISERE,Mens,2700,332,2368,25,2343,1,MODEM,397,6.550000000000001,33.2
2007,ISERE,Mens,2700,332,2368,25,2343,1,MPF,59,6.550000000000001,33.2
2007,ISERE,Mens,2700,332,2368,25,2343,1,PCF,34,6.550000000000001,33.2
2007,ISERE,Mens,2700,332,2368,25,2343,1,PS,711,6.550000000000001,33.2
2007,ISERE,Mens,2700,332,2368,25,2343,1,PT,7,6.550000000000001,33.2
2007,ISERE,Mens,2700,332,2368,25,2343,1,UMP,663,6.550000000000001,33.2
2007,ISERE,Monestier-de-Clermont,3573,343,3230,31,3199,1,CPNT,69,6.550000000000001,33.2
2007,ISERE,Monestier-de-Clermont,3573,343,3230,31,3199,1,DVG,66,6.550000000000001,33.2
2007,ISERE,Monestier-de-Clermont,3573,343,3230,31,3199,1,FN,208,6.550000000000001,33.2
2007,ISERE,Monestier-de-Clermont,3573,343,3230,31,3199,1,LCR,142,6.550000000000001,33.2
2007,ISERE,Monestier-de-Clermont,3573,343,3230,31,3199,1,LO,31,6.550000000000001,33.2
2007,ISERE,Monestier-de-Clermont,3573,343,3230,31,3199,1,LV,64,6.550000000000001,33.2
2007,ISERE,Monestier-de-Clermont,3573,343,3230,31,3199,1,MODEM,599,6.550000000000001,33.2
2007,ISERE,Monestier-de-Clermont,3573,343,3230,31,3199,1,MPF,54,6.550000000000001,33.2
2007,ISERE,Monestier-de-Clermont,3573,343,3230,31,3199,1,PCF,67,6.550000000000001,33.2
2007,ISERE,Monestier-de-Clermont,3573,343,3230,31,3199,1,PS,845,6.550000000000001,33.2
2007,ISERE,Monestier-de-Clermont,3573,343,3230,31,3199,1,PT,16,6.550000000000001,33.2
2007,ISERE,Monestier-de-Clermont,3573,343,3230,31,3199,1,UMP,1038,6.550000000000001,33.2
2007,ISERE,Pont-en-Royans,4813,647,4166,64,4102,1,CPNT,102,6.550000000000001,33.2
2007,ISERE,Pont-en-Royans,4813,647,4166,64,4102,1,DVG,78,6.550000000000001,33.2
2007,ISERE,Pont-en-Royans,4813,647,4166,64,4102,1,FN,449,6.550000000000001,33.2
2007,ISERE,Pont-en-Royans,4813,647,4166,64,4102,1,LCR,184,6.550000000000001,33.2
2007,ISERE,Pont-en-Royans,4813,647,4166,64,4102,1,LO,68,6.550000000000001,33.2
2007,ISERE,Pont-en-Royans,4813,647,4166,64,4102,1,LV,114,6.550000000000001,33.2
2007,ISERE,Pont-en-Royans,4813,647,4166,64,4102,1,MODEM,715,6.550000000000001,33.2
2007,ISERE,Pont-en-Royans,4813,647,4166,64,4102,1,MPF,105,6.550000000000001,33.2
2007,ISERE,Pont-en-Royans,4813,647,4166,64,4102,1,PCF,68,6.550000000000001,33.2
2007,ISERE,Pont-en-Royans,4813,647,4166,64,4102,1,PS,1046,6.550000000000001,33.2
2007,ISERE,Pont-en-Royans,4813,647,4166,64,4102,1,PT,13,6.550000000000001,33.2
2007,ISERE,Pont-en-Royans,4813,647,4166,64,4102,1,UMP,1160,6.550000000000001,33.2
2007,ISERE,Roybon,4833,663,4170,73,4097,1,CPNT,93,6.550000000000001,33.2
2007,ISERE,Roybon,4833,663,4170,73,4097,1,DVG,73,6.550000000000001,33.2
2007,ISERE,Roybon,4833,663,4170,73,4097,1,FN,506,6.550000000000001,33.2
2007,ISERE,Roybon,4833,663,4170,73,4097,1,LCR,180,6.550000000000001,33.2
2007,ISERE,Roybon,4833,663,4170,73,4097,1,LO,65,6.550000000000001,33.2
2007,ISERE,Roybon,4833,663,4170,73,4097,1,LV,79,6.550000000000001,33.2
2007,ISERE,Roybon,4833,663,4170,73,4097,1,MODEM,820,6.550000000000001,33.2
2007,ISERE,Roybon,4833,663,4170,73,4097,1,MPF,110,6.550000000000001,33.2
2007,ISERE,Roybon,4833,663,4170,73,4097,1,PCF,95,6.550000000000001,33.2
2007,ISERE,Roybon,4833,663,4170,73,4097,1,PS,883,6.550000000000001,33.2
2007,ISERE,Roybon,4833,663,4170,73,4097,1,PT,31,6.550000000000001,33.2
2007,ISERE,Roybon,4833,663,4170,73,4097,1,UMP,1162,6.550000000000001,33.2
2007,ISERE,Allevard,5570,820,4750,60,4690,1,CPNT,58,6.550000000000001,33.2
2007,ISERE,Allevard,5570,820,4750,60,4690,1,DVG,109,6.550000000000001,33.2
2007,ISERE,Allevard,5570,820,4750,60,4690,1,FN,414,6.550000000000001,33.2
2007,ISERE,Allevard,5570,820,4750,60,4690,1,LCR,241,6.550000000000001,33.2
2007,ISERE,Allevard,5570,820,4750,60,4690,1,LO,38,6.550000000000001,33.2
2007,ISERE,Allevard,5570,820,4750,60,4690,1,LV,109,6.550000000000001,33.2
2007,ISERE,Allevard,5570,820,4750,60,4690,1,MODEM,898,6.550000000000001,33.2
2007,ISERE,Allevard,5570,820,4750,60,4690,1,MPF,96,6.550000000000001,33.2
2007,ISERE,Allevard,5570,820,4750,60,4690,1,PCF,105,6.550000000000001,33.2
2007,ISERE,Allevard,5570,820,4750,60,4690,1,PS,1337,6.550000000000001,33.2
2007,ISERE,Allevard,5570,820,4750,60,4690,1,PT,13,6.550000000000001,33.2
2007,ISERE,Allevard,5570,820,4750,60,4690,1,UMP,1272,6.550000000000001,33.2
2007,ISERE,Vinay,6338,936,5402,103,5299,1,CPNT,126,6.550000000000001,33.2
2007,ISERE,Vinay,6338,936,5402,103,5299,1,DVG,94,6.550000000000001,33.2
2007,ISERE,Vinay,6338,936,5402,103,5299,1,FN,692,6.550000000000001,33.2
2007,ISERE,Vinay,6338,936,5402,103,5299,1,LCR,176,6.550000000000001,33.2
2007,ISERE,Vinay,6338,936,5402,103,5299,1,LO,58,6.550000000000001,33.2
2007,ISERE,Vinay,6338,936,5402,103,5299,1,LV,81,6.550000000000001,33.2
2007,ISERE,Vinay,6338,936,5402,103,5299,1,MODEM,933,6.550000000000001,33.2
2007,ISERE,Vinay,6338,936,5402,103,5299,1,MPF,139,6.550000000000001,33.2
2007,ISERE,Vinay,6338,936,5402,103,5299,1,PCF,62,6.550000000000001,33.2
2007,ISERE,Vinay,6338,936,5402,103,5299,1,PS,1267,6.550000000000001,33.2
2007,ISERE,Vinay,6338,936,5402,103,5299,1,PT,13,6.550000000000001,33.2
2007,ISERE,Vinay,6338,936,5402,103,5299,1,UMP,1658,6.550000000000001,33.2
2007,ISERE,SAINT-MARTIN-D'HERES-SUD,6743,990,5753,56,5697,1,CPNT,18,6.550000000000001,33.2
2007,ISERE,SAINT-MARTIN-D'HERES-SUD,6743,990,5753,56,5697,1,DVG,83,6.550000000000001,33.2
2007,ISERE,SAINT-MARTIN-D'HERES-SUD,6743,990,5753,56,5697,1,FN,444,6.550000000000001,33.2
2007,ISERE,SAINT-MARTIN-D'HERES-SUD,6743,990,5753,56,5697,1,LCR,282,6.550000000000001,33.2
2007,ISERE,SAINT-MARTIN-D'HERES-SUD,6743,990,5753,56,5697,1,LO,65,6.550000000000001,33.2
2007,ISERE,SAINT-MARTIN-D'HERES-SUD,6743,990,5753,56,5697,1,LV,127,6.550000000000001,33.2
2007,ISERE,SAINT-MARTIN-D'HERES-SUD,6743,990,5753,56,5697,1,MODEM,1073,6.550000000000001,33.2
2007,ISERE,SAINT-MARTIN-D'HERES-SUD,6743,990,5753,56,5697,1,MPF,68,6.550000000000001,33.2
2007,ISERE,SAINT-MARTIN-D'HERES-SUD,6743,990,5753,56,5697,1,PCF,234,6.550000000000001,33.2
2007,ISERE,SAINT-MARTIN-D'HERES-SUD,6743,990,5753,56,5697,1,PS,1986,6.550000000000001,33.2
2007,ISERE,SAINT-MARTIN-D'HERES-SUD,6743,990,5753,56,5697,1,PT,7,6.550000000000001,33.2
2007,ISERE,SAINT-MARTIN-D'HERES-SUD,6743,990,5753,56,5697,1,UMP,1310,6.550000000000001,33.2
2007,ISERE,Saint-Geoire-en-Valdaine,6909,901,6008,88,5920,1,CPNT,87,6.550000000000001,33.2
2007,ISERE,Saint-Geoire-en-Valdaine,6909,901,6008,88,5920,1,DVG,115,6.550000000000001,33.2
2007,ISERE,Saint-Geoire-en-Valdaine,6909,901,6008,88,5920,1,FN,769,6.550000000000001,33.2
2007,ISERE,Saint-Geoire-en-Valdaine,6909,901,6008,88,5920,1,LCR,219,6.550000000000001,33.2
2007,ISERE,Saint-Geoire-en-Valdaine,6909,901,6008,88,5920,1,LO,90,6.550000000000001,33.2
2007,ISERE,Saint-Geoire-en-Valdaine,6909,901,6008,88,5920,1,LV,105,6.550000000000001,33.2
2007,ISERE,Saint-Geoire-en-Valdaine,6909,901,6008,88,5920,1,MODEM,1172,6.550000000000001,33.2
2007,ISERE,Saint-Geoire-en-Valdaine,6909,901,6008,88,5920,1,MPF,152,6.550000000000001,33.2
2007,ISERE,Saint-Geoire-en-Valdaine,6909,901,6008,88,5920,1,PCF,63,6.550000000000001,33.2
2007,ISERE,Saint-Geoire-en-Valdaine,6909,901,6008,88,5920,1,PS,1180,6.550000000000001,33.2
2007,ISERE,Saint-Geoire-en-Valdaine,6909,901,6008,88,5920,1,PT,22,6.550000000000001,33.2
2007,ISERE,Saint-Geoire-en-Valdaine,6909,901,6008,88,5920,1,UMP,1946,6.550000000000001,33.2
2007,ISERE,VIRIEU,7726,948,6778,74,6704,1,CPNT,108,6.550000000000001,33.2
2007,ISERE,VIRIEU,7726,948,6778,74,6704,1,DVG,103,6.550000000000001,33.2
2007,ISERE,VIRIEU,7726,948,6778,74,6704,1,FN,797,6.550000000000001,33.2
2007,ISERE,VIRIEU,7726,948,6778,74,6704,1,LCR,286,6.550000000000001,33.2
2007,ISERE,VIRIEU,7726,948,6778,74,6704,1,LO,86,6.550000000000001,33.2
2007,ISERE,VIRIEU,7726,948,6778,74,6704,1,LV,125,6.550000000000001,33.2
2007,ISERE,VIRIEU,7726,948,6778,74,6704,1,MODEM,1385,6.550000000000001,33.2
2007,ISERE,VIRIEU,7726,948,6778,74,6704,1,MPF,159,6.550000000000001,33.2
2007,ISERE,VIRIEU,7726,948,6778,74,6704,1,PCF,98,6.550000000000001,33.2
2007,ISERE,VIRIEU,7726,948,6778,74,6704,1,PS,1442,6.550000000000001,33.2
2007,ISERE,VIRIEU,7726,948,6778,74,6704,1,PT,41,6.550000000000001,33.2
2007,ISERE,VIRIEU,7726,948,6778,74,6704,1,UMP,2074,6.550000000000001,33.2
2007,ISERE,ECHIROLLES-EST,8315,1123,7192,70,7122,1,CPNT,16,6.550000000000001,33.2
2007,ISERE,ECHIROLLES-EST,8315,1123,7192,70,7122,1,DVG,128,6.550000000000001,33.2
2007,ISERE,ECHIROLLES-EST,8315,1123,7192,70,7122,1,FN,607,6.550000000000001,33.2
2007,ISERE,ECHIROLLES-EST,8315,1123,7192,70,7122,1,LCR,310,6.550000000000001,33.2
2007,ISERE,ECHIROLLES-EST,8315,1123,7192,70,7122,1,LO,94,6.550000000000001,33.2
2007,ISERE,ECHIROLLES-EST,8315,1123,7192,70,7122,1,LV,130,6.550000000000001,33.2
2007,ISERE,ECHIROLLES-EST,8315,1123,7192,70,7122,1,MODEM,1184,6.550000000000001,33.2
2007,ISERE,ECHIROLLES-EST,8315,1123,7192,70,7122,1,MPF,104,6.550000000000001,33.2
2007,ISERE,ECHIROLLES-EST,8315,1123,7192,70,7122,1,PCF,263,6.550000000000001,33.2
2007,ISERE,ECHIROLLES-EST,8315,1123,7192,70,7122,1,PS,2649,6.550000000000001,33.2
2007,ISERE,ECHIROLLES-EST,8315,1123,7192,70,7122,1,PT,9,6.550000000000001,33.2
2007,ISERE,ECHIROLLES-EST,8315,1123,7192,70,7122,1,UMP,1628,6.550000000000001,33.2
2007,ISERE,Saint-Laurent-du-Pont,8379,1154,7225,88,7137,1,CPNT,111,6.550000000000001,33.2
2007,ISERE,Saint-Laurent-du-Pont,8379,1154,7225,88,7137,1,DVG,157,6.550000000000001,33.2
2007,ISERE,Saint-Laurent-du-Pont,8379,1154,7225,88,7137,1,FN,831,6.550000000000001,33.2
2007,ISERE,Saint-Laurent-du-Pont,8379,1154,7225,88,7137,1,LCR,353,6.550000000000001,33.2
2007,ISERE,Saint-Laurent-du-Pont,8379,1154,7225,88,7137,1,LO,112,6.550000000000001,33.2
2007,ISERE,Saint-Laurent-du-Pont,8379,1154,7225,88,7137,1,LV,148,6.550000000000001,33.2
2007,ISERE,Saint-Laurent-du-Pont,8379,1154,7225,88,7137,1,MODEM,1409,6.550000000000001,33.2
2007,ISERE,Saint-Laurent-du-Pont,8379,1154,7225,88,7137,1,MPF,163,6.550000000000001,33.2
2007,ISERE,Saint-Laurent-du-Pont,8379,1154,7225,88,7137,1,PCF,77,6.550000000000001,33.2
2007,ISERE,Saint-Laurent-du-Pont,8379,1154,7225,88,7137,1,PS,1577,6.550000000000001,33.2
2007,ISERE,Saint-Laurent-du-Pont,8379,1154,7225,88,7137,1,PT,22,6.550000000000001,33.2
2007,ISERE,Saint-Laurent-du-Pont,8379,1154,7225,88,7137,1,UMP,2177,6.550000000000001,33.2
2007,ISERE,Saint-Etienne-de-Saint-Geoirs,8500,1154,7346,110,7236,1,CPNT,104,6.550000000000001,33.2
2007,ISERE,Saint-Etienne-de-Saint-Geoirs,8500,1154,7346,110,7236,1,DVG,125,6.550000000000001,33.2
2007,ISERE,Saint-Etienne-de-Saint-Geoirs,8500,1154,7346,110,7236,1,FN,744,6.550000000000001,33.2
2007,ISERE,Saint-Etienne-de-Saint-Geoirs,8500,1154,7346,110,7236,1,LCR,287,6.550000000000001,33.2
2007,ISERE,Saint-Etienne-de-Saint-Geoirs,8500,1154,7346,110,7236,1,LO,102,6.550000000000001,33.2
2007,ISERE,Saint-Etienne-de-Saint-Geoirs,8500,1154,7346,110,7236,1,LV,110,6.550000000000001,33.2
2007,ISERE,Saint-Etienne-de-Saint-Geoirs,8500,1154,7346,110,7236,1,MODEM,1433,6.550000000000001,33.2
2007,ISERE,Saint-Etienne-de-Saint-Geoirs,8500,1154,7346,110,7236,1,MPF,179,6.550000000000001,33.2
2007,ISERE,Saint-Etienne-de-Saint-Geoirs,8500,1154,7346,110,7236,1,PCF,143,6.550000000000001,33.2
2007,ISERE,Saint-Etienne-de-Saint-Geoirs,8500,1154,7346,110,7236,1,PS,1678,6.550000000000001,33.2
2007,ISERE,Saint-Etienne-de-Saint-Geoirs,8500,1154,7346,110,7236,1,PT,36,6.550000000000001,33.2
2007,ISERE,Saint-Etienne-de-Saint-Geoirs,8500,1154,7346,110,7236,1,UMP,2295,6.550000000000001,33.2
2007,ISERE,Tullins,8633,1209,7424,100,7324,1,CPNT,100,6.550000000000001,33.2
2007,ISERE,Tullins,8633,1209,7424,100,7324,1,DVG,133,6.550000000000001,33.2
2007,ISERE,Tullins,8633,1209,7424,100,7324,1,FN,826,6.550000000000001,33.2
2007,ISERE,Tullins,8633,1209,7424,100,7324,1,LCR,311,6.550000000000001,33.2
2007,ISERE,Tullins,8633,1209,7424,100,7324,1,LO,98,6.550000000000001,33.2
2007,ISERE,Tullins,8633,1209,7424,100,7324,1,LV,155,6.550000000000001,33.2
2007,ISERE,Tullins,8633,1209,7424,100,7324,1,MODEM,1426,6.550000000000001,33.2
2007,ISERE,Tullins,8633,1209,7424,100,7324,1,MPF,133,6.550000000000001,33.2
2007,ISERE,Tullins,8633,1209,7424,100,7324,1,PCF,109,6.550000000000001,33.2
2007,ISERE,Tullins,8633,1209,7424,100,7324,1,PS,1945,6.550000000000001,33.2
2007,ISERE,Tullins,8633,1209,7424,100,7324,1,PT,28,6.550000000000001,33.2
2007,ISERE,Tullins,8633,1209,7424,100,7324,1,UMP,2060,6.550000000000001,33.2
2007,ISERE,LE-BOURG-D'OISANS,9050,1343,7707,78,7629,1,CPNT,133,6.550000000000001,33.2
2007,ISERE,LE-BOURG-D'OISANS,9050,1343,7707,78,7629,1,DVG,143,6.550000000000001,33.2
2007,ISERE,LE-BOURG-D'OISANS,9050,1343,7707,78,7629,1,FN,722,6.550000000000001,33.2
2007,ISERE,LE-BOURG-D'OISANS,9050,1343,7707,78,7629,1,LCR,268,6.550000000000001,33.2
2007,ISERE,LE-BOURG-D'OISANS,9050,1343,7707,78,7629,1,LO,102,6.550000000000001,33.2
2007,ISERE,LE-BOURG-D'OISANS,9050,1343,7707,78,7629,1,LV,146,6.550000000000001,33.2
2007,ISERE,LE-BOURG-D'OISANS,9050,1343,7707,78,7629,1,MODEM,1322,6.550000000000001,33.2
2007,ISERE,LE-BOURG-D'OISANS,9050,1343,7707,78,7629,1,MPF,140,6.550000000000001,33.2
2007,ISERE,LE-BOURG-D'OISANS,9050,1343,7707,78,7629,1,PCF,118,6.550000000000001,33.2
2007,ISERE,LE-BOURG-D'OISANS,9050,1343,7707,78,7629,1,PS,1782,6.550000000000001,33.2
2007,ISERE,LE-BOURG-D'OISANS,9050,1343,7707,78,7629,1,PT,22,6.550000000000001,33.2
2007,ISERE,LE-BOURG-D'OISANS,9050,1343,7707,78,7629,1,UMP,2731,6.550000000000001,33.2
2007,ISERE,Villard-de-Lans,9149,1026,8123,79,8044,1,CPNT,104,6.550000000000001,33.2
2007,ISERE,Villard-de-Lans,9149,1026,8123,79,8044,1,DVG,199,6.550000000000001,33.2
2007,ISERE,Villard-de-Lans,9149,1026,8123,79,8044,1,FN,480,6.550000000000001,33.2
2007,ISERE,Villard-de-Lans,9149,1026,8123,79,8044,1,LCR,312,6.550000000000001,33.2
2007,ISERE,Villard-de-Lans,9149,1026,8123,79,8044,1,LO,45,6.550000000000001,33.2
2007,ISERE,Villard-de-Lans,9149,1026,8123,79,8044,1,LV,267,6.550000000000001,33.2
2007,ISERE,Villard-de-Lans,9149,1026,8123,79,8044,1,MODEM,1591,6.550000000000001,33.2
2007,ISERE,Villard-de-Lans,9149,1026,8123,79,8044,1,MPF,146,6.550000000000001,33.2
2007,ISERE,Villard-de-Lans,9149,1026,8123,79,8044,1,PCF,105,6.550000000000001,33.2
2007,ISERE,Villard-de-Lans,9149,1026,8123,79,8044,1,PS,2171,6.550000000000001,33.2
2007,ISERE,Villard-de-Lans,9149,1026,8123,79,8044,1,PT,30,6.550000000000001,33.2
2007,ISERE,Villard-de-Lans,9149,1026,8123,79,8044,1,UMP,2594,6.550000000000001,33.2
2007,ISERE,LA-COTE-SAINT-ANDRE,9954,1255,8699,110,8589,1,CPNT,129,6.550000000000001,33.2
2007,ISERE,LA-COTE-SAINT-ANDRE,9954,1255,8699,110,8589,1,DVG,119,6.550000000000001,33.2
2007,ISERE,LA-COTE-SAINT-ANDRE,9954,1255,8699,110,8589,1,FN,1065,6.550000000000001,33.2
2007,ISERE,LA-COTE-SAINT-ANDRE,9954,1255,8699,110,8589,1,LCR,354,6.550000000000001,33.2
2007,ISERE,LA-COTE-SAINT-ANDRE,9954,1255,8699,110,8589,1,LO,106,6.550000000000001,33.2
2007,ISERE,LA-COTE-SAINT-ANDRE,9954,1255,8699,110,8589,1,LV,140,6.550000000000001,33.2
2007,ISERE,LA-COTE-SAINT-ANDRE,9954,1255,8699,110,8589,1,MODEM,1607,6.550000000000001,33.2
2007,ISERE,LA-COTE-SAINT-ANDRE,9954,1255,8699,110,8589,1,MPF,228,6.550000000000001,33.2
2007,ISERE,LA-COTE-SAINT-ANDRE,9954,1255,8699,110,8589,1,PCF,94,6.550000000000001,33.2
2007,ISERE,LA-COTE-SAINT-ANDRE,9954,1255,8699,110,8589,1,PS,1919,6.550000000000001,33.2
2007,ISERE,LA-COTE-SAINT-ANDRE,9954,1255,8699,110,8589,1,PT,25,6.550000000000001,33.2
2007,ISERE,LA-COTE-SAINT-ANDRE,9954,1255,8699,110,8589,1,UMP,2803,6.550000000000001,33.2
2007,ISERE,SAINT-MARTIN-D'HÈRES-NORD,10203,1444,8759,116,8643,1,CPNT,24,6.550000000000001,33.2
2007,ISERE,SAINT-MARTIN-D'HÈRES-NORD,10203,1444,8759,116,8643,1,DVG,133,6.550000000000001,33.2
2007,ISERE,SAINT-MARTIN-D'HÈRES-NORD,10203,1444,8759,116,8643,1,FN,655,6.550000000000001,33.2
2007,ISERE,SAINT-MARTIN-D'HÈRES-NORD,10203,1444,8759,116,8643,1,LCR,421,6.550000000000001,33.2
2007,ISERE,SAINT-MARTIN-D'HÈRES-NORD,10203,1444,8759,116,8643,1,LO,99,6.550000000000001,33.2
2007,ISERE,SAINT-MARTIN-D'HÈRES-NORD,10203,1444,8759,116,8643,1,LV,177,6.550000000000001,33.2
2007,ISERE,SAINT-MARTIN-D'HÈRES-NORD,10203,1444,8759,116,8643,1,MODEM,1605,6.550000000000001,33.2
2007,ISERE,SAINT-MARTIN-D'HÈRES-NORD,10203,1444,8759,116,8643,1,MPF,121,6.550000000000001,33.2
2007,ISERE,SAINT-MARTIN-D'HÈRES-NORD,10203,1444,8759,116,8643,1,PCF,548,6.550000000000001,33.2
2007,ISERE,SAINT-MARTIN-D'HÈRES-NORD,10203,1444,8759,116,8643,1,PS,2910,6.550000000000001,33.2
2007,ISERE,SAINT-MARTIN-D'HÈRES-NORD,10203,1444,8759,116,8643,1,PT,26,6.550000000000001,33.2
2007,ISERE,SAINT-MARTIN-D'HÈRES-NORD,10203,1444,8759,116,8643,1,UMP,1924,6.550000000000001,33.2
2007,ISERE,Beaurepaire,10303,1479,8824,135,8689,1,CPNT,117,6.550000000000001,33.2
2007,ISERE,Beaurepaire,10303,1479,8824,135,8689,1,DVG,150,6.550000000000001,33.2
2007,ISERE,Beaurepaire,10303,1479,8824,135,8689,1,FN,1345,6.550000000000001,33.2
2007,ISERE,Beaurepaire,10303,1479,8824,135,8689,1,LCR,356,6.550000000000001,33.2
2007,ISERE,Beaurepaire,10303,1479,8824,135,8689,1,LO,109,6.550000000000001,33.2
2007,ISERE,Beaurepaire,10303,1479,8824,135,8689,1,LV,147,6.550000000000001,33.2
2007,ISERE,Beaurepaire,10303,1479,8824,135,8689,1,MODEM,1422,6.550000000000001,33.2
2007,ISERE,Beaurepaire,10303,1479,8824,135,8689,1,MPF,222,6.550000000000001,33.2
2007,ISERE,Beaurepaire,10303,1479,8824,135,8689,1,PCF,257,6.550000000000001,33.2
2007,ISERE,Beaurepaire,10303,1479,8824,135,8689,1,PS,2008,6.550000000000001,33.2
2007,ISERE,Beaurepaire,10303,1479,8824,135,8689,1,PT,40,6.550000000000001,33.2
2007,ISERE,Beaurepaire,10303,1479,8824,135,8689,1,UMP,2516,6.550000000000001,33.2
2007,ISERE,LE-GRAND-LEMPS,10522,1334,9188,135,9053,1,CPNT,139,6.550000000000001,33.2
2007,ISERE,LE-GRAND-LEMPS,10522,1334,9188,135,9053,1,DVG,126,6.550000000000001,33.2
2007,ISERE,LE-GRAND-LEMPS,10522,1334,9188,135,9053,1,FN,1107,6.550000000000001,33.2
2007,ISERE,LE-GRAND-LEMPS,10522,1334,9188,135,9053,1,LCR,361,6.550000000000001,33.2
2007,ISERE,LE-GRAND-LEMPS,10522,1334,9188,135,9053,1,LO,144,6.550000000000001,33.2
2007,ISERE,LE-GRAND-LEMPS,10522,1334,9188,135,9053,1,LV,151,6.550000000000001,33.2
2007,ISERE,LE-GRAND-LEMPS,10522,1334,9188,135,9053,1,MODEM,1776,6.550000000000001,33.2
2007,ISERE,LE-GRAND-LEMPS,10522,1334,9188,135,9053,1,MPF,204,6.550000000000001,33.2
2007,ISERE,LE-GRAND-LEMPS,10522,1334,9188,135,9053,1,PCF,164,6.550000000000001,33.2
2007,ISERE,LE-GRAND-LEMPS,10522,1334,9188,135,9053,1,PS,2110,6.550000000000001,33.2
2007,ISERE,LE-GRAND-LEMPS,10522,1334,9188,135,9053,1,PT,45,6.550000000000001,33.2
2007,ISERE,LE-GRAND-LEMPS,10522,1334,9188,135,9053,1,UMP,2726,6.550000000000001,33.2
2007,ISERE,La Mure,10556,1537,9019,154,8865,1,CPNT,128,6.550000000000001,33.2
2007,ISERE,La Mure,10556,1537,9019,154,8865,1,DVG,173,6.550000000000001,33.2
2007,ISERE,La Mure,10556,1537,9019,154,8865,1,FN,1047,6.550000000000001,33.2
2007,ISERE,La Mure,10556,1537,9019,154,8865,1,LCR,432,6.550000000000001,33.2
2007,ISERE,La Mure,10556,1537,9019,154,8865,1,LO,149,6.550000000000001,33.2
2007,ISERE,La Mure,10556,1537,9019,154,8865,1,LV,180,6.550000000000001,33.2
2007,ISERE,La Mure,10556,1537,9019,154,8865,1,MODEM,1445,6.550000000000001,33.2
2007,ISERE,La Mure,10556,1537,9019,154,8865,1,MPF,171,6.550000000000001,33.2
2007,ISERE,La Mure,10556,1537,9019,154,8865,1,PCF,248,6.550000000000001,33.2
2007,ISERE,La Mure,10556,1537,9019,154,8865,1,PS,2630,6.550000000000001,33.2
2007,ISERE,La Mure,10556,1537,9019,154,8865,1,PT,57,6.550000000000001,33.2
2007,ISERE,La Mure,10556,1537,9019,154,8865,1,UMP,2205,6.550000000000001,33.2
2007,ISERE,GRENOBLE-4,11064,1631,9433,87,9346,1,CPNT,29,6.550000000000001,33.2
2007,ISERE,GRENOBLE-4,11064,1631,9433,87,9346,1,DVG,147,6.550000000000001,33.2
2007,ISERE,GRENOBLE-4,11064,1631,9433,87,9346,1,FN,473,6.550000000000001,33.2
2007,ISERE,GRENOBLE-4,11064,1631,9433,87,9346,1,LCR,234,6.550000000000001,33.2
2007,ISERE,GRENOBLE-4,11064,1631,9433,87,9346,1,LO,64,6.550000000000001,33.2
2007,ISERE,GRENOBLE-4,11064,1631,9433,87,9346,1,LV,246,6.550000000000001,33.2
2007,ISERE,GRENOBLE-4,11064,1631,9433,87,9346,1,MODEM,1924,6.550000000000001,33.2
2007,ISERE,GRENOBLE-4,11064,1631,9433,87,9346,1,MPF,117,6.550000000000001,33.2
2007,ISERE,GRENOBLE-4,11064,1631,9433,87,9346,1,PCF,130,6.550000000000001,33.2
2007,ISERE,GRENOBLE-4,11064,1631,9433,87,9346,1,PS,3126,6.550000000000001,33.2
2007,ISERE,GRENOBLE-4,11064,1631,9433,87,9346,1,PT,22,6.550000000000001,33.2
2007,ISERE,GRENOBLE-4,11064,1631,9433,87,9346,1,UMP,2834,6.550000000000001,33.2
2007,ISERE,Saint-Jean-de-Bournay,11518,1495,10023,197,9826,1,CPNT,156,6.550000000000001,33.2
2007,ISERE,Saint-Jean-de-Bournay,11518,1495,10023,197,9826,1,DVG,131,6.550000000000001,33.2
2007,ISERE,Saint-Jean-de-Bournay,11518,1495,10023,197,9826,1,FN,1604,6.550000000000001,33.2
2007,ISERE,Saint-Jean-de-Bournay,11518,1495,10023,197,9826,1,LCR,317,6.550000000000001,33.2
2007,ISERE,Saint-Jean-de-Bournay,11518,1495,10023,197,9826,1,LO,116,6.550000000000001,33.2
2007,ISERE,Saint-Jean-de-Bournay,11518,1495,10023,197,9826,1,LV,147,6.550000000000001,33.2
2007,ISERE,Saint-Jean-de-Bournay,11518,1495,10023,197,9826,1,MODEM,1860,6.550000000000001,33.2
2007,ISERE,Saint-Jean-de-Bournay,11518,1495,10023,197,9826,1,MPF,274,6.550000000000001,33.2
2007,ISERE,Saint-Jean-de-Bournay,11518,1495,10023,197,9826,1,PCF,133,6.550000000000001,33.2
2007,ISERE,Saint-Jean-de-Bournay,11518,1495,10023,197,9826,1,PS,1702,6.550000000000001,33.2
2007,ISERE,Saint-Jean-de-Bournay,11518,1495,10023,197,9826,1,PT,49,6.550000000000001,33.2
2007,ISERE,Saint-Jean-de-Bournay,11518,1495,10023,197,9826,1,UMP,3337,6.550000000000001,33.2
2007,ISERE,GRENOBLE-6,11614,1923,9691,86,9605,1,CPNT,26,6.550000000000001,33.2
2007,ISERE,GRENOBLE-6,11614,1923,9691,86,9605,1,DVG,213,6.550000000000001,33.2
2007,ISERE,GRENOBLE-6,11614,1923,9691,86,9605,1,FN,625,6.550000000000001,33.2
2007,ISERE,GRENOBLE-6,11614,1923,9691,86,9605,1,LCR,387,6.550000000000001,33.2
2007,ISERE,GRENOBLE-6,11614,1923,9691,86,9605,1,LO,88,6.550000000000001,33.2
2007,ISERE,GRENOBLE-6,11614,1923,9691,86,9605,1,LV,118,6.550000000000001,33.2
2007,ISERE,GRENOBLE-6,11614,1923,9691,86,9605,1,MODEM,1670,6.550000000000001,33.2
2007,ISERE,GRENOBLE-6,11614,1923,9691,86,9605,1,MPF,119,6.550000000000001,33.2
2007,ISERE,GRENOBLE-6,11614,1923,9691,86,9605,1,PCF,167,6.550000000000001,33.2
2007,ISERE,GRENOBLE-6,11614,1923,9691,86,9605,1,PS,3892,6.550000000000001,33.2
2007,ISERE,GRENOBLE-6,11614,1923,9691,86,9605,1,PT,22,6.550000000000001,33.2
2007,ISERE,GRENOBLE-6,11614,1923,9691,86,9605,1,UMP,2278,6.550000000000001,33.2
2007,ISERE,La Verpillière,11720,1515,10205,162,10043,1,CPNT,97,6.550000000000001,33.2
2007,ISERE,La Verpillière,11720,1515,10205,162,10043,1,DVG,114,6.550000000000001,33.2
2007,ISERE,La Verpillière,11720,1515,10205,162,10043,1,FN,1366,6.550000000000001,33.2
2007,ISERE,La Verpillière,11720,1515,10205,162,10043,1,LCR,357,6.550000000000001,33.2
2007,ISERE,La Verpillière,11720,1515,10205,162,10043,1,LO,139,6.550000000000001,33.2
2007,ISERE,La Verpillière,11720,1515,10205,162,10043,1,LV,176,6.550000000000001,33.2
2007,ISERE,La Verpillière,11720,1515,10205,162,10043,1,MODEM,1879,6.550000000000001,33.2
2007,ISERE,La Verpillière,11720,1515,10205,162,10043,1,MPF,274,6.550000000000001,33.2
2007,ISERE,La Verpillière,11720,1515,10205,162,10043,1,PCF,191,6.550000000000001,33.2
2007,ISERE,La Verpillière,11720,1515,10205,162,10043,1,PS,2254,6.550000000000001,33.2
2007,ISERE,La Verpillière,11720,1515,10205,162,10043,1,PT,42,6.550000000000001,33.2
2007,ISERE,La Verpillière,11720,1515,10205,162,10043,1,UMP,3154,6.550000000000001,33.2
2007,ISERE,ECHIROLLES-OUEST,12362,1525,10837,124,10713,1,CPNT,31,6.550000000000001,33.2
2007,ISERE,ECHIROLLES-OUEST,12362,1525,10837,124,10713,1,DVG,134,6.550000000000001,33.2
2007,ISERE,ECHIROLLES-OUEST,12362,1525,10837,124,10713,1,FN,1003,6.550000000000001,33.2
2007,ISERE,ECHIROLLES-OUEST,12362,1525,10837,124,10713,1,LCR,465,6.550000000000001,33.2
2007,ISERE,ECHIROLLES-OUEST,12362,1525,10837,124,10713,1,LO,108,6.550000000000001,33.2
2007,ISERE,ECHIROLLES-OUEST,12362,1525,10837,124,10713,1,LV,157,6.550000000000001,33.2
2007,ISERE,ECHIROLLES-OUEST,12362,1525,10837,124,10713,1,MODEM,1868,6.550000000000001,33.2
2007,ISERE,ECHIROLLES-OUEST,12362,1525,10837,124,10713,1,MPF,160,6.550000000000001,33.2
2007,ISERE,ECHIROLLES-OUEST,12362,1525,10837,124,10713,1,PCF,418,6.550000000000001,33.2
2007,ISERE,ECHIROLLES-OUEST,12362,1525,10837,124,10713,1,PS,3384,6.550000000000001,33.2
2007,ISERE,ECHIROLLES-OUEST,12362,1525,10837,124,10713,1,PT,31,6.550000000000001,33.2
2007,ISERE,ECHIROLLES-OUEST,12362,1525,10837,124,10713,1,UMP,2954,6.550000000000001,33.2
2007,ISERE,Eybens,13208,1454,11754,122,11632,1,CPNT,49,6.550000000000001,33.2
2007,ISERE,Eybens,13208,1454,11754,122,11632,1,DVG,183,6.550000000000001,33.2
2007,ISERE,Eybens,13208,1454,11754,122,11632,1,FN,734,6.550000000000001,33.2
2007,ISERE,Eybens,13208,1454,11754,122,11632,1,LCR,426,6.550000000000001,33.2
2007,ISERE,Eybens,13208,1454,11754,122,11632,1,LO,91,6.550000000000001,33.2
2007,ISERE,Eybens,13208,1454,11754,122,11632,1,LV,224,6.550000000000001,33.2
2007,ISERE,Eybens,13208,1454,11754,122,11632,1,MODEM,2307,6.550000000000001,33.2
2007,ISERE,Eybens,13208,1454,11754,122,11632,1,MPF,166,6.550000000000001,33.2
2007,ISERE,Eybens,13208,1454,11754,122,11632,1,PCF,245,6.550000000000001,33.2
2007,ISERE,Eybens,13208,1454,11754,122,11632,1,PS,3792,6.550000000000001,33.2
2007,ISERE,Eybens,13208,1454,11754,122,11632,1,PT,33,6.550000000000001,33.2
2007,ISERE,Eybens,13208,1454,11754,122,11632,1,UMP,3382,6.550000000000001,33.2
2007,ISERE,GRENOBLE-3,13489,1888,11601,106,11495,1,CPNT,31,6.550000000000001,33.2
2007,ISERE,GRENOBLE-3,13489,1888,11601,106,11495,1,DVG,244,6.550000000000001,33.2
2007,ISERE,GRENOBLE-3,13489,1888,11601,106,11495,1,FN,723,6.550000000000001,33.2
2007,ISERE,GRENOBLE-3,13489,1888,11601,106,11495,1,LCR,416,6.550000000000001,33.2
2007,ISERE,GRENOBLE-3,13489,1888,11601,106,11495,1,LO,104,6.550000000000001,33.2
2007,ISERE,GRENOBLE-3,13489,1888,11601,106,11495,1,LV,235,6.550000000000001,33.2
2007,ISERE,GRENOBLE-3,13489,1888,11601,106,11495,1,MODEM,2053,6.550000000000001,33.2
2007,ISERE,GRENOBLE-3,13489,1888,11601,106,11495,1,MPF,114,6.550000000000001,33.2
2007,ISERE,GRENOBLE-3,13489,1888,11601,106,11495,1,PCF,237,6.550000000000001,33.2
2007,ISERE,GRENOBLE-3,13489,1888,11601,106,11495,1,PS,4615,6.550000000000001,33.2
2007,ISERE,GRENOBLE-3,13489,1888,11601,106,11495,1,PT,32,6.550000000000001,33.2
2007,ISERE,GRENOBLE-3,13489,1888,11601,106,11495,1,UMP,2691,6.550000000000001,33.2
2007,ISERE,Heyrieux,14208,1776,12432,187,12245,1,CPNT,139,6.550000000000001,33.2
2007,ISERE,Heyrieux,14208,1776,12432,187,12245,1,DVG,152,6.550000000000001,33.2
2007,ISERE,Heyrieux,14208,1776,12432,187,12245,1,FN,1780,6.550000000000001,33.2
2007,ISERE,Heyrieux,14208,1776,12432,187,12245,1,LCR,456,6.550000000000001,33.2
2007,ISERE,Heyrieux,14208,1776,12432,187,12245,1,LO,150,6.550000000000001,33.2
2007,ISERE,Heyrieux,14208,1776,12432,187,12245,1,LV,208,6.550000000000001,33.2
2007,ISERE,Heyrieux,14208,1776,12432,187,12245,1,MODEM,2320,6.550000000000001,33.2
2007,ISERE,Heyrieux,14208,1776,12432,187,12245,1,MPF,301,6.550000000000001,33.2
2007,ISERE,Heyrieux,14208,1776,12432,187,12245,1,PCF,156,6.550000000000001,33.2
2007,ISERE,Heyrieux,14208,1776,12432,187,12245,1,PS,2219,6.550000000000001,33.2
2007,ISERE,Heyrieux,14208,1776,12432,187,12245,1,PT,39,6.550000000000001,33.2
2007,ISERE,Heyrieux,14208,1776,12432,187,12245,1,UMP,4325,6.550000000000001,33.2
2007,ISERE,GRENOBLE-2,14318,1977,12341,98,12243,1,CPNT,33,6.550000000000001,33.2
2007,ISERE,GRENOBLE-2,14318,1977,12341,98,12243,1,DVG,177,6.550000000000001,33.2
2007,ISERE,GRENOBLE-2,14318,1977,12341,98,12243,1,FN,492,6.550000000000001,33.2
2007,ISERE,GRENOBLE-2,14318,1977,12341,98,12243,1,LCR,327,6.550000000000001,33.2
2007,ISERE,GRENOBLE-2,14318,1977,12341,98,12243,1,LO,72,6.550000000000001,33.2
2007,ISERE,GRENOBLE-2,14318,1977,12341,98,12243,1,LV,251,6.550000000000001,33.2
2007,ISERE,GRENOBLE-2,14318,1977,12341,98,12243,1,MODEM,2579,6.550000000000001,33.2
2007,ISERE,GRENOBLE-2,14318,1977,12341,98,12243,1,MPF,199,6.550000000000001,33.2
2007,ISERE,GRENOBLE-2,14318,1977,12341,98,12243,1,PCF,179,6.550000000000001,33.2
2007,ISERE,GRENOBLE-2,14318,1977,12341,98,12243,1,PS,3922,6.550000000000001,33.2
2007,ISERE,GRENOBLE-2,14318,1977,12341,98,12243,1,PT,27,6.550000000000001,33.2
2007,ISERE,GRENOBLE-2,14318,1977,12341,98,12243,1,UMP,3985,6.550000000000001,33.2
2007,ISERE,Saint-Ismier,14452,1323,13129,102,13027,1,CPNT,54,6.550000000000001,33.2
2007,ISERE,Saint-Ismier,14452,1323,13129,102,13027,1,DVG,124,6.550000000000001,33.2
2007,ISERE,Saint-Ismier,14452,1323,13129,102,13027,1,FN,557,6.550000000000001,33.2
2007,ISERE,Saint-Ismier,14452,1323,13129,102,13027,1,LCR,214,6.550000000000001,33.2
2007,ISERE,Saint-Ismier,14452,1323,13129,102,13027,1,LO,77,6.550000000000001,33.2
2007,ISERE,Saint-Ismier,14452,1323,13129,102,13027,1,LV,251,6.550000000000001,33.2
2007,ISERE,Saint-Ismier,14452,1323,13129,102,13027,1,MODEM,3176,6.550000000000001,33.2
2007,ISERE,Saint-Ismier,14452,1323,13129,102,13027,1,MPF,201,6.550000000000001,33.2
2007,ISERE,Saint-Ismier,14452,1323,13129,102,13027,1,PCF,101,6.550000000000001,33.2
2007,ISERE,Saint-Ismier,14452,1323,13129,102,13027,1,PS,3024,6.550000000000001,33.2
2007,ISERE,Saint-Ismier,14452,1323,13129,102,13027,1,PT,20,6.550000000000001,33.2
2007,ISERE,Saint-Ismier,14452,1323,13129,102,13027,1,UMP,5228,6.550000000000001,33.2
2007,ISERE,LE-PONT-DE-BEAUVOISIN,14826,2278,12548,200,12348,1,CPNT,151,6.550000000000001,33.2
2007,ISERE,LE-PONT-DE-BEAUVOISIN,14826,2278,12548,200,12348,1,DVG,182,6.550000000000001,33.2
2007,ISERE,LE-PONT-DE-BEAUVOISIN,14826,2278,12548,200,12348,1,FN,1958,6.550000000000001,33.2
2007,ISERE,LE-PONT-DE-BEAUVOISIN,14826,2278,12548,200,12348,1,LCR,435,6.550000000000001,33.2
2007,ISERE,LE-PONT-DE-BEAUVOISIN,14826,2278,12548,200,12348,1,LO,161,6.550000000000001,33.2
2007,ISERE,LE-PONT-DE-BEAUVOISIN,14826,2278,12548,200,12348,1,LV,213,6.550000000000001,33.2
2007,ISERE,LE-PONT-DE-BEAUVOISIN,14826,2278,12548,200,12348,1,MODEM,2291,6.550000000000001,33.2
2007,ISERE,LE-PONT-DE-BEAUVOISIN,14826,2278,12548,200,12348,1,MPF,314,6.550000000000001,33.2
2007,ISERE,LE-PONT-DE-BEAUVOISIN,14826,2278,12548,200,12348,1,PCF,186,6.550000000000001,33.2
2007,ISERE,LE-PONT-DE-BEAUVOISIN,14826,2278,12548,200,12348,1,PS,2603,6.550000000000001,33.2
2007,ISERE,LE-PONT-DE-BEAUVOISIN,14826,2278,12548,200,12348,1,PT,50,6.550000000000001,33.2
2007,ISERE,LE-PONT-DE-BEAUVOISIN,14826,2278,12548,200,12348,1,UMP,3804,6.550000000000001,33.2
2007,ISERE,PONT-DE-CHERUY,15206,2915,12291,154,12137,1,CPNT,61,6.550000000000001,33.2
2007,ISERE,PONT-DE-CHERUY,15206,2915,12291,154,12137,1,DVG,118,6.550000000000001,33.2
2007,ISERE,PONT-DE-CHERUY,15206,2915,12291,154,12137,1,FN,1854,6.550000000000001,33.2
2007,ISERE,PONT-DE-CHERUY,15206,2915,12291,154,12137,1,LCR,399,6.550000000000001,33.2
2007,ISERE,PONT-DE-CHERUY,15206,2915,12291,154,12137,1,LO,171,6.550000000000001,33.2
2007,ISERE,PONT-DE-CHERUY,15206,2915,12291,154,12137,1,LV,143,6.550000000000001,33.2
2007,ISERE,PONT-DE-CHERUY,15206,2915,12291,154,12137,1,MODEM,2043,6.550000000000001,33.2
2007,ISERE,PONT-DE-CHERUY,15206,2915,12291,154,12137,1,MPF,312,6.550000000000001,33.2
2007,ISERE,PONT-DE-CHERUY,15206,2915,12291,154,12137,1,PCF,165,6.550000000000001,33.2
2007,ISERE,PONT-DE-CHERUY,15206,2915,12291,154,12137,1,PS,2726,6.550000000000001,33.2
2007,ISERE,PONT-DE-CHERUY,15206,2915,12291,154,12137,1,PT,38,6.550000000000001,33.2
2007,ISERE,PONT-DE-CHERUY,15206,2915,12291,154,12137,1,UMP,4107,6.550000000000001,33.2
2007,ISERE,Goncelin,15387,2071,13316,192,13124,1,CPNT,124,6.550000000000001,33.2
2007,ISERE,Goncelin,15387,2071,13316,192,13124,1,DVG,213,6.550000000000001,33.2
2007,ISERE,Goncelin,15387,2071,13316,192,13124,1,FN,1334,6.550000000000001,33.2
2007,ISERE,Goncelin,15387,2071,13316,192,13124,1,LCR,577,6.550000000000001,33.2
2007,ISERE,Goncelin,15387,2071,13316,192,13124,1,LO,170,6.550000000000001,33.2
2007,ISERE,Goncelin,15387,2071,13316,192,13124,1,LV,274,6.550000000000001,33.2
2007,ISERE,Goncelin,15387,2071,13316,192,13124,1,MODEM,2495,6.550000000000001,33.2
2007,ISERE,Goncelin,15387,2071,13316,192,13124,1,MPF,226,6.550000000000001,33.2
2007,ISERE,Goncelin,15387,2071,13316,192,13124,1,PCF,289,6.550000000000001,33.2
2007,ISERE,Goncelin,15387,2071,13316,192,13124,1,PS,3698,6.550000000000001,33.2
2007,ISERE,Goncelin,15387,2071,13316,192,13124,1,PT,52,6.550000000000001,33.2
2007,ISERE,Goncelin,15387,2071,13316,192,13124,1,UMP,3672,6.550000000000001,33.2
2007,ISERE,BOURGOIN-JALLIEU-SUD,15814,2156,13658,194,13464,1,CPNT,103,6.550000000000001,33.2
2007,ISERE,BOURGOIN-JALLIEU-SUD,15814,2156,13658,194,13464,1,DVG,165,6.550000000000001,33.2
2007,ISERE,BOURGOIN-JALLIEU-SUD,15814,2156,13658,194,13464,1,FN,1539,6.550000000000001,33.2
2007,ISERE,BOURGOIN-JALLIEU-SUD,15814,2156,13658,194,13464,1,LCR,446,6.550000000000001,33.2
2007,ISERE,BOURGOIN-JALLIEU-SUD,15814,2156,13658,194,13464,1,LO,143,6.550000000000001,33.2
2007,ISERE,BOURGOIN-JALLIEU-SUD,15814,2156,13658,194,13464,1,LV,238,6.550000000000001,33.2
2007,ISERE,BOURGOIN-JALLIEU-SUD,15814,2156,13658,194,13464,1,MODEM,2676,6.550000000000001,33.2
2007,ISERE,BOURGOIN-JALLIEU-SUD,15814,2156,13658,194,13464,1,MPF,310,6.550000000000001,33.2
2007,ISERE,BOURGOIN-JALLIEU-SUD,15814,2156,13658,194,13464,1,PCF,214,6.550000000000001,33.2
2007,ISERE,BOURGOIN-JALLIEU-SUD,15814,2156,13658,194,13464,1,PS,2910,6.550000000000001,33.2
2007,ISERE,BOURGOIN-JALLIEU-SUD,15814,2156,13658,194,13464,1,PT,32,6.550000000000001,33.2
2007,ISERE,BOURGOIN-JALLIEU-SUD,15814,2156,13658,194,13464,1,UMP,4688,6.550000000000001,33.2
2007,ISERE,Saint-Marcellin,15989,2343,13646,211,13435,1,CPNT,226,6.550000000000001,33.2
2007,ISERE,Saint-Marcellin,15989,2343,13646,211,13435,1,DVG,273,6.550000000000001,33.2
2007,ISERE,Saint-Marcellin,15989,2343,13646,211,13435,1,FN,1544,6.550000000000001,33.2
2007,ISERE,Saint-Marcellin,15989,2343,13646,211,13435,1,LCR,509,6.550000000000001,33.2
2007,ISERE,Saint-Marcellin,15989,2343,13646,211,13435,1,LO,146,6.550000000000001,33.2
2007,ISERE,Saint-Marcellin,15989,2343,13646,211,13435,1,LV,203,6.550000000000001,33.2
2007,ISERE,Saint-Marcellin,15989,2343,13646,211,13435,1,MODEM,2606,6.550000000000001,33.2
2007,ISERE,Saint-Marcellin,15989,2343,13646,211,13435,1,MPF,374,6.550000000000001,33.2
2007,ISERE,Saint-Marcellin,15989,2343,13646,211,13435,1,PCF,144,6.550000000000001,33.2
2007,ISERE,Saint-Marcellin,15989,2343,13646,211,13435,1,PS,2965,6.550000000000001,33.2
2007,ISERE,Saint-Marcellin,15989,2343,13646,211,13435,1,PT,57,6.550000000000001,33.2
2007,ISERE,Saint-Marcellin,15989,2343,13646,211,13435,1,UMP,4388,6.550000000000001,33.2
2007,ISERE,GRENOBLE-5,16774,2381,14393,131,14262,1,CPNT,47,6.550000000000001,33.2
2007,ISERE,GRENOBLE-5,16774,2381,14393,131,14262,1,DVG,274,6.550000000000001,33.2
2007,ISERE,GRENOBLE-5,16774,2381,14393,131,14262,1,FN,840,6.550000000000001,33.2
2007,ISERE,GRENOBLE-5,16774,2381,14393,131,14262,1,LCR,558,6.550000000000001,33.2
2007,ISERE,GRENOBLE-5,16774,2381,14393,131,14262,1,LO,126,6.550000000000001,33.2
2007,ISERE,GRENOBLE-5,16774,2381,14393,131,14262,1,LV,306,6.550000000000001,33.2
2007,ISERE,GRENOBLE-5,16774,2381,14393,131,14262,1,MODEM,2888,6.550000000000001,33.2
2007,ISERE,GRENOBLE-5,16774,2381,14393,131,14262,1,MPF,168,6.550000000000001,33.2
2007,ISERE,GRENOBLE-5,16774,2381,14393,131,14262,1,PCF,262,6.550000000000001,33.2
2007,ISERE,GRENOBLE-5,16774,2381,14393,131,14262,1,PS,5129,6.550000000000001,33.2
2007,ISERE,GRENOBLE-5,16774,2381,14393,131,14262,1,PT,37,6.550000000000001,33.2
2007,ISERE,GRENOBLE-5,16774,2381,14393,131,14262,1,UMP,3627,6.550000000000001,33.2
2007,ISERE,BOURGOIN-JALLIEU-NORD,16890,2413,14477,198,14279,1,CPNT,118,6.550000000000001,33.2
2007,ISERE,BOURGOIN-JALLIEU-NORD,16890,2413,14477,198,14279,1,DVG,213,6.550000000000001,33.2
2007,ISERE,BOURGOIN-JALLIEU-NORD,16890,2413,14477,198,14279,1,FN,1817,6.550000000000001,33.2
2007,ISERE,BOURGOIN-JALLIEU-NORD,16890,2413,14477,198,14279,1,LCR,511,6.550000000000001,33.2
2007,ISERE,BOURGOIN-JALLIEU-NORD,16890,2413,14477,198,14279,1,LO,149,6.550000000000001,33.2
2007,ISERE,BOURGOIN-JALLIEU-NORD,16890,2413,14477,198,14279,1,LV,238,6.550000000000001,33.2
2007,ISERE,BOURGOIN-JALLIEU-NORD,16890,2413,14477,198,14279,1,MODEM,2704,6.550000000000001,33.2
2007,ISERE,BOURGOIN-JALLIEU-NORD,16890,2413,14477,198,14279,1,MPF,323,6.550000000000001,33.2
2007,ISERE,BOURGOIN-JALLIEU-NORD,16890,2413,14477,198,14279,1,PCF,234,6.550000000000001,33.2
2007,ISERE,BOURGOIN-JALLIEU-NORD,16890,2413,14477,198,14279,1,PS,3318,6.550000000000001,33.2
2007,ISERE,BOURGOIN-JALLIEU-NORD,16890,2413,14477,198,14279,1,PT,41,6.550000000000001,33.2
2007,ISERE,BOURGOIN-JALLIEU-NORD,16890,2413,14477,198,14279,1,UMP,4613,6.550000000000001,33.2
2007,ISERE,GRENOBLE-1,17428,2632,14796,133,14663,1,CPNT,29,6.550000000000001,33.2
2007,ISERE,GRENOBLE-1,17428,2632,14796,133,14663,1,DVG,273,6.550000000000001,33.2
2007,ISERE,GRENOBLE-1,17428,2632,14796,133,14663,1,FN,849,6.550000000000001,33.2
2007,ISERE,GRENOBLE-1,17428,2632,14796,133,14663,1,LCR,510,6.550000000000001,33.2
2007,ISERE,GRENOBLE-1,17428,2632,14796,133,14663,1,LO,121,6.550000000000001,33.2
2007,ISERE,GRENOBLE-1,17428,2632,14796,133,14663,1,LV,339,6.550000000000001,33.2
2007,ISERE,GRENOBLE-1,17428,2632,14796,133,14663,1,MODEM,2965,6.550000000000001,33.2
2007,ISERE,GRENOBLE-1,17428,2632,14796,133,14663,1,MPF,186,6.550000000000001,33.2
2007,ISERE,GRENOBLE-1,17428,2632,14796,133,14663,1,PCF,259,6.550000000000001,33.2
2007,ISERE,GRENOBLE-1,17428,2632,14796,133,14663,1,PS,5320,6.550000000000001,33.2
2007,ISERE,GRENOBLE-1,17428,2632,14796,133,14663,1,PT,50,6.550000000000001,33.2
2007,ISERE,GRENOBLE-1,17428,2632,14796,133,14663,1,UMP,3762,6.550000000000001,33.2
2007,ISERE,FONTAINE-SASSENAGE,17782,2553,15229,191,15038,1,CPNT,72,6.550000000000001,33.2
2007,ISERE,FONTAINE-SASSENAGE,17782,2553,15229,191,15038,1,DVG,198,6.550000000000001,33.2
2007,ISERE,FONTAINE-SASSENAGE,17782,2553,15229,191,15038,1,FN,1414,6.550000000000001,33.2
2007,ISERE,FONTAINE-SASSENAGE,17782,2553,15229,191,15038,1,LCR,647,6.550000000000001,33.2
2007,ISERE,FONTAINE-SASSENAGE,17782,2553,15229,191,15038,1,LO,173,6.550000000000001,33.2
2007,ISERE,FONTAINE-SASSENAGE,17782,2553,15229,191,15038,1,LV,226,6.550000000000001,33.2
2007,ISERE,FONTAINE-SASSENAGE,17782,2553,15229,191,15038,1,MODEM,2834,6.550000000000001,33.2
2007,ISERE,FONTAINE-SASSENAGE,17782,2553,15229,191,15038,1,MPF,238,6.550000000000001,33.2
2007,ISERE,FONTAINE-SASSENAGE,17782,2553,15229,191,15038,1,PCF,473,6.550000000000001,33.2
2007,ISERE,FONTAINE-SASSENAGE,17782,2553,15229,191,15038,1,PS,4516,6.550000000000001,33.2
2007,ISERE,FONTAINE-SASSENAGE,17782,2553,15229,191,15038,1,PT,47,6.550000000000001,33.2
2007,ISERE,FONTAINE-SASSENAGE,17782,2553,15229,191,15038,1,UMP,4200,6.550000000000001,33.2
2007,ISERE,Le Touvet,18135,1964,16171,178,15993,1,CPNT,130,6.550000000000001,33.2
2007,ISERE,Le Touvet,18135,1964,16171,178,15993,1,DVG,320,6.550000000000001,33.2
2007,ISERE,Le Touvet,18135,1964,16171,178,15993,1,FN,1187,6.550000000000001,33.2
2007,ISERE,Le Touvet,18135,1964,16171,178,15993,1,LCR,571,6.550000000000001,33.2
2007,ISERE,Le Touvet,18135,1964,16171,178,15993,1,LO,157,6.550000000000001,33.2
2007,ISERE,Le Touvet,18135,1964,16171,178,15993,1,LV,395,6.550000000000001,33.2
2007,ISERE,Le Touvet,18135,1964,16171,178,15993,1,MODEM,3358,6.550000000000001,33.2
2007,ISERE,Le Touvet,18135,1964,16171,178,15993,1,MPF,264,6.550000000000001,33.2
2007,ISERE,Le Touvet,18135,1964,16171,178,15993,1,PCF,331,6.550000000000001,33.2
2007,ISERE,Le Touvet,18135,1964,16171,178,15993,1,PS,4623,6.550000000000001,33.2
2007,ISERE,Le Touvet,18135,1964,16171,178,15993,1,PT,42,6.550000000000001,33.2
2007,ISERE,Le Touvet,18135,1964,16171,178,15993,1,UMP,4615,6.550000000000001,33.2
2007,ISERE,Saint-Egrève,18357,2346,16011,184,15827,1,CPNT,97,6.550000000000001,33.2
2007,ISERE,Saint-Egrève,18357,2346,16011,184,15827,1,DVG,223,6.550000000000001,33.2
2007,ISERE,Saint-Egrève,18357,2346,16011,184,15827,1,FN,1083,6.550000000000001,33.2
2007,ISERE,Saint-Egrève,18357,2346,16011,184,15827,1,LCR,581,6.550000000000001,33.2
2007,ISERE,Saint-Egrève,18357,2346,16011,184,15827,1,LO,144,6.550000000000001,33.2
2007,ISERE,Saint-Egrève,18357,2346,16011,184,15827,1,LV,343,6.550000000000001,33.2
2007,ISERE,Saint-Egrève,18357,2346,16011,184,15827,1,MODEM,3383,6.550000000000001,33.2
2007,ISERE,Saint-Egrève,18357,2346,16011,184,15827,1,MPF,290,6.550000000000001,33.2
2007,ISERE,Saint-Egrève,18357,2346,16011,184,15827,1,PCF,301,6.550000000000001,33.2
2007,ISERE,Saint-Egrève,18357,2346,16011,184,15827,1,PS,4927,6.550000000000001,33.2
2007,ISERE,Saint-Egrève,18357,2346,16011,184,15827,1,PT,42,6.550000000000001,33.2
2007,ISERE,Saint-Egrève,18357,2346,16011,184,15827,1,UMP,4413,6.550000000000001,33.2
2007,ISERE,Morestel,18461,2795,15666,226,15440,1,CPNT,262,6.550000000000001,33.2
2007,ISERE,Morestel,18461,2795,15666,226,15440,1,DVG,202,6.550000000000001,33.2
2007,ISERE,Morestel,18461,2795,15666,226,15440,1,FN,2503,6.550000000000001,33.2
2007,ISERE,Morestel,18461,2795,15666,226,15440,1,LCR,644,6.550000000000001,33.2
2007,ISERE,Morestel,18461,2795,15666,226,15440,1,LO,247,6.550000000000001,33.2
2007,ISERE,Morestel,18461,2795,15666,226,15440,1,LV,245,6.550000000000001,33.2
2007,ISERE,Morestel,18461,2795,15666,226,15440,1,MODEM,2688,6.550000000000001,33.2
2007,ISERE,Morestel,18461,2795,15666,226,15440,1,MPF,408,6.550000000000001,33.2
2007,ISERE,Morestel,18461,2795,15666,226,15440,1,PCF,270,6.550000000000001,33.2
2007,ISERE,Morestel,18461,2795,15666,226,15440,1,PS,3051,6.550000000000001,33.2
2007,ISERE,Morestel,18461,2795,15666,226,15440,1,PT,78,6.550000000000001,33.2
2007,ISERE,Morestel,18461,2795,15666,226,15440,1,UMP,4842,6.550000000000001,33.2
2007,ISERE,L'Isle-d'Abeau,19170,3258,15912,218,15694,1,CPNT,73,6.550000000000001,33.2
2007,ISERE,L'Isle-d'Abeau,19170,3258,15912,218,15694,1,DVG,242,6.550000000000001,33.2
2007,ISERE,L'Isle-d'Abeau,19170,3258,15912,218,15694,1,FN,1687,6.550000000000001,33.2
2007,ISERE,L'Isle-d'Abeau,19170,3258,15912,218,15694,1,LCR,773,6.550000000000001,33.2
2007,ISERE,L'Isle-d'Abeau,19170,3258,15912,218,15694,1,LO,257,6.550000000000001,33.2
2007,ISERE,L'Isle-d'Abeau,19170,3258,15912,218,15694,1,LV,279,6.550000000000001,33.2
2007,ISERE,L'Isle-d'Abeau,19170,3258,15912,218,15694,1,MODEM,3059,6.550000000000001,33.2
2007,ISERE,L'Isle-d'Abeau,19170,3258,15912,218,15694,1,MPF,296,6.550000000000001,33.2
2007,ISERE,L'Isle-d'Abeau,19170,3258,15912,218,15694,1,PCF,246,6.550000000000001,33.2
2007,ISERE,L'Isle-d'Abeau,19170,3258,15912,218,15694,1,PS,4732,6.550000000000001,33.2
2007,ISERE,L'Isle-d'Abeau,19170,3258,15912,218,15694,1,PT,45,6.550000000000001,33.2
2007,ISERE,L'Isle-d'Abeau,19170,3258,15912,218,15694,1,UMP,4005,6.550000000000001,33.2
2007,ISERE,LA-TOUR-DU-PIN,19301,2618,16683,271,16412,1,CPNT,175,6.550000000000001,33.2
2007,ISERE,LA-TOUR-DU-PIN,19301,2618,16683,271,16412,1,DVG,224,6.550000000000001,33.2
2007,ISERE,LA-TOUR-DU-PIN,19301,2618,16683,271,16412,1,FN,2351,6.550000000000001,33.2
2007,ISERE,LA-TOUR-DU-PIN,19301,2618,16683,271,16412,1,LCR,640,6.550000000000001,33.2
2007,ISERE,LA-TOUR-DU-PIN,19301,2618,16683,271,16412,1,LO,248,6.550000000000001,33.2
2007,ISERE,LA-TOUR-DU-PIN,19301,2618,16683,271,16412,1,LV,296,6.550000000000001,33.2
2007,ISERE,LA-TOUR-DU-PIN,19301,2618,16683,271,16412,1,MODEM,3028,6.550000000000001,33.2
2007,ISERE,LA-TOUR-DU-PIN,19301,2618,16683,271,16412,1,MPF,437,6.550000000000001,33.2
2007,ISERE,LA-TOUR-DU-PIN,19301,2618,16683,271,16412,1,PCF,227,6.550000000000001,33.2
2007,ISERE,LA-TOUR-DU-PIN,19301,2618,16683,271,16412,1,PS,3512,6.550000000000001,33.2
2007,ISERE,LA-TOUR-DU-PIN,19301,2618,16683,271,16412,1,PT,83,6.550000000000001,33.2
2007,ISERE,LA-TOUR-DU-PIN,19301,2618,16683,271,16412,1,UMP,5191,6.550000000000001,33.2
2007,ISERE,FONTAINE-SEYSSINET,19342,2441,16901,214,16687,1,CPNT,82,6.550000000000001,33.2
2007,ISERE,FONTAINE-SEYSSINET,19342,2441,16901,214,16687,1,DVG,214,6.550000000000001,33.2
2007,ISERE,FONTAINE-SEYSSINET,19342,2441,16901,214,16687,1,FN,1251,6.550000000000001,33.2
2007,ISERE,FONTAINE-SEYSSINET,19342,2441,16901,214,16687,1,LCR,640,6.550000000000001,33.2
2007,ISERE,FONTAINE-SEYSSINET,19342,2441,16901,214,16687,1,LO,189,6.550000000000001,33.2
2007,ISERE,FONTAINE-SEYSSINET,19342,2441,16901,214,16687,1,LV,322,6.550000000000001,33.2
2007,ISERE,FONTAINE-SEYSSINET,19342,2441,16901,214,16687,1,MODEM,3286,6.550000000000001,33.2
2007,ISERE,FONTAINE-SEYSSINET,19342,2441,16901,214,16687,1,MPF,238,6.550000000000001,33.2
2007,ISERE,FONTAINE-SEYSSINET,19342,2441,16901,214,16687,1,PCF,337,6.550000000000001,33.2
2007,ISERE,FONTAINE-SEYSSINET,19342,2441,16901,214,16687,1,PS,5377,6.550000000000001,33.2
2007,ISERE,FONTAINE-SEYSSINET,19342,2441,16901,214,16687,1,PT,50,6.550000000000001,33.2
2007,ISERE,FONTAINE-SEYSSINET,19342,2441,16901,214,16687,1,UMP,4701,6.550000000000001,33.2
2007,ISERE,DOMENE,19864,2457,17407,217,17190,1,CPNT,125,6.550000000000001,33.2
2007,ISERE,DOMENE,19864,2457,17407,217,17190,1,DVG,257,6.550000000000001,33.2
2007,ISERE,DOMENE,19864,2457,17407,217,17190,1,FN,1397,6.550000000000001,33.2
2007,ISERE,DOMENE,19864,2457,17407,217,17190,1,LCR,703,6.550000000000001,33.2
2007,ISERE,DOMENE,19864,2457,17407,217,17190,1,LO,199,6.550000000000001,33.2
2007,ISERE,DOMENE,19864,2457,17407,217,17190,1,LV,399,6.550000000000001,33.2
2007,ISERE,DOMENE,19864,2457,17407,217,17190,1,MODEM,3434,6.550000000000001,33.2
2007,ISERE,DOMENE,19864,2457,17407,217,17190,1,MPF,225,6.550000000000001,33.2
2007,ISERE,DOMENE,19864,2457,17407,217,17190,1,PCF,442,6.550000000000001,33.2
2007,ISERE,DOMENE,19864,2457,17407,217,17190,1,PS,4980,6.550000000000001,33.2
2007,ISERE,DOMENE,19864,2457,17407,217,17190,1,PT,55,6.550000000000001,33.2
2007,ISERE,DOMENE,19864,2457,17407,217,17190,1,UMP,4974,6.550000000000001,33.2
2007,ISERE,Meylan,20917,2335,18582,201,18381,1,CPNT,58,6.550000000000001,33.2
2007,ISERE,Meylan,20917,2335,18582,201,18381,1,DVG,233,6.550000000000001,33.2
2007,ISERE,Meylan,20917,2335,18582,201,18381,1,FN,704,6.550000000000001,33.2
2007,ISERE,Meylan,20917,2335,18582,201,18381,1,LCR,364,6.550000000000001,33.2
2007,ISERE,Meylan,20917,2335,18582,201,18381,1,LO,75,6.550000000000001,33.2
2007,ISERE,Meylan,20917,2335,18582,201,18381,1,LV,387,6.550000000000001,33.2
2007,ISERE,Meylan,20917,2335,18582,201,18381,1,MODEM,4363,6.550000000000001,33.2
2007,ISERE,Meylan,20917,2335,18582,201,18381,1,MPF,264,6.550000000000001,33.2
2007,ISERE,Meylan,20917,2335,18582,201,18381,1,PCF,193,6.550000000000001,33.2
2007,ISERE,Meylan,20917,2335,18582,201,18381,1,PS,4901,6.550000000000001,33.2
2007,ISERE,Meylan,20917,2335,18582,201,18381,1,PT,18,6.550000000000001,33.2
2007,ISERE,Meylan,20917,2335,18582,201,18381,1,UMP,6821,6.550000000000001,33.2
2007,ISERE,Crémieu,21018,2718,18300,252,18048,1,CPNT,191,6.550000000000001,33.2
2007,ISERE,Crémieu,21018,2718,18300,252,18048,1,DVG,239,6.550000000000001,33.2
2007,ISERE,Crémieu,21018,2718,18300,252,18048,1,FN,2556,6.550000000000001,33.2
2007,ISERE,Crémieu,21018,2718,18300,252,18048,1,LCR,671,6.550000000000001,33.2
2007,ISERE,Crémieu,21018,2718,18300,252,18048,1,LO,229,6.550000000000001,33.2
2007,ISERE,Crémieu,21018,2718,18300,252,18048,1,LV,316,6.550000000000001,33.2
2007,ISERE,Crémieu,21018,2718,18300,252,18048,1,MODEM,3244,6.550000000000001,33.2
2007,ISERE,Crémieu,21018,2718,18300,252,18048,1,MPF,467,6.550000000000001,33.2
2007,ISERE,Crémieu,21018,2718,18300,252,18048,1,PCF,227,6.550000000000001,33.2
2007,ISERE,Crémieu,21018,2718,18300,252,18048,1,PS,3513,6.550000000000001,33.2
2007,ISERE,Crémieu,21018,2718,18300,252,18048,1,PT,53,6.550000000000001,33.2
2007,ISERE,Crémieu,21018,2718,18300,252,18048,1,UMP,6342,6.550000000000001,33.2
2007,ISERE,Rives,21550,2845,18705,245,18460,1,CPNT,161,6.550000000000001,33.2
2007,ISERE,Rives,21550,2845,18705,245,18460,1,DVG,280,6.550000000000001,33.2
2007,ISERE,Rives,21550,2845,18705,245,18460,1,FN,1739,6.550000000000001,33.2
2007,ISERE,Rives,21550,2845,18705,245,18460,1,LCR,789,6.550000000000001,33.2
2007,ISERE,Rives,21550,2845,18705,245,18460,1,LO,230,6.550000000000001,33.2
2007,ISERE,Rives,21550,2845,18705,245,18460,1,LV,332,6.550000000000001,33.2
2007,ISERE,Rives,21550,2845,18705,245,18460,1,MODEM,3682,6.550000000000001,33.2
2007,ISERE,Rives,21550,2845,18705,245,18460,1,MPF,349,6.550000000000001,33.2
2007,ISERE,Rives,21550,2845,18705,245,18460,1,PCF,339,6.550000000000001,33.2
2007,ISERE,Rives,21550,2845,18705,245,18460,1,PS,5099,6.550000000000001,33.2
2007,ISERE,Rives,21550,2845,18705,245,18460,1,PT,60,6.550000000000001,33.2
2007,ISERE,Rives,21550,2845,18705,245,18460,1,UMP,5400,6.550000000000001,33.2
2007,ISERE,Vizille,21696,2778,18918,228,18690,1,CPNT,204,6.550000000000001,33.2
2007,ISERE,Vizille,21696,2778,18918,228,18690,1,DVG,319,6.550000000000001,33.2
2007,ISERE,Vizille,21696,2778,18918,228,18690,1,FN,1903,6.550000000000001,33.2
2007,ISERE,Vizille,21696,2778,18918,228,18690,1,LCR,868,6.550000000000001,33.2
2007,ISERE,Vizille,21696,2778,18918,228,18690,1,LO,268,6.550000000000001,33.2
2007,ISERE,Vizille,21696,2778,18918,228,18690,1,LV,368,6.550000000000001,33.2
2007,ISERE,Vizille,21696,2778,18918,228,18690,1,MODEM,3426,6.550000000000001,33.2
2007,ISERE,Vizille,21696,2778,18918,228,18690,1,MPF,316,6.550000000000001,33.2
2007,ISERE,Vizille,21696,2778,18918,228,18690,1,PCF,493,6.550000000000001,33.2
2007,ISERE,Vizille,21696,2778,18918,228,18690,1,PS,5151,6.550000000000001,33.2
2007,ISERE,Vizille,21696,2778,18918,228,18690,1,PT,69,6.550000000000001,33.2
2007,ISERE,Vizille,21696,2778,18918,228,18690,1,UMP,5305,6.550000000000001,33.2
2007,ISERE,VIENNE-SUD,21877,2905,18972,274,18698,1,CPNT,138,6.550000000000001,33.2
2007,ISERE,VIENNE-SUD,21877,2905,18972,274,18698,1,DVG,261,6.550000000000001,33.2
2007,ISERE,VIENNE-SUD,21877,2905,18972,274,18698,1,FN,2111,6.550000000000001,33.2
2007,ISERE,VIENNE-SUD,21877,2905,18972,274,18698,1,LCR,620,6.550000000000001,33.2
2007,ISERE,VIENNE-SUD,21877,2905,18972,274,18698,1,LO,206,6.550000000000001,33.2
2007,ISERE,VIENNE-SUD,21877,2905,18972,274,18698,1,LV,290,6.550000000000001,33.2
2007,ISERE,VIENNE-SUD,21877,2905,18972,274,18698,1,MODEM,3700,6.550000000000001,33.2
2007,ISERE,VIENNE-SUD,21877,2905,18972,274,18698,1,MPF,423,6.550000000000001,33.2
2007,ISERE,VIENNE-SUD,21877,2905,18972,274,18698,1,PCF,249,6.550000000000001,33.2
2007,ISERE,VIENNE-SUD,21877,2905,18972,274,18698,1,PS,4167,6.550000000000001,33.2
2007,ISERE,VIENNE-SUD,21877,2905,18972,274,18698,1,PT,55,6.550000000000001,33.2
2007,ISERE,VIENNE-SUD,21877,2905,18972,274,18698,1,UMP,6478,6.550000000000001,33.2
2007,ISERE,VIENNE-NORD,23833,3734,20099,295,19804,1,CPNT,127,6.550000000000001,33.2
2007,ISERE,VIENNE-NORD,23833,3734,20099,295,19804,1,DVG,239,6.550000000000001,33.2
2007,ISERE,VIENNE-NORD,23833,3734,20099,295,19804,1,FN,2408,6.550000000000001,33.2
2007,ISERE,VIENNE-NORD,23833,3734,20099,295,19804,1,LCR,738,6.550000000000001,33.2
2007,ISERE,VIENNE-NORD,23833,3734,20099,295,19804,1,LO,256,6.550000000000001,33.2
2007,ISERE,VIENNE-NORD,23833,3734,20099,295,19804,1,LV,289,6.550000000000001,33.2
2007,ISERE,VIENNE-NORD,23833,3734,20099,295,19804,1,MODEM,3692,6.550000000000001,33.2
2007,ISERE,VIENNE-NORD,23833,3734,20099,295,19804,1,MPF,380,6.550000000000001,33.2
2007,ISERE,VIENNE-NORD,23833,3734,20099,295,19804,1,PCF,291,6.550000000000001,33.2
2007,ISERE,VIENNE-NORD,23833,3734,20099,295,19804,1,PS,5261,6.550000000000001,33.2
2007,ISERE,VIENNE-NORD,23833,3734,20099,295,19804,1,PT,50,6.550000000000001,33.2
2007,ISERE,VIENNE-NORD,23833,3734,20099,295,19804,1,UMP,6073,6.550000000000001,33.2
2007,ISERE,Vif,25165,3541,21624,255,21369,1,CPNT,155,6.550000000000001,33.2
2007,ISERE,Vif,25165,3541,21624,255,21369,1,DVG,255,6.550000000000001,33.2
2007,ISERE,Vif,25165,3541,21624,255,21369,1,FN,2025,6.550000000000001,33.2
2007,ISERE,Vif,25165,3541,21624,255,21369,1,LCR,907,6.550000000000001,33.2
2007,ISERE,Vif,25165,3541,21624,255,21369,1,LO,213,6.550000000000001,33.2
2007,ISERE,Vif,25165,3541,21624,255,21369,1,LV,381,6.550000000000001,33.2
2007,ISERE,Vif,25165,3541,21624,255,21369,1,MODEM,4010,6.550000000000001,33.2
2007,ISERE,Vif,25165,3541,21624,255,21369,1,MPF,330,6.550000000000001,33.2
2007,ISERE,Vif,25165,3541,21624,255,21369,1,PCF,522,6.550000000000001,33.2
2007,ISERE,Vif,25165,3541,21624,255,21369,1,PS,5865,6.550000000000001,33.2
2007,ISERE,Vif,25165,3541,21624,255,21369,1,PT,59,6.550000000000001,33.2
2007,ISERE,Vif,25165,3541,21624,255,21369,1,UMP,6647,6.550000000000001,33.2
2007,ISERE,Voiron,31233,4111,27122,396,26726,1,CPNT,174,6.550000000000001,33.2
2007,ISERE,Voiron,31233,4111,27122,396,26726,1,DVG,410,6.550000000000001,33.2
2007,ISERE,Voiron,31233,4111,27122,396,26726,1,FN,2068,6.550000000000001,33.2
2007,ISERE,Voiron,31233,4111,27122,396,26726,1,LCR,971,6.550000000000001,33.2
2007,ISERE,Voiron,31233,4111,27122,396,26726,1,LO,232,6.550000000000001,33.2
2007,ISERE,Voiron,31233,4111,27122,396,26726,1,LV,561,6.550000000000001,33.2
2007,ISERE,Voiron,31233,4111,27122,396,26726,1,MODEM,5946,6.550000000000001,33.2
2007,ISERE,Voiron,31233,4111,27122,396,26726,1,MPF,470,6.550000000000001,33.2
2007,ISERE,Voiron,31233,4111,27122,396,26726,1,PCF,363,6.550000000000001,33.2
2007,ISERE,Voiron,31233,4111,27122,396,26726,1,PS,7241,6.550000000000001,33.2
2007,ISERE,Voiron,31233,4111,27122,396,26726,1,PT,73,6.550000000000001,33.2
2007,ISERE,Voiron,31233,4111,27122,396,26726,1,UMP,8217,6.550000000000001,33.2
2007,ISERE,Roussillon,31947,4928,27019,479,26540,1,CPNT,359,6.550000000000001,33.2
2007,ISERE,Roussillon,31947,4928,27019,479,26540,1,DVG,333,6.550000000000001,33.2
2007,ISERE,Roussillon,31947,4928,27019,479,26540,1,FN,3562,6.550000000000001,33.2
2007,ISERE,Roussillon,31947,4928,27019,479,26540,1,LCR,1274,6.550000000000001,33.2
2007,ISERE,Roussillon,31947,4928,27019,479,26540,1,LO,384,6.550000000000001,33.2
2007,ISERE,Roussillon,31947,4928,27019,479,26540,1,LV,390,6.550000000000001,33.2
2007,ISERE,Roussillon,31947,4928,27019,479,26540,1,MODEM,4485,6.550000000000001,33.2
2007,ISERE,Roussillon,31947,4928,27019,479,26540,1,MPF,614,6.550000000000001,33.2
2007,ISERE,Roussillon,31947,4928,27019,479,26540,1,PCF,1093,6.550000000000001,33.2
2007,ISERE,Roussillon,31947,4928,27019,479,26540,1,PS,6561,6.550000000000001,33.2
2007,ISERE,Roussillon,31947,4928,27019,479,26540,1,PT,101,6.550000000000001,33.2
2007,ISERE,Roussillon,31947,4928,27019,479,26540,1,UMP,7384,6.550000000000001,33.2
2007,ISERE,Clelles,1699,143,1556,55,1501,2,PS,674,6.550000000000001,33.2
2007,ISERE,Clelles,1699,143,1556,55,1501,2,UMP,827,6.550000000000001,33.2
2007,ISERE,Valbonnais,1873,268,1605,70,1535,2,PS,809,6.550000000000001,33.2
2007,ISERE,Valbonnais,1873,268,1605,70,1535,2,UMP,726,6.550000000000001,33.2
2007,ISERE,Corps,1938,233,1705,66,1639,2,PS,727,6.550000000000001,33.2
2007,ISERE,Corps,1938,233,1705,66,1639,2,UMP,912,6.550000000000001,33.2
2007,ISERE,Mens,2699,305,2394,97,2297,2,PS,1178,6.550000000000001,33.2
2007,ISERE,Mens,2699,305,2394,97,2297,2,UMP,1119,6.550000000000001,33.2
2007,ISERE,Monestier-de-Clermont,3573,364,3209,100,3109,2,PS,1496,6.550000000000001,33.2
2007,ISERE,Monestier-de-Clermont,3573,364,3209,100,3109,2,UMP,1613,6.550000000000001,33.2
2007,ISERE,Pont-en-Royans,4814,676,4138,189,3949,2,PS,1858,6.550000000000001,33.2
2007,ISERE,Pont-en-Royans,4814,676,4138,189,3949,2,UMP,2091,6.550000000000001,33.2
2007,ISERE,Roybon,4834,697,4137,216,3921,2,PS,1750,6.550000000000001,33.2
2007,ISERE,Roybon,4834,697,4137,216,3921,2,UMP,2171,6.550000000000001,33.2
2007,ISERE,Allevard,5564,804,4760,206,4554,2,PS,2348,6.550000000000001,33.2
2007,ISERE,Allevard,5564,804,4760,206,4554,2,UMP,2206,6.550000000000001,33.2
2007,ISERE,Vinay,6321,917,5404,260,5144,2,PS,2181,6.550000000000001,33.2
2007,ISERE,Vinay,6321,917,5404,260,5144,2,UMP,2963,6.550000000000001,33.2
2007,ISERE,SAINT-MARTIN-D'HERES-SUD,6744,1050,5694,200,5494,2,PS,3332,6.550000000000001,33.2
2007,ISERE,SAINT-MARTIN-D'HERES-SUD,6744,1050,5694,200,5494,2,UMP,2162,6.550000000000001,33.2
2007,ISERE,Saint-Geoire-en-Valdaine,6907,930,5977,292,5685,2,PS,2308,6.550000000000001,33.2
2007,ISERE,Saint-Geoire-en-Valdaine,6907,930,5977,292,5685,2,UMP,3377,6.550000000000001,33.2
2007,ISERE,VIRIEU,7721,1012,6709,340,6369,2,PS,2715,6.550000000000001,33.2
2007,ISERE,VIRIEU,7721,1012,6709,340,6369,2,UMP,3654,6.550000000000001,33.2
2007,ISERE,ECHIROLLES-EST,8315,1152,7163,246,6917,2,PS,4239,6.550000000000001,33.2
2007,ISERE,ECHIROLLES-EST,8315,1152,7163,246,6917,2,UMP,2678,6.550000000000001,33.2
2007,ISERE,Saint-Laurent-du-Pont,8377,1241,7136,335,6801,2,PS,3038,6.550000000000001,33.2
2007,ISERE,Saint-Laurent-du-Pont,8377,1241,7136,335,6801,2,UMP,3763,6.550000000000001,33.2
2007,ISERE,Saint-Etienne-de-Saint-Geoirs,8504,1221,7283,314,6969,2,PS,3083,6.550000000000001,33.2
2007,ISERE,Saint-Etienne-de-Saint-Geoirs,8504,1221,7283,314,6969,2,UMP,3886,6.550000000000001,33.2
2007,ISERE,Tullins,8632,1245,7387,336,7051,2,PS,3434,6.550000000000001,33.2
2007,ISERE,Tullins,8632,1245,7387,336,7051,2,UMP,3617,6.550000000000001,33.2
2007,ISERE,LE-BOURG-D'OISANS,9050,1543,7507,238,7269,2,PS,3081,6.550000000000001,33.2
2007,ISERE,LE-BOURG-D'OISANS,9050,1543,7507,238,7269,2,UMP,4188,6.550000000000001,33.2
2007,ISERE,Villard-de-Lans,9150,1059,8091,286,7805,2,PS,3727,6.550000000000001,33.2
2007,ISERE,Villard-de-Lans,9150,1059,8091,286,7805,2,UMP,4078,6.550000000000001,33.2
2007,ISERE,LA-COTE-SAINT-ANDRE,9949,1287,8662,364,8298,2,PS,3485,6.550000000000001,33.2
2007,ISERE,LA-COTE-SAINT-ANDRE,9949,1287,8662,364,8298,2,UMP,4813,6.550000000000001,33.2
2007,ISERE,SAINT-MARTIN-D'HÈRES-NORD,10206,1540,8666,355,8311,2,PS,5134,6.550000000000001,33.2
2007,ISERE,SAINT-MARTIN-D'HÈRES-NORD,10206,1540,8666,355,8311,2,UMP,3177,6.550000000000001,33.2
2007,ISERE,Beaurepaire,10276,1498,8778,439,8339,2,PS,3716,6.550000000000001,33.2
2007,ISERE,Beaurepaire,10276,1498,8778,439,8339,2,UMP,4623,6.550000000000001,33.2
2007,ISERE,LE-GRAND-LEMPS,10512,1387,9125,446,8679,2,PS,3862,6.550000000000001,33.2
2007,ISERE,LE-GRAND-LEMPS,10512,1387,9125,446,8679,2,UMP,4817,6.550000000000001,33.2
2007,ISERE,La Mure,10552,1654,8898,423,8475,2,PS,4579,6.550000000000001,33.2
2007,ISERE,La Mure,10552,1654,8898,423,8475,2,UMP,3896,6.550000000000001,33.2
2007,ISERE,GRENOBLE-4,11063,1770,9293,349,8944,2,PS,4781,6.550000000000001,33.2
2007,ISERE,GRENOBLE-4,11063,1770,9293,349,8944,2,UMP,4163,6.550000000000001,33.2
2007,ISERE,Saint-Jean-de-Bournay,11518,1665,9853,488,9365,2,PS,3366,6.550000000000001,33.2
2007,ISERE,Saint-Jean-de-Bournay,11518,1665,9853,488,9365,2,UMP,5999,6.550000000000001,33.2
2007,ISERE,GRENOBLE-6,11614,1875,9739,269,9470,2,PS,5910,6.550000000000001,33.2
2007,ISERE,GRENOBLE-6,11614,1875,9739,269,9470,2,UMP,3560,6.550000000000001,33.2
2007,ISERE,La Verpillière,11725,1640,10085,457,9628,2,PS,4087,6.550000000000001,33.2
2007,ISERE,La Verpillière,11725,1640,10085,457,9628,2,UMP,5541,6.550000000000001,33.2
2007,ISERE,ECHIROLLES-OUEST,12365,1617,10748,365,10383,2,PS,5677,6.550000000000001,33.2
2007,ISERE,ECHIROLLES-OUEST,12365,1617,10748,365,10383,2,UMP,4706,6.550000000000001,33.2
2007,ISERE,Eybens,13210,1580,11630,438,11192,2,PS,5922,6.550000000000001,33.2
2007,ISERE,Eybens,13210,1580,11630,438,11192,2,UMP,5270,6.550000000000001,33.2
2007,ISERE,GRENOBLE-3,13491,2055,11436,353,11083,2,PS,6910,6.550000000000001,33.2
2007,ISERE,GRENOBLE-3,13491,2055,11436,353,11083,2,UMP,4173,6.550000000000001,33.2
2007,ISERE,Heyrieux,14209,1995,12214,536,11678,2,PS,4321,6.550000000000001,33.2
2007,ISERE,Heyrieux,14209,1995,12214,536,11678,2,UMP,7357,6.550000000000001,33.2
2007,ISERE,GRENOBLE-2,14318,2128,12190,387,11803,2,PS,6122,6.550000000000001,33.2
2007,ISERE,GRENOBLE-2,14318,2128,12190,387,11803,2,UMP,5681,6.550000000000001,33.2
2007,ISERE,Saint-Ismier,14453,1429,13024,492,12532,2,PS,4973,6.550000000000001,33.2
2007,ISERE,Saint-Ismier,14453,1429,13024,492,12532,2,UMP,7559,6.550000000000001,33.2
2007,ISERE,LE-PONT-DE-BEAUVOISIN,14815,2387,12428,577,11851,2,PS,4899,6.550000000000001,33.2
2007,ISERE,LE-PONT-DE-BEAUVOISIN,14815,2387,12428,577,11851,2,UMP,6952,6.550000000000001,33.2
2007,ISERE,PONT-DE-CHERUY,15203,2965,12238,423,11815,2,PS,4714,6.550000000000001,33.2
2007,ISERE,PONT-DE-CHERUY,15203,2965,12238,423,11815,2,UMP,7101,6.550000000000001,33.2
2007,ISERE,Goncelin,15391,2220,13171,561,12610,2,PS,6367,6.550000000000001,33.2
2007,ISERE,Goncelin,15391,2220,13171,561,12610,2,UMP,6243,6.550000000000001,33.2
2007,ISERE,BOURGOIN-JALLIEU-SUD,15823,2314,13509,583,12926,2,PS,5268,6.550000000000001,33.2
2007,ISERE,BOURGOIN-JALLIEU-SUD,15823,2314,13509,583,12926,2,UMP,7658,6.550000000000001,33.2
2007,ISERE,Saint-Marcellin,15993,2345,13648,598,13050,2,PS,5498,6.550000000000001,33.2
2007,ISERE,Saint-Marcellin,15993,2345,13648,598,13050,2,UMP,7552,6.550000000000001,33.2
2007,ISERE,GRENOBLE-5,16775,2696,14079,459,13620,2,PS,8045,6.550000000000001,33.2
2007,ISERE,GRENOBLE-5,16775,2696,14079,459,13620,2,UMP,5575,6.550000000000001,33.2
2007,ISERE,BOURGOIN-JALLIEU-NORD,16895,2551,14344,547,13797,2,PS,5896,6.550000000000001,33.2
2007,ISERE,BOURGOIN-JALLIEU-NORD,16895,2551,14344,547,13797,2,UMP,7901,6.550000000000001,33.2
2007,ISERE,GRENOBLE-1,17426,2774,14652,503,14149,2,PS,8325,6.550000000000001,33.2
2007,ISERE,GRENOBLE-1,17426,2774,14652,503,14149,2,UMP,5824,6.550000000000001,33.2
2007,ISERE,FONTAINE-SASSENAGE,17780,2612,15168,602,14566,2,PS,7575,6.550000000000001,33.2
2007,ISERE,FONTAINE-SASSENAGE,17780,2612,15168,602,14566,2,UMP,6991,6.550000000000001,33.2
2007,ISERE,Le Touvet,18135,2066,16069,581,15488,2,PS,7954,6.550000000000001,33.2
2007,ISERE,Le Touvet,18135,2066,16069,581,15488,2,UMP,7534,6.550000000000001,33.2
2007,ISERE,Saint-Egrève,18364,2594,15770,612,15158,2,PS,8107,6.550000000000001,33.2
2007,ISERE,Saint-Egrève,18364,2594,15770,612,15158,2,UMP,7051,6.550000000000001,33.2
2007,ISERE,Morestel,18462,2947,15515,760,14755,2,PS,5710,6.550000000000001,33.2
2007,ISERE,Morestel,18462,2947,15515,760,14755,2,UMP,9045,6.550000000000001,33.2
2007,ISERE,L'Isle-d'Abeau,19171,3359,15812,638,15174,2,PS,8199,6.550000000000001,33.2
2007,ISERE,L'Isle-d'Abeau,19171,3359,15812,638,15174,2,UMP,6975,6.550000000000001,33.2
2007,ISERE,LA-TOUR-DU-PIN,19301,2761,16540,850,15690,2,PS,6511,6.550000000000001,33.2
2007,ISERE,LA-TOUR-DU-PIN,19301,2761,16540,850,15690,2,UMP,9179,6.550000000000001,33.2
2007,ISERE,FONTAINE-SEYSSINET,19349,2584,16765,659,16106,2,PS,8540,6.550000000000001,33.2
2007,ISERE,FONTAINE-SEYSSINET,19349,2584,16765,659,16106,2,UMP,7566,6.550000000000001,33.2
2007,ISERE,DOMENE,19863,2647,17216,680,16536,2,PS,8458,6.550000000000001,33.2
2007,ISERE,DOMENE,19863,2647,17216,680,16536,2,UMP,8078,6.550000000000001,33.2
2007,ISERE,Meylan,20914,2468,18446,778,17668,2,PS,7902,6.550000000000001,33.2
2007,ISERE,Meylan,20914,2468,18446,778,17668,2,UMP,9766,6.550000000000001,33.2
2007,ISERE,Crémieu,21022,2934,18088,837,17251,2,PS,6541,6.550000000000001,33.2
2007,ISERE,Crémieu,21022,2934,18088,837,17251,2,UMP,10710,6.550000000000001,33.2
2007,ISERE,Rives,21550,2960,18590,744,17846,2,PS,8870,6.550000000000001,33.2
2007,ISERE,Rives,21550,2960,18590,744,17846,2,UMP,8976,6.550000000000001,33.2
2007,ISERE,Vizille,21694,2914,18780,754,18026,2,PS,9082,6.550000000000001,33.2
2007,ISERE,Vizille,21694,2914,18780,754,18026,2,UMP,8944,6.550000000000001,33.2
2007,ISERE,VIENNE-SUD,21881,3014,18867,871,17996,2,PS,7268,6.550000000000001,33.2
2007,ISERE,VIENNE-SUD,21881,3014,18867,871,17996,2,UMP,10728,6.550000000000001,33.2
2007,ISERE,VIENNE-NORD,23829,3865,19964,828,19136,2,PS,8810,6.550000000000001,33.2
2007,ISERE,VIENNE-NORD,23829,3865,19964,828,19136,2,UMP,10326,6.550000000000001,33.2
2007,ISERE,Vif,25152,3595,21557,754,20803,2,PS,9965,6.550000000000001,33.2
2007,ISERE,Vif,25152,3595,21557,754,20803,2,UMP,10838,6.550000000000001,33.2
2007,ISERE,Voiron,31232,4288,26944,1237,25707,2,PS,12472,6.550000000000001,33.2
2007,ISERE,Voiron,31232,4288,26944,1237,25707,2,UMP,13235,6.550000000000001,33.2
2007,ISERE,Roussillon,31967,5230,26737,1264,25473,2,PS,12273,6.550000000000001,33.2
2007,ISERE,Roussillon,31967,5230,26737,1264,25473,2,UMP,13200,6.550000000000001,33.2
2002,ISERE,Clelles,1559,321,1238,37,1201,1,CAP 21,33,6.475,33.9
2002,ISERE,Clelles,1559,321,1238,37,1201,1,CPNT,103,6.475,33.9
2002,ISERE,Clelles,1559,321,1238,37,1201,1,DL,48,6.475,33.9
2002,ISERE,Clelles,1559,321,1238,37,1201,1,FN,175,6.475,33.9
2002,ISERE,Clelles,1559,321,1238,37,1201,1,FRS,19,6.475,33.9
2002,ISERE,Clelles,1559,321,1238,37,1201,1,LCR,71,6.475,33.9
2002,ISERE,Clelles,1559,321,1238,37,1201,1,LO,53,6.475,33.9
2002,ISERE,Clelles,1559,321,1238,37,1201,1,LV,91,6.475,33.9
2002,ISERE,Clelles,1559,321,1238,37,1201,1,MDC,55,6.475,33.9
2002,ISERE,Clelles,1559,321,1238,37,1201,1,MNR,24,6.475,33.9
2002,ISERE,Clelles,1559,321,1238,37,1201,1,MODEM,72,6.475,33.9
2002,ISERE,Clelles,1559,321,1238,37,1201,1,PCF,28,6.475,33.9
2002,ISERE,Clelles,1559,321,1238,37,1201,1,PRG,19,6.475,33.9
2002,ISERE,Clelles,1559,321,1238,37,1201,1,PS,159,6.475,33.9
2002,ISERE,Clelles,1559,321,1238,37,1201,1,PT,5,6.475,33.9
2002,ISERE,Clelles,1559,321,1238,37,1201,1,RPR,246,6.475,33.9
2002,ISERE,Valbonnais,1890,486,1404,54,1350,1,CAP 21,18,6.475,33.9
2002,ISERE,Valbonnais,1890,486,1404,54,1350,1,CPNT,90,6.475,33.9
2002,ISERE,Valbonnais,1890,486,1404,54,1350,1,DL,39,6.475,33.9
2002,ISERE,Valbonnais,1890,486,1404,54,1350,1,FN,218,6.475,33.9
2002,ISERE,Valbonnais,1890,486,1404,54,1350,1,FRS,13,6.475,33.9
2002,ISERE,Valbonnais,1890,486,1404,54,1350,1,LCR,63,6.475,33.9
2002,ISERE,Valbonnais,1890,486,1404,54,1350,1,LO,95,6.475,33.9
2002,ISERE,Valbonnais,1890,486,1404,54,1350,1,LV,77,6.475,33.9
2002,ISERE,Valbonnais,1890,486,1404,54,1350,1,MDC,102,6.475,33.9
2002,ISERE,Valbonnais,1890,486,1404,54,1350,1,MNR,30,6.475,33.9
2002,ISERE,Valbonnais,1890,486,1404,54,1350,1,MODEM,72,6.475,33.9
2002,ISERE,Valbonnais,1890,486,1404,54,1350,1,PCF,63,6.475,33.9
2002,ISERE,Valbonnais,1890,486,1404,54,1350,1,PRG,28,6.475,33.9
2002,ISERE,Valbonnais,1890,486,1404,54,1350,1,PS,244,6.475,33.9
2002,ISERE,Valbonnais,1890,486,1404,54,1350,1,PT,7,6.475,33.9
2002,ISERE,Valbonnais,1890,486,1404,54,1350,1,RPR,191,6.475,33.9
2002,ISERE,Corps,1933,473,1460,41,1419,1,CAP 21,30,6.475,33.9
2002,ISERE,Corps,1933,473,1460,41,1419,1,CPNT,85,6.475,33.9
2002,ISERE,Corps,1933,473,1460,41,1419,1,DL,30,6.475,33.9
2002,ISERE,Corps,1933,473,1460,41,1419,1,FN,241,6.475,33.9
2002,ISERE,Corps,1933,473,1460,41,1419,1,FRS,21,6.475,33.9
2002,ISERE,Corps,1933,473,1460,41,1419,1,LCR,61,6.475,33.9
2002,ISERE,Corps,1933,473,1460,41,1419,1,LO,77,6.475,33.9
2002,ISERE,Corps,1933,473,1460,41,1419,1,LV,67,6.475,33.9
2002,ISERE,Corps,1933,473,1460,41,1419,1,MDC,84,6.475,33.9
2002,ISERE,Corps,1933,473,1460,41,1419,1,MNR,57,6.475,33.9
2002,ISERE,Corps,1933,473,1460,41,1419,1,MODEM,86,6.475,33.9
2002,ISERE,Corps,1933,473,1460,41,1419,1,PCF,48,6.475,33.9
2002,ISERE,Corps,1933,473,1460,41,1419,1,PRG,21,6.475,33.9
2002,ISERE,Corps,1933,473,1460,41,1419,1,PS,208,6.475,33.9
2002,ISERE,Corps,1933,473,1460,41,1419,1,PT,3,6.475,33.9
2002,ISERE,Corps,1933,473,1460,41,1419,1,RPR,300,6.475,33.9
2002,ISERE,Mens,2485,577,1908,58,1850,1,CAP 21,37,6.475,33.9
2002,ISERE,Mens,2485,577,1908,58,1850,1,CPNT,110,6.475,33.9
2002,ISERE,Mens,2485,577,1908,58,1850,1,DL,77,6.475,33.9
2002,ISERE,Mens,2485,577,1908,58,1850,1,FN,262,6.475,33.9
2002,ISERE,Mens,2485,577,1908,58,1850,1,FRS,27,6.475,33.9
2002,ISERE,Mens,2485,577,1908,58,1850,1,LCR,78,6.475,33.9
2002,ISERE,Mens,2485,577,1908,58,1850,1,LO,100,6.475,33.9
2002,ISERE,Mens,2485,577,1908,58,1850,1,LV,139,6.475,33.9
2002,ISERE,Mens,2485,577,1908,58,1850,1,MDC,128,6.475,33.9
2002,ISERE,Mens,2485,577,1908,58,1850,1,MNR,45,6.475,33.9
2002,ISERE,Mens,2485,577,1908,58,1850,1,MODEM,119,6.475,33.9
2002,ISERE,Mens,2485,577,1908,58,1850,1,PCF,45,6.475,33.9
2002,ISERE,Mens,2485,577,1908,58,1850,1,PRG,62,6.475,33.9
2002,ISERE,Mens,2485,577,1908,58,1850,1,PS,275,6.475,33.9
2002,ISERE,Mens,2485,577,1908,58,1850,1,PT,11,6.475,33.9
2002,ISERE,Mens,2485,577,1908,58,1850,1,RPR,335,6.475,33.9
2002,ISERE,Monestier-de-Clermont,3114,674,2440,66,2374,1,CAP 21,88,6.475,33.9
2002,ISERE,Monestier-de-Clermont,3114,674,2440,66,2374,1,CPNT,146,6.475,33.9
2002,ISERE,Monestier-de-Clermont,3114,674,2440,66,2374,1,DL,111,6.475,33.9
2002,ISERE,Monestier-de-Clermont,3114,674,2440,66,2374,1,FN,288,6.475,33.9
2002,ISERE,Monestier-de-Clermont,3114,674,2440,66,2374,1,FRS,34,6.475,33.9
2002,ISERE,Monestier-de-Clermont,3114,674,2440,66,2374,1,LCR,145,6.475,33.9
2002,ISERE,Monestier-de-Clermont,3114,674,2440,66,2374,1,LO,128,6.475,33.9
2002,ISERE,Monestier-de-Clermont,3114,674,2440,66,2374,1,LV,204,6.475,33.9
2002,ISERE,Monestier-de-Clermont,3114,674,2440,66,2374,1,MDC,156,6.475,33.9
2002,ISERE,Monestier-de-Clermont,3114,674,2440,66,2374,1,MNR,72,6.475,33.9
2002,ISERE,Monestier-de-Clermont,3114,674,2440,66,2374,1,MODEM,166,6.475,33.9
2002,ISERE,Monestier-de-Clermont,3114,674,2440,66,2374,1,PCF,86,6.475,33.9
2002,ISERE,Monestier-de-Clermont,3114,674,2440,66,2374,1,PRG,40,6.475,33.9
2002,ISERE,Monestier-de-Clermont,3114,674,2440,66,2374,1,PS,331,6.475,33.9
2002,ISERE,Monestier-de-Clermont,3114,674,2440,66,2374,1,PT,8,6.475,33.9
2002,ISERE,Monestier-de-Clermont,3114,674,2440,66,2374,1,RPR,371,6.475,33.9
2002,ISERE,Roybon,4481,1225,3256,132,3124,1,CAP 21,66,6.475,33.9
2002,ISERE,Roybon,4481,1225,3256,132,3124,1,CPNT,186,6.475,33.9
2002,ISERE,Roybon,4481,1225,3256,132,3124,1,DL,128,6.475,33.9
2002,ISERE,Roybon,4481,1225,3256,132,3124,1,FN,611,6.475,33.9
2002,ISERE,Roybon,4481,1225,3256,132,3124,1,FRS,70,6.475,33.9
2002,ISERE,Roybon,4481,1225,3256,132,3124,1,LCR,135,6.475,33.9
2002,ISERE,Roybon,4481,1225,3256,132,3124,1,LO,214,6.475,33.9
2002,ISERE,Roybon,4481,1225,3256,132,3124,1,LV,129,6.475,33.9
2002,ISERE,Roybon,4481,1225,3256,132,3124,1,MDC,165,6.475,33.9
2002,ISERE,Roybon,4481,1225,3256,132,3124,1,MNR,99,6.475,33.9
2002,ISERE,Roybon,4481,1225,3256,132,3124,1,MODEM,205,6.475,33.9
2002,ISERE,Roybon,4481,1225,3256,132,3124,1,PCF,114,6.475,33.9
2002,ISERE,Roybon,4481,1225,3256,132,3124,1,PRG,50,6.475,33.9
2002,ISERE,Roybon,4481,1225,3256,132,3124,1,PS,429,6.475,33.9
2002,ISERE,Roybon,4481,1225,3256,132,3124,1,PT,17,6.475,33.9
2002,ISERE,Roybon,4481,1225,3256,132,3124,1,RPR,506,6.475,33.9
2002,ISERE,Pont-en-Royans,4506,1168,3338,125,3213,1,CAP 21,65,6.475,33.9
2002,ISERE,Pont-en-Royans,4506,1168,3338,125,3213,1,CPNT,205,6.475,33.9
2002,ISERE,Pont-en-Royans,4506,1168,3338,125,3213,1,DL,153,6.475,33.9
2002,ISERE,Pont-en-Royans,4506,1168,3338,125,3213,1,FN,577,6.475,33.9
2002,ISERE,Pont-en-Royans,4506,1168,3338,125,3213,1,FRS,36,6.475,33.9
2002,ISERE,Pont-en-Royans,4506,1168,3338,125,3213,1,LCR,182,6.475,33.9
2002,ISERE,Pont-en-Royans,4506,1168,3338,125,3213,1,LO,233,6.475,33.9
2002,ISERE,Pont-en-Royans,4506,1168,3338,125,3213,1,LV,226,6.475,33.9
2002,ISERE,Pont-en-Royans,4506,1168,3338,125,3213,1,MDC,173,6.475,33.9
2002,ISERE,Pont-en-Royans,4506,1168,3338,125,3213,1,MNR,72,6.475,33.9
2002,ISERE,Pont-en-Royans,4506,1168,3338,125,3213,1,MODEM,173,6.475,33.9
2002,ISERE,Pont-en-Royans,4506,1168,3338,125,3213,1,PCF,75,6.475,33.9
2002,ISERE,Pont-en-Royans,4506,1168,3338,125,3213,1,PRG,72,6.475,33.9
2002,ISERE,Pont-en-Royans,4506,1168,3338,125,3213,1,PS,449,6.475,33.9
2002,ISERE,Pont-en-Royans,4506,1168,3338,125,3213,1,PT,20,6.475,33.9
2002,ISERE,Pont-en-Royans,4506,1168,3338,125,3213,1,RPR,502,6.475,33.9
2002,ISERE,Allevard,4717,1316,3401,117,3284,1,CAP 21,57,6.475,33.9
2002,ISERE,Allevard,4717,1316,3401,117,3284,1,CPNT,124,6.475,33.9
2002,ISERE,Allevard,4717,1316,3401,117,3284,1,DL,144,6.475,33.9
2002,ISERE,Allevard,4717,1316,3401,117,3284,1,FN,612,6.475,33.9
2002,ISERE,Allevard,4717,1316,3401,117,3284,1,FRS,40,6.475,33.9
2002,ISERE,Allevard,4717,1316,3401,117,3284,1,LCR,158,6.475,33.9
2002,ISERE,Allevard,4717,1316,3401,117,3284,1,LO,213,6.475,33.9
2002,ISERE,Allevard,4717,1316,3401,117,3284,1,LV,254,6.475,33.9
2002,ISERE,Allevard,4717,1316,3401,117,3284,1,MDC,217,6.475,33.9
2002,ISERE,Allevard,4717,1316,3401,117,3284,1,MNR,107,6.475,33.9
2002,ISERE,Allevard,4717,1316,3401,117,3284,1,MODEM,164,6.475,33.9
2002,ISERE,Allevard,4717,1316,3401,117,3284,1,PCF,159,6.475,33.9
2002,ISERE,Allevard,4717,1316,3401,117,3284,1,PRG,70,6.475,33.9
2002,ISERE,Allevard,4717,1316,3401,117,3284,1,PS,490,6.475,33.9
2002,ISERE,Allevard,4717,1316,3401,117,3284,1,PT,11,6.475,33.9
2002,ISERE,Allevard,4717,1316,3401,117,3284,1,RPR,464,6.475,33.9
2002,ISERE,Vinay,5741,1523,4218,240,3978,1,CAP 21,65,6.475,33.9
2002,ISERE,Vinay,5741,1523,4218,240,3978,1,CPNT,269,6.475,33.9
2002,ISERE,Vinay,5741,1523,4218,240,3978,1,DL,167,6.475,33.9
2002,ISERE,Vinay,5741,1523,4218,240,3978,1,FN,828,6.475,33.9
2002,ISERE,Vinay,5741,1523,4218,240,3978,1,FRS,49,6.475,33.9
2002,ISERE,Vinay,5741,1523,4218,240,3978,1,LCR,170,6.475,33.9
2002,ISERE,Vinay,5741,1523,4218,240,3978,1,LO,253,6.475,33.9
2002,ISERE,Vinay,5741,1523,4218,240,3978,1,LV,195,6.475,33.9
2002,ISERE,Vinay,5741,1523,4218,240,3978,1,MDC,252,6.475,33.9
2002,ISERE,Vinay,5741,1523,4218,240,3978,1,MNR,134,6.475,33.9
2002,ISERE,Vinay,5741,1523,4218,240,3978,1,MODEM,243,6.475,33.9
2002,ISERE,Vinay,5741,1523,4218,240,3978,1,PCF,95,6.475,33.9
2002,ISERE,Vinay,5741,1523,4218,240,3978,1,PRG,87,6.475,33.9
2002,ISERE,Vinay,5741,1523,4218,240,3978,1,PS,519,6.475,33.9
2002,ISERE,Vinay,5741,1523,4218,240,3978,1,PT,24,6.475,33.9
2002,ISERE,Vinay,5741,1523,4218,240,3978,1,RPR,628,6.475,33.9
2002,ISERE,SAINT-MARTIN-D'HERES-SUD,6220,1793,4427,134,4293,1,CAP 21,84,6.475,33.9
2002,ISERE,SAINT-MARTIN-D'HERES-SUD,6220,1793,4427,134,4293,1,CPNT,38,6.475,33.9
2002,ISERE,SAINT-MARTIN-D'HERES-SUD,6220,1793,4427,134,4293,1,DL,95,6.475,33.9
2002,ISERE,SAINT-MARTIN-D'HERES-SUD,6220,1793,4427,134,4293,1,FN,645,6.475,33.9
2002,ISERE,SAINT-MARTIN-D'HERES-SUD,6220,1793,4427,134,4293,1,FRS,37,6.475,33.9
2002,ISERE,SAINT-MARTIN-D'HERES-SUD,6220,1793,4427,134,4293,1,LCR,264,6.475,33.9
2002,ISERE,SAINT-MARTIN-D'HERES-SUD,6220,1793,4427,134,4293,1,LO,318,6.475,33.9
2002,ISERE,SAINT-MARTIN-D'HERES-SUD,6220,1793,4427,134,4293,1,LV,395,6.475,33.9
2002,ISERE,SAINT-MARTIN-D'HERES-SUD,6220,1793,4427,134,4293,1,MDC,279,6.475,33.9
2002,ISERE,SAINT-MARTIN-D'HERES-SUD,6220,1793,4427,134,4293,1,MNR,91,6.475,33.9
2002,ISERE,SAINT-MARTIN-D'HERES-SUD,6220,1793,4427,134,4293,1,MODEM,226,6.475,33.9
2002,ISERE,SAINT-MARTIN-D'HERES-SUD,6220,1793,4427,134,4293,1,PCF,320,6.475,33.9
2002,ISERE,SAINT-MARTIN-D'HERES-SUD,6220,1793,4427,134,4293,1,PRG,111,6.475,33.9
2002,ISERE,SAINT-MARTIN-D'HERES-SUD,6220,1793,4427,134,4293,1,PS,905,6.475,33.9
2002,ISERE,SAINT-MARTIN-D'HERES-SUD,6220,1793,4427,134,4293,1,PT,16,6.475,33.9
2002,ISERE,SAINT-MARTIN-D'HERES-SUD,6220,1793,4427,134,4293,1,RPR,469,6.475,33.9
2002,ISERE,Saint-Geoire-en-Valdaine,6235,1746,4489,170,4319,1,CAP 21,111,6.475,33.9
2002,ISERE,Saint-Geoire-en-Valdaine,6235,1746,4489,170,4319,1,CPNT,164,6.475,33.9
2002,ISERE,Saint-Geoire-en-Valdaine,6235,1746,4489,170,4319,1,DL,252,6.475,33.9
2002,ISERE,Saint-Geoire-en-Valdaine,6235,1746,4489,170,4319,1,FN,936,6.475,33.9
2002,ISERE,Saint-Geoire-en-Valdaine,6235,1746,4489,170,4319,1,FRS,42,6.475,33.9
2002,ISERE,Saint-Geoire-en-Valdaine,6235,1746,4489,170,4319,1,LCR,157,6.475,33.9
2002,ISERE,Saint-Geoire-en-Valdaine,6235,1746,4489,170,4319,1,LO,294,6.475,33.9
2002,ISERE,Saint-Geoire-en-Valdaine,6235,1746,4489,170,4319,1,LV,241,6.475,33.9
2002,ISERE,Saint-Geoire-en-Valdaine,6235,1746,4489,170,4319,1,MDC,239,6.475,33.9
2002,ISERE,Saint-Geoire-en-Valdaine,6235,1746,4489,170,4319,1,MNR,140,6.475,33.9
2002,ISERE,Saint-Geoire-en-Valdaine,6235,1746,4489,170,4319,1,MODEM,306,6.475,33.9
2002,ISERE,Saint-Geoire-en-Valdaine,6235,1746,4489,170,4319,1,PCF,105,6.475,33.9
2002,ISERE,Saint-Geoire-en-Valdaine,6235,1746,4489,170,4319,1,PRG,94,6.475,33.9
2002,ISERE,Saint-Geoire-en-Valdaine,6235,1746,4489,170,4319,1,PS,506,6.475,33.9
2002,ISERE,Saint-Geoire-en-Valdaine,6235,1746,4489,170,4319,1,PT,25,6.475,33.9
2002,ISERE,Saint-Geoire-en-Valdaine,6235,1746,4489,170,4319,1,RPR,707,6.475,33.9
2002,ISERE,VIRIEU,6824,1694,5130,206,4924,1,CAP 21,113,6.475,33.9
2002,ISERE,VIRIEU,6824,1694,5130,206,4924,1,CPNT,188,6.475,33.9
2002,ISERE,VIRIEU,6824,1694,5130,206,4924,1,DL,245,6.475,33.9
2002,ISERE,VIRIEU,6824,1694,5130,206,4924,1,FN,989,6.475,33.9
2002,ISERE,VIRIEU,6824,1694,5130,206,4924,1,FRS,86,6.475,33.9
2002,ISERE,VIRIEU,6824,1694,5130,206,4924,1,LCR,248,6.475,33.9
2002,ISERE,VIRIEU,6824,1694,5130,206,4924,1,LO,295,6.475,33.9
2002,ISERE,VIRIEU,6824,1694,5130,206,4924,1,LV,335,6.475,33.9
2002,ISERE,VIRIEU,6824,1694,5130,206,4924,1,MDC,293,6.475,33.9
2002,ISERE,VIRIEU,6824,1694,5130,206,4924,1,MNR,112,6.475,33.9
2002,ISERE,VIRIEU,6824,1694,5130,206,4924,1,MODEM,399,6.475,33.9
2002,ISERE,VIRIEU,6824,1694,5130,206,4924,1,PCF,98,6.475,33.9
2002,ISERE,VIRIEU,6824,1694,5130,206,4924,1,PRG,104,6.475,33.9
2002,ISERE,VIRIEU,6824,1694,5130,206,4924,1,PS,606,6.475,33.9
2002,ISERE,VIRIEU,6824,1694,5130,206,4924,1,PT,31,6.475,33.9
2002,ISERE,VIRIEU,6824,1694,5130,206,4924,1,RPR,782,6.475,33.9
2002,ISERE,Saint-Etienne-de-Saint-Geoirs,7610,1952,5658,239,5419,1,CAP 21,120,6.475,33.9
2002,ISERE,Saint-Etienne-de-Saint-Geoirs,7610,1952,5658,239,5419,1,CPNT,268,6.475,33.9
2002,ISERE,Saint-Etienne-de-Saint-Geoirs,7610,1952,5658,239,5419,1,DL,235,6.475,33.9
2002,ISERE,Saint-Etienne-de-Saint-Geoirs,7610,1952,5658,239,5419,1,FN,1043,6.475,33.9
2002,ISERE,Saint-Etienne-de-Saint-Geoirs,7610,1952,5658,239,5419,1,FRS,83,6.475,33.9
2002,ISERE,Saint-Etienne-de-Saint-Geoirs,7610,1952,5658,239,5419,1,LCR,222,6.475,33.9
2002,ISERE,Saint-Etienne-de-Saint-Geoirs,7610,1952,5658,239,5419,1,LO,335,6.475,33.9
2002,ISERE,Saint-Etienne-de-Saint-Geoirs,7610,1952,5658,239,5419,1,LV,288,6.475,33.9
2002,ISERE,Saint-Etienne-de-Saint-Geoirs,7610,1952,5658,239,5419,1,MDC,351,6.475,33.9
2002,ISERE,Saint-Etienne-de-Saint-Geoirs,7610,1952,5658,239,5419,1,MNR,161,6.475,33.9
2002,ISERE,Saint-Etienne-de-Saint-Geoirs,7610,1952,5658,239,5419,1,MODEM,379,6.475,33.9
2002,ISERE,Saint-Etienne-de-Saint-Geoirs,7610,1952,5658,239,5419,1,PCF,197,6.475,33.9
2002,ISERE,Saint-Etienne-de-Saint-Geoirs,7610,1952,5658,239,5419,1,PRG,102,6.475,33.9
2002,ISERE,Saint-Etienne-de-Saint-Geoirs,7610,1952,5658,239,5419,1,PS,761,6.475,33.9
2002,ISERE,Saint-Etienne-de-Saint-Geoirs,7610,1952,5658,239,5419,1,PT,25,6.475,33.9
2002,ISERE,Saint-Etienne-de-Saint-Geoirs,7610,1952,5658,239,5419,1,RPR,849,6.475,33.9
2002,ISERE,Saint-Laurent-du-Pont,7670,1973,5697,206,5491,1,CAP 21,138,6.475,33.9
2002,ISERE,Saint-Laurent-du-Pont,7670,1973,5697,206,5491,1,CPNT,199,6.475,33.9
2002,ISERE,Saint-Laurent-du-Pont,7670,1973,5697,206,5491,1,DL,254,6.475,33.9
2002,ISERE,Saint-Laurent-du-Pont,7670,1973,5697,206,5491,1,FN,1083,6.475,33.9
2002,ISERE,Saint-Laurent-du-Pont,7670,1973,5697,206,5491,1,FRS,157,6.475,33.9
2002,ISERE,Saint-Laurent-du-Pont,7670,1973,5697,206,5491,1,LCR,272,6.475,33.9
2002,ISERE,Saint-Laurent-du-Pont,7670,1973,5697,206,5491,1,LO,334,6.475,33.9
2002,ISERE,Saint-Laurent-du-Pont,7670,1973,5697,206,5491,1,LV,403,6.475,33.9
2002,ISERE,Saint-Laurent-du-Pont,7670,1973,5697,206,5491,1,MDC,334,6.475,33.9
2002,ISERE,Saint-Laurent-du-Pont,7670,1973,5697,206,5491,1,MNR,115,6.475,33.9
2002,ISERE,Saint-Laurent-du-Pont,7670,1973,5697,206,5491,1,MODEM,428,6.475,33.9
2002,ISERE,Saint-Laurent-du-Pont,7670,1973,5697,206,5491,1,PCF,139,6.475,33.9
2002,ISERE,Saint-Laurent-du-Pont,7670,1973,5697,206,5491,1,PRG,98,6.475,33.9
2002,ISERE,Saint-Laurent-du-Pont,7670,1973,5697,206,5491,1,PS,648,6.475,33.9
2002,ISERE,Saint-Laurent-du-Pont,7670,1973,5697,206,5491,1,PT,46,6.475,33.9
2002,ISERE,Saint-Laurent-du-Pont,7670,1973,5697,206,5491,1,RPR,843,6.475,33.9
2002,ISERE,ECHIROLLES-EST,7750,1958,5792,168,5624,1,CAP 21,104,6.475,33.9
2002,ISERE,ECHIROLLES-EST,7750,1958,5792,168,5624,1,CPNT,63,6.475,33.9
2002,ISERE,ECHIROLLES-EST,7750,1958,5792,168,5624,1,DL,134,6.475,33.9
2002,ISERE,ECHIROLLES-EST,7750,1958,5792,168,5624,1,FN,920,6.475,33.9
2002,ISERE,ECHIROLLES-EST,7750,1958,5792,168,5624,1,FRS,54,6.475,33.9
2002,ISERE,ECHIROLLES-EST,7750,1958,5792,168,5624,1,LCR,295,6.475,33.9
2002,ISERE,ECHIROLLES-EST,7750,1958,5792,168,5624,1,LO,424,6.475,33.9
2002,ISERE,ECHIROLLES-EST,7750,1958,5792,168,5624,1,LV,465,6.475,33.9
2002,ISERE,ECHIROLLES-EST,7750,1958,5792,168,5624,1,MDC,409,6.475,33.9
2002,ISERE,ECHIROLLES-EST,7750,1958,5792,168,5624,1,MNR,124,6.475,33.9
2002,ISERE,ECHIROLLES-EST,7750,1958,5792,168,5624,1,MODEM,274,6.475,33.9
2002,ISERE,ECHIROLLES-EST,7750,1958,5792,168,5624,1,PCF,382,6.475,33.9
2002,ISERE,ECHIROLLES-EST,7750,1958,5792,168,5624,1,PRG,165,6.475,33.9
2002,ISERE,ECHIROLLES-EST,7750,1958,5792,168,5624,1,PS,1115,6.475,33.9
2002,ISERE,ECHIROLLES-EST,7750,1958,5792,168,5624,1,PT,33,6.475,33.9
2002,ISERE,ECHIROLLES-EST,7750,1958,5792,168,5624,1,RPR,663,6.475,33.9
2002,ISERE,Tullins,7851,2187,5664,214,5450,1,CAP 21,151,6.475,33.9
2002,ISERE,Tullins,7851,2187,5664,214,5450,1,CPNT,240,6.475,33.9
2002,ISERE,Tullins,7851,2187,5664,214,5450,1,DL,257,6.475,33.9
2002,ISERE,Tullins,7851,2187,5664,214,5450,1,FN,1015,6.475,33.9
2002,ISERE,Tullins,7851,2187,5664,214,5450,1,FRS,42,6.475,33.9
2002,ISERE,Tullins,7851,2187,5664,214,5450,1,LCR,288,6.475,33.9
2002,ISERE,Tullins,7851,2187,5664,214,5450,1,LO,328,6.475,33.9
2002,ISERE,Tullins,7851,2187,5664,214,5450,1,LV,388,6.475,33.9
2002,ISERE,Tullins,7851,2187,5664,214,5450,1,MDC,362,6.475,33.9
2002,ISERE,Tullins,7851,2187,5664,214,5450,1,MNR,142,6.475,33.9
2002,ISERE,Tullins,7851,2187,5664,214,5450,1,MODEM,329,6.475,33.9
2002,ISERE,Tullins,7851,2187,5664,214,5450,1,PCF,156,6.475,33.9
2002,ISERE,Tullins,7851,2187,5664,214,5450,1,PRG,118,6.475,33.9
2002,ISERE,Tullins,7851,2187,5664,214,5450,1,PS,845,6.475,33.9
2002,ISERE,Tullins,7851,2187,5664,214,5450,1,PT,37,6.475,33.9
2002,ISERE,Tullins,7851,2187,5664,214,5450,1,RPR,752,6.475,33.9
2002,ISERE,Villard-de-Lans,8006,1972,6034,181,5853,1,CAP 21,213,6.475,33.9
2002,ISERE,Villard-de-Lans,8006,1972,6034,181,5853,1,CPNT,273,6.475,33.9
2002,ISERE,Villard-de-Lans,8006,1972,6034,181,5853,1,DL,368,6.475,33.9
2002,ISERE,Villard-de-Lans,8006,1972,6034,181,5853,1,FN,696,6.475,33.9
2002,ISERE,Villard-de-Lans,8006,1972,6034,181,5853,1,FRS,85,6.475,33.9
2002,ISERE,Villard-de-Lans,8006,1972,6034,181,5853,1,LCR,306,6.475,33.9
2002,ISERE,Villard-de-Lans,8006,1972,6034,181,5853,1,LO,286,6.475,33.9
2002,ISERE,Villard-de-Lans,8006,1972,6034,181,5853,1,LV,679,6.475,33.9
2002,ISERE,Villard-de-Lans,8006,1972,6034,181,5853,1,MDC,315,6.475,33.9
2002,ISERE,Villard-de-Lans,8006,1972,6034,181,5853,1,MNR,116,6.475,33.9
2002,ISERE,Villard-de-Lans,8006,1972,6034,181,5853,1,MODEM,416,6.475,33.9
2002,ISERE,Villard-de-Lans,8006,1972,6034,181,5853,1,PCF,128,6.475,33.9
2002,ISERE,Villard-de-Lans,8006,1972,6034,181,5853,1,PRG,158,6.475,33.9
2002,ISERE,Villard-de-Lans,8006,1972,6034,181,5853,1,PS,813,6.475,33.9
2002,ISERE,Villard-de-Lans,8006,1972,6034,181,5853,1,PT,20,6.475,33.9
2002,ISERE,Villard-de-Lans,8006,1972,6034,181,5853,1,RPR,981,6.475,33.9
2002,ISERE,LE-BOURG-D'OISANS,8510,2594,5916,216,5700,1,CAP 21,146,6.475,33.9
2002,ISERE,LE-BOURG-D'OISANS,8510,2594,5916,216,5700,1,CPNT,279,6.475,33.9
2002,ISERE,LE-BOURG-D'OISANS,8510,2594,5916,216,5700,1,DL,344,6.475,33.9
2002,ISERE,LE-BOURG-D'OISANS,8510,2594,5916,216,5700,1,FN,1049,6.475,33.9
2002,ISERE,LE-BOURG-D'OISANS,8510,2594,5916,216,5700,1,FRS,37,6.475,33.9
2002,ISERE,LE-BOURG-D'OISANS,8510,2594,5916,216,5700,1,LCR,281,6.475,33.9
2002,ISERE,LE-BOURG-D'OISANS,8510,2594,5916,216,5700,1,LO,325,6.475,33.9
2002,ISERE,LE-BOURG-D'OISANS,8510,2594,5916,216,5700,1,LV,362,6.475,33.9
2002,ISERE,LE-BOURG-D'OISANS,8510,2594,5916,216,5700,1,MDC,335,6.475,33.9
2002,ISERE,LE-BOURG-D'OISANS,8510,2594,5916,216,5700,1,MNR,183,6.475,33.9
2002,ISERE,LE-BOURG-D'OISANS,8510,2594,5916,216,5700,1,MODEM,347,6.475,33.9
2002,ISERE,LE-BOURG-D'OISANS,8510,2594,5916,216,5700,1,PCF,140,6.475,33.9
2002,ISERE,LE-BOURG-D'OISANS,8510,2594,5916,216,5700,1,PRG,111,6.475,33.9
2002,ISERE,LE-BOURG-D'OISANS,8510,2594,5916,216,5700,1,PS,760,6.475,33.9
2002,ISERE,LE-BOURG-D'OISANS,8510,2594,5916,216,5700,1,PT,16,6.475,33.9
2002,ISERE,LE-BOURG-D'OISANS,8510,2594,5916,216,5700,1,RPR,985,6.475,33.9
2002,ISERE,SAINT-MARTIN-D'HERES-NORD,8715,2452,6263,201,6062,1,CAP 21,122,6.475,33.9
2002,ISERE,SAINT-MARTIN-D'HERES-NORD,8715,2452,6263,201,6062,1,CPNT,61,6.475,33.9
2002,ISERE,SAINT-MARTIN-D'HERES-NORD,8715,2452,6263,201,6062,1,DL,157,6.475,33.9
2002,ISERE,SAINT-MARTIN-D'HERES-NORD,8715,2452,6263,201,6062,1,FN,861,6.475,33.9
2002,ISERE,SAINT-MARTIN-D'HERES-NORD,8715,2452,6263,201,6062,1,FRS,53,6.475,33.9
2002,ISERE,SAINT-MARTIN-D'HERES-NORD,8715,2452,6263,201,6062,1,LCR,321,6.475,33.9
2002,ISERE,SAINT-MARTIN-D'HERES-NORD,8715,2452,6263,201,6062,1,LO,411,6.475,33.9
2002,ISERE,SAINT-MARTIN-D'HERES-NORD,8715,2452,6263,201,6062,1,LV,591,6.475,33.9
2002,ISERE,SAINT-MARTIN-D'HERES-NORD,8715,2452,6263,201,6062,1,MDC,423,6.475,33.9
2002,ISERE,SAINT-MARTIN-D'HERES-NORD,8715,2452,6263,201,6062,1,MNR,157,6.475,33.9
2002,ISERE,SAINT-MARTIN-D'HERES-NORD,8715,2452,6263,201,6062,1,MODEM,310,6.475,33.9
2002,ISERE,SAINT-MARTIN-D'HERES-NORD,8715,2452,6263,201,6062,1,PCF,520,6.475,33.9
2002,ISERE,SAINT-MARTIN-D'HERES-NORD,8715,2452,6263,201,6062,1,PRG,149,6.475,33.9
2002,ISERE,SAINT-MARTIN-D'HERES-NORD,8715,2452,6263,201,6062,1,PS,1147,6.475,33.9
2002,ISERE,SAINT-MARTIN-D'HERES-NORD,8715,2452,6263,201,6062,1,PT,35,6.475,33.9
2002,ISERE,SAINT-MARTIN-D'HERES-NORD,8715,2452,6263,201,6062,1,RPR,744,6.475,33.9
2002,ISERE,LA-COTE-SAINT-ANDRE,9043,2187,6856,251,6605,1,CAP 21,137,6.475,33.9
2002,ISERE,LA-COTE-SAINT-ANDRE,9043,2187,6856,251,6605,1,CPNT,368,6.475,33.9
2002,ISERE,LA-COTE-SAINT-ANDRE,9043,2187,6856,251,6605,1,DL,301,6.475,33.9
2002,ISERE,LA-COTE-SAINT-ANDRE,9043,2187,6856,251,6605,1,FN,1315,6.475,33.9
2002,ISERE,LA-COTE-SAINT-ANDRE,9043,2187,6856,251,6605,1,FRS,108,6.475,33.9
2002,ISERE,LA-COTE-SAINT-ANDRE,9043,2187,6856,251,6605,1,LCR,289,6.475,33.9
2002,ISERE,LA-COTE-SAINT-ANDRE,9043,2187,6856,251,6605,1,LO,316,6.475,33.9
2002,ISERE,LA-COTE-SAINT-ANDRE,9043,2187,6856,251,6605,1,LV,349,6.475,33.9
2002,ISERE,LA-COTE-SAINT-ANDRE,9043,2187,6856,251,6605,1,MDC,391,6.475,33.9
2002,ISERE,LA-COTE-SAINT-ANDRE,9043,2187,6856,251,6605,1,MNR,187,6.475,33.9
2002,ISERE,LA-COTE-SAINT-ANDRE,9043,2187,6856,251,6605,1,MODEM,545,6.475,33.9
2002,ISERE,LA-COTE-SAINT-ANDRE,9043,2187,6856,251,6605,1,PCF,157,6.475,33.9
2002,ISERE,LA-COTE-SAINT-ANDRE,9043,2187,6856,251,6605,1,PRG,139,6.475,33.9
2002,ISERE,LA-COTE-SAINT-ANDRE,9043,2187,6856,251,6605,1,PS,861,6.475,33.9
2002,ISERE,LA-COTE-SAINT-ANDRE,9043,2187,6856,251,6605,1,PT,27,6.475,33.9
2002,ISERE,LA-COTE-SAINT-ANDRE,9043,2187,6856,251,6605,1,RPR,1115,6.475,33.9
2002,ISERE,Beaurepaire,9291,2498,6793,291,6502,1,CAP 21,148,6.475,33.9
2002,ISERE,Beaurepaire,9291,2498,6793,291,6502,1,CPNT,318,6.475,33.9
2002,ISERE,Beaurepaire,9291,2498,6793,291,6502,1,DL,247,6.475,33.9
2002,ISERE,Beaurepaire,9291,2498,6793,291,6502,1,FN,1528,6.475,33.9
2002,ISERE,Beaurepaire,9291,2498,6793,291,6502,1,FRS,88,6.475,33.9
2002,ISERE,Beaurepaire,9291,2498,6793,291,6502,1,LCR,312,6.475,33.9
2002,ISERE,Beaurepaire,9291,2498,6793,291,6502,1,LO,371,6.475,33.9
2002,ISERE,Beaurepaire,9291,2498,6793,291,6502,1,LV,317,6.475,33.9
2002,ISERE,Beaurepaire,9291,2498,6793,291,6502,1,MDC,365,6.475,33.9
2002,ISERE,Beaurepaire,9291,2498,6793,291,6502,1,MNR,244,6.475,33.9
2002,ISERE,Beaurepaire,9291,2498,6793,291,6502,1,MODEM,379,6.475,33.9
2002,ISERE,Beaurepaire,9291,2498,6793,291,6502,1,PCF,293,6.475,33.9
2002,ISERE,Beaurepaire,9291,2498,6793,291,6502,1,PRG,98,6.475,33.9
2002,ISERE,Beaurepaire,9291,2498,6793,291,6502,1,PS,906,6.475,33.9
2002,ISERE,Beaurepaire,9291,2498,6793,291,6502,1,PT,44,6.475,33.9
2002,ISERE,Beaurepaire,9291,2498,6793,291,6502,1,RPR,844,6.475,33.9
2002,ISERE,LE-GRAND-LEMPS,9294,2316,6978,324,6654,1,CAP 21,157,6.475,33.9
2002,ISERE,LE-GRAND-LEMPS,9294,2316,6978,324,6654,1,CPNT,265,6.475,33.9
2002,ISERE,LE-GRAND-LEMPS,9294,2316,6978,324,6654,1,DL,288,6.475,33.9
2002,ISERE,LE-GRAND-LEMPS,9294,2316,6978,324,6654,1,FN,1317,6.475,33.9
2002,ISERE,LE-GRAND-LEMPS,9294,2316,6978,324,6654,1,FRS,96,6.475,33.9
2002,ISERE,LE-GRAND-LEMPS,9294,2316,6978,324,6654,1,LCR,322,6.475,33.9
2002,ISERE,LE-GRAND-LEMPS,9294,2316,6978,324,6654,1,LO,470,6.475,33.9
2002,ISERE,LE-GRAND-LEMPS,9294,2316,6978,324,6654,1,LV,358,6.475,33.9
2002,ISERE,LE-GRAND-LEMPS,9294,2316,6978,324,6654,1,MDC,371,6.475,33.9
2002,ISERE,LE-GRAND-LEMPS,9294,2316,6978,324,6654,1,MNR,210,6.475,33.9
2002,ISERE,LE-GRAND-LEMPS,9294,2316,6978,324,6654,1,MODEM,477,6.475,33.9
2002,ISERE,LE-GRAND-LEMPS,9294,2316,6978,324,6654,1,PCF,230,6.475,33.9
2002,ISERE,LE-GRAND-LEMPS,9294,2316,6978,324,6654,1,PRG,113,6.475,33.9
2002,ISERE,LE-GRAND-LEMPS,9294,2316,6978,324,6654,1,PS,841,6.475,33.9
2002,ISERE,LE-GRAND-LEMPS,9294,2316,6978,324,6654,1,PT,58,6.475,33.9
2002,ISERE,LE-GRAND-LEMPS,9294,2316,6978,324,6654,1,RPR,1081,6.475,33.9
2002,ISERE,La Mure,9748,2582,7166,292,6874,1,CAP 21,116,6.475,33.9
2002,ISERE,La Mure,9748,2582,7166,292,6874,1,CPNT,243,6.475,33.9
2002,ISERE,La Mure,9748,2582,7166,292,6874,1,DL,148,6.475,33.9
2002,ISERE,La Mure,9748,2582,7166,292,6874,1,FN,1330,6.475,33.9
2002,ISERE,La Mure,9748,2582,7166,292,6874,1,FRS,73,6.475,33.9
2002,ISERE,La Mure,9748,2582,7166,292,6874,1,LCR,385,6.475,33.9
2002,ISERE,La Mure,9748,2582,7166,292,6874,1,LO,543,6.475,33.9
2002,ISERE,La Mure,9748,2582,7166,292,6874,1,LV,402,6.475,33.9
2002,ISERE,La Mure,9748,2582,7166,292,6874,1,MDC,456,6.475,33.9
2002,ISERE,La Mure,9748,2582,7166,292,6874,1,MNR,187,6.475,33.9
2002,ISERE,La Mure,9748,2582,7166,292,6874,1,MODEM,375,6.475,33.9
2002,ISERE,La Mure,9748,2582,7166,292,6874,1,PCF,321,6.475,33.9
2002,ISERE,La Mure,9748,2582,7166,292,6874,1,PRG,145,6.475,33.9
2002,ISERE,La Mure,9748,2582,7166,292,6874,1,PS,1177,6.475,33.9
2002,ISERE,La Mure,9748,2582,7166,292,6874,1,PT,51,6.475,33.9
2002,ISERE,La Mure,9748,2582,7166,292,6874,1,RPR,922,6.475,33.9
2002,ISERE,GRENOBLE-4,10384,2839,7545,146,7399,1,CAP 21,177,6.475,33.9
2002,ISERE,GRENOBLE-4,10384,2839,7545,146,7399,1,CPNT,66,6.475,33.9
2002,ISERE,GRENOBLE-4,10384,2839,7545,146,7399,1,DL,319,6.475,33.9
2002,ISERE,GRENOBLE-4,10384,2839,7545,146,7399,1,FN,888,6.475,33.9
2002,ISERE,GRENOBLE-4,10384,2839,7545,146,7399,1,FRS,114,6.475,33.9
2002,ISERE,GRENOBLE-4,10384,2839,7545,146,7399,1,LCR,333,6.475,33.9
2002,ISERE,GRENOBLE-4,10384,2839,7545,146,7399,1,LO,289,6.475,33.9
2002,ISERE,GRENOBLE-4,10384,2839,7545,146,7399,1,LV,703,6.475,33.9
2002,ISERE,GRENOBLE-4,10384,2839,7545,146,7399,1,MDC,556,6.475,33.9
2002,ISERE,GRENOBLE-4,10384,2839,7545,146,7399,1,MNR,92,6.475,33.9
2002,ISERE,GRENOBLE-4,10384,2839,7545,146,7399,1,MODEM,549,6.475,33.9
2002,ISERE,GRENOBLE-4,10384,2839,7545,146,7399,1,PCF,170,6.475,33.9
2002,ISERE,GRENOBLE-4,10384,2839,7545,146,7399,1,PRG,191,6.475,33.9
2002,ISERE,GRENOBLE-4,10384,2839,7545,146,7399,1,PS,1389,6.475,33.9
2002,ISERE,GRENOBLE-4,10384,2839,7545,146,7399,1,PT,29,6.475,33.9
2002,ISERE,GRENOBLE-4,10384,2839,7545,146,7399,1,RPR,1534,6.475,33.9
2002,ISERE,GRENOBLE-6,10414,3106,7308,163,7145,1,CAP 21,110,6.475,33.9
2002,ISERE,GRENOBLE-6,10414,3106,7308,163,7145,1,CPNT,85,6.475,33.9
2002,ISERE,GRENOBLE-6,10414,3106,7308,163,7145,1,DL,200,6.475,33.9
2002,ISERE,GRENOBLE-6,10414,3106,7308,163,7145,1,FN,972,6.475,33.9
2002,ISERE,GRENOBLE-6,10414,3106,7308,163,7145,1,FRS,66,6.475,33.9
2002,ISERE,GRENOBLE-6,10414,3106,7308,163,7145,1,LCR,338,6.475,33.9
2002,ISERE,GRENOBLE-6,10414,3106,7308,163,7145,1,LO,397,6.475,33.9
2002,ISERE,GRENOBLE-6,10414,3106,7308,163,7145,1,LV,718,6.475,33.9
2002,ISERE,GRENOBLE-6,10414,3106,7308,163,7145,1,MDC,536,6.475,33.9
2002,ISERE,GRENOBLE-6,10414,3106,7308,163,7145,1,MNR,178,6.475,33.9
2002,ISERE,GRENOBLE-6,10414,3106,7308,163,7145,1,MODEM,403,6.475,33.9
2002,ISERE,GRENOBLE-6,10414,3106,7308,163,7145,1,PCF,239,6.475,33.9
2002,ISERE,GRENOBLE-6,10414,3106,7308,163,7145,1,PRG,224,6.475,33.9
2002,ISERE,GRENOBLE-6,10414,3106,7308,163,7145,1,PS,1670,6.475,33.9
2002,ISERE,GRENOBLE-6,10414,3106,7308,163,7145,1,PT,35,6.475,33.9
2002,ISERE,GRENOBLE-6,10414,3106,7308,163,7145,1,RPR,974,6.475,33.9
2002,ISERE,ECHIROLLES-OUEST,10617,2710,7907,206,7701,1,CAP 21,152,6.475,33.9
2002,ISERE,ECHIROLLES-OUEST,10617,2710,7907,206,7701,1,CPNT,71,6.475,33.9
2002,ISERE,ECHIROLLES-OUEST,10617,2710,7907,206,7701,1,DL,222,6.475,33.9
2002,ISERE,ECHIROLLES-OUEST,10617,2710,7907,206,7701,1,FN,1438,6.475,33.9
2002,ISERE,ECHIROLLES-OUEST,10617,2710,7907,206,7701,1,FRS,59,6.475,33.9
2002,ISERE,ECHIROLLES-OUEST,10617,2710,7907,206,7701,1,LCR,351,6.475,33.9
2002,ISERE,ECHIROLLES-OUEST,10617,2710,7907,206,7701,1,LO,496,6.475,33.9
2002,ISERE,ECHIROLLES-OUEST,10617,2710,7907,206,7701,1,LV,562,6.475,33.9
2002,ISERE,ECHIROLLES-OUEST,10617,2710,7907,206,7701,1,MDC,537,6.475,33.9
2002,ISERE,ECHIROLLES-OUEST,10617,2710,7907,206,7701,1,MNR,195,6.475,33.9
2002,ISERE,ECHIROLLES-OUEST,10617,2710,7907,206,7701,1,MODEM,397,6.475,33.9
2002,ISERE,ECHIROLLES-OUEST,10617,2710,7907,206,7701,1,PCF,557,6.475,33.9
2002,ISERE,ECHIROLLES-OUEST,10617,2710,7907,206,7701,1,PRG,145,6.475,33.9
2002,ISERE,ECHIROLLES-OUEST,10617,2710,7907,206,7701,1,PS,1503,6.475,33.9
2002,ISERE,ECHIROLLES-OUEST,10617,2710,7907,206,7701,1,PT,45,6.475,33.9
2002,ISERE,ECHIROLLES-OUEST,10617,2710,7907,206,7701,1,RPR,971,6.475,33.9
2002,ISERE,Saint-Jean-de-Bournay,10653,2735,7918,343,7575,1,CAP 21,153,6.475,33.9
2002,ISERE,Saint-Jean-de-Bournay,10653,2735,7918,343,7575,1,CPNT,354,6.475,33.9
2002,ISERE,Saint-Jean-de-Bournay,10653,2735,7918,343,7575,1,DL,409,6.475,33.9
2002,ISERE,Saint-Jean-de-Bournay,10653,2735,7918,343,7575,1,FN,1898,6.475,33.9
2002,ISERE,Saint-Jean-de-Bournay,10653,2735,7918,343,7575,1,FRS,80,6.475,33.9
2002,ISERE,Saint-Jean-de-Bournay,10653,2735,7918,343,7575,1,LCR,296,6.475,33.9
2002,ISERE,Saint-Jean-de-Bournay,10653,2735,7918,343,7575,1,LO,419,6.475,33.9
2002,ISERE,Saint-Jean-de-Bournay,10653,2735,7918,343,7575,1,LV,312,6.475,33.9
2002,ISERE,Saint-Jean-de-Bournay,10653,2735,7918,343,7575,1,MDC,343,6.475,33.9
2002,ISERE,Saint-Jean-de-Bournay,10653,2735,7918,343,7575,1,MNR,299,6.475,33.9
2002,ISERE,Saint-Jean-de-Bournay,10653,2735,7918,343,7575,1,MODEM,501,6.475,33.9
2002,ISERE,Saint-Jean-de-Bournay,10653,2735,7918,343,7575,1,PCF,181,6.475,33.9
2002,ISERE,Saint-Jean-de-Bournay,10653,2735,7918,343,7575,1,PRG,119,6.475,33.9
2002,ISERE,Saint-Jean-de-Bournay,10653,2735,7918,343,7575,1,PS,929,6.475,33.9
2002,ISERE,Saint-Jean-de-Bournay,10653,2735,7918,343,7575,1,PT,28,6.475,33.9
2002,ISERE,Saint-Jean-de-Bournay,10653,2735,7918,343,7575,1,RPR,1254,6.475,33.9
2002,ISERE,LA VERPILLIERE,10751,2946,7805,266,7539,1,CAP 21,162,6.475,33.9
2002,ISERE,LA VERPILLIERE,10751,2946,7805,266,7539,1,CPNT,196,6.475,33.9
2002,ISERE,LA VERPILLIERE,10751,2946,7805,266,7539,1,DL,281,6.475,33.9
2002,ISERE,LA VERPILLIERE,10751,2946,7805,266,7539,1,FN,1883,6.475,33.9
2002,ISERE,LA VERPILLIERE,10751,2946,7805,266,7539,1,FRS,94,6.475,33.9
2002,ISERE,LA VERPILLIERE,10751,2946,7805,266,7539,1,LCR,312,6.475,33.9
2002,ISERE,LA VERPILLIERE,10751,2946,7805,266,7539,1,LO,470,6.475,33.9
2002,ISERE,LA VERPILLIERE,10751,2946,7805,266,7539,1,LV,401,6.475,33.9
2002,ISERE,LA VERPILLIERE,10751,2946,7805,266,7539,1,MDC,480,6.475,33.9
2002,ISERE,LA VERPILLIERE,10751,2946,7805,266,7539,1,MNR,272,6.475,33.9
2002,ISERE,LA VERPILLIERE,10751,2946,7805,266,7539,1,MODEM,492,6.475,33.9
2002,ISERE,LA VERPILLIERE,10751,2946,7805,266,7539,1,PCF,241,6.475,33.9
2002,ISERE,LA VERPILLIERE,10751,2946,7805,266,7539,1,PRG,154,6.475,33.9
2002,ISERE,LA VERPILLIERE,10751,2946,7805,266,7539,1,PS,1010,6.475,33.9
2002,ISERE,LA VERPILLIERE,10751,2946,7805,266,7539,1,PT,37,6.475,33.9
2002,ISERE,LA VERPILLIERE,10751,2946,7805,266,7539,1,RPR,1054,6.475,33.9
2002,ISERE,GRENOBLE-3,12021,3186,8835,201,8634,1,CAP 21,173,6.475,33.9
2002,ISERE,GRENOBLE-3,12021,3186,8835,201,8634,1,CPNT,48,6.475,33.9
2002,ISERE,GRENOBLE-3,12021,3186,8835,201,8634,1,DL,249,6.475,33.9
2002,ISERE,GRENOBLE-3,12021,3186,8835,201,8634,1,FN,1140,6.475,33.9
2002,ISERE,GRENOBLE-3,12021,3186,8835,201,8634,1,FRS,92,6.475,33.9
2002,ISERE,GRENOBLE-3,12021,3186,8835,201,8634,1,LCR,462,6.475,33.9
2002,ISERE,GRENOBLE-3,12021,3186,8835,201,8634,1,LO,529,6.475,33.9
2002,ISERE,GRENOBLE-3,12021,3186,8835,201,8634,1,LV,909,6.475,33.9
2002,ISERE,GRENOBLE-3,12021,3186,8835,201,8634,1,MDC,623,6.475,33.9
2002,ISERE,GRENOBLE-3,12021,3186,8835,201,8634,1,MNR,183,6.475,33.9
2002,ISERE,GRENOBLE-3,12021,3186,8835,201,8634,1,MODEM,536,6.475,33.9
2002,ISERE,GRENOBLE-3,12021,3186,8835,201,8634,1,PCF,293,6.475,33.9
2002,ISERE,GRENOBLE-3,12021,3186,8835,201,8634,1,PRG,301,6.475,33.9
2002,ISERE,GRENOBLE-3,12021,3186,8835,201,8634,1,PS,1988,6.475,33.9
2002,ISERE,GRENOBLE-3,12021,3186,8835,201,8634,1,PT,42,6.475,33.9
2002,ISERE,GRENOBLE-3,12021,3186,8835,201,8634,1,RPR,1066,6.475,33.9
2002,ISERE,Eybens,12375,2816,9559,260,9299,1,CAP 21,251,6.475,33.9
2002,ISERE,Eybens,12375,2816,9559,260,9299,1,CPNT,113,6.475,33.9
2002,ISERE,Eybens,12375,2816,9559,260,9299,1,DL,411,6.475,33.9
2002,ISERE,Eybens,12375,2816,9559,260,9299,1,FN,1301,6.475,33.9
2002,ISERE,Eybens,12375,2816,9559,260,9299,1,FRS,123,6.475,33.9
2002,ISERE,Eybens,12375,2816,9559,260,9299,1,LCR,397,6.475,33.9
2002,ISERE,Eybens,12375,2816,9559,260,9299,1,LO,459,6.475,33.9
2002,ISERE,Eybens,12375,2816,9559,260,9299,1,LV,846,6.475,33.9
2002,ISERE,Eybens,12375,2816,9559,260,9299,1,MDC,718,6.475,33.9
2002,ISERE,Eybens,12375,2816,9559,260,9299,1,MNR,171,6.475,33.9
2002,ISERE,Eybens,12375,2816,9559,260,9299,1,MODEM,736,6.475,33.9
2002,ISERE,Eybens,12375,2816,9559,260,9299,1,PCF,315,6.475,33.9
2002,ISERE,Eybens,12375,2816,9559,260,9299,1,PRG,213,6.475,33.9
2002,ISERE,Eybens,12375,2816,9559,260,9299,1,PS,2002,6.475,33.9
2002,ISERE,Eybens,12375,2816,9559,260,9299,1,PT,44,6.475,33.9
2002,ISERE,Eybens,12375,2816,9559,260,9299,1,RPR,1199,6.475,33.9
2002,ISERE,Heyrieux,12645,3053,9592,323,9269,1,CAP 21,190,6.475,33.9
2002,ISERE,Heyrieux,12645,3053,9592,323,9269,1,CPNT,304,6.475,33.9
2002,ISERE,Heyrieux,12645,3053,9592,323,9269,1,DL,439,6.475,33.9
2002,ISERE,Heyrieux,12645,3053,9592,323,9269,1,FN,2343,6.475,33.9
2002,ISERE,Heyrieux,12645,3053,9592,323,9269,1,FRS,96,6.475,33.9
2002,ISERE,Heyrieux,12645,3053,9592,323,9269,1,LCR,361,6.475,33.9
2002,ISERE,Heyrieux,12645,3053,9592,323,9269,1,LO,533,6.475,33.9
2002,ISERE,Heyrieux,12645,3053,9592,323,9269,1,LV,419,6.475,33.9
2002,ISERE,Heyrieux,12645,3053,9592,323,9269,1,MDC,582,6.475,33.9
2002,ISERE,Heyrieux,12645,3053,9592,323,9269,1,MNR,406,6.475,33.9
2002,ISERE,Heyrieux,12645,3053,9592,323,9269,1,MODEM,664,6.475,33.9
2002,ISERE,Heyrieux,12645,3053,9592,323,9269,1,PCF,254,6.475,33.9
2002,ISERE,Heyrieux,12645,3053,9592,323,9269,1,PRG,166,6.475,33.9
2002,ISERE,Heyrieux,12645,3053,9592,323,9269,1,PS,1088,6.475,33.9
2002,ISERE,Heyrieux,12645,3053,9592,323,9269,1,PT,68,6.475,33.9
2002,ISERE,Heyrieux,12645,3053,9592,323,9269,1,RPR,1356,6.475,33.9
2002,ISERE,LE-PONT-DE-BEAUVOISIN,13107,3731,9376,351,9025,1,CAP 21,169,6.475,33.9
2002,ISERE,LE-PONT-DE-BEAUVOISIN,13107,3731,9376,351,9025,1,CPNT,327,6.475,33.9
2002,ISERE,LE-PONT-DE-BEAUVOISIN,13107,3731,9376,351,9025,1,DL,380,6.475,33.9
2002,ISERE,LE-PONT-DE-BEAUVOISIN,13107,3731,9376,351,9025,1,FN,2252,6.475,33.9
2002,ISERE,LE-PONT-DE-BEAUVOISIN,13107,3731,9376,351,9025,1,FRS,134,6.475,33.9
2002,ISERE,LE-PONT-DE-BEAUVOISIN,13107,3731,9376,351,9025,1,LCR,359,6.475,33.9
2002,ISERE,LE-PONT-DE-BEAUVOISIN,13107,3731,9376,351,9025,1,LO,502,6.475,33.9
2002,ISERE,LE-PONT-DE-BEAUVOISIN,13107,3731,9376,351,9025,1,LV,469,6.475,33.9
2002,ISERE,LE-PONT-DE-BEAUVOISIN,13107,3731,9376,351,9025,1,MDC,521,6.475,33.9
2002,ISERE,LE-PONT-DE-BEAUVOISIN,13107,3731,9376,351,9025,1,MNR,270,6.475,33.9
2002,ISERE,LE-PONT-DE-BEAUVOISIN,13107,3731,9376,351,9025,1,MODEM,605,6.475,33.9
2002,ISERE,LE-PONT-DE-BEAUVOISIN,13107,3731,9376,351,9025,1,PCF,290,6.475,33.9
2002,ISERE,LE-PONT-DE-BEAUVOISIN,13107,3731,9376,351,9025,1,PRG,154,6.475,33.9
2002,ISERE,LE-PONT-DE-BEAUVOISIN,13107,3731,9376,351,9025,1,PS,1097,6.475,33.9
2002,ISERE,LE-PONT-DE-BEAUVOISIN,13107,3731,9376,351,9025,1,PT,62,6.475,33.9
2002,ISERE,LE-PONT-DE-BEAUVOISIN,13107,3731,9376,351,9025,1,RPR,1434,6.475,33.9
2002,ISERE,PONT-DE-CHERUY,13161,4180,8981,225,8756,1,CAP 21,165,6.475,33.9
2002,ISERE,PONT-DE-CHERUY,13161,4180,8981,225,8756,1,CPNT,164,6.475,33.9
2002,ISERE,PONT-DE-CHERUY,13161,4180,8981,225,8756,1,DL,369,6.475,33.9
2002,ISERE,PONT-DE-CHERUY,13161,4180,8981,225,8756,1,FN,2390,6.475,33.9
2002,ISERE,PONT-DE-CHERUY,13161,4180,8981,225,8756,1,FRS,68,6.475,33.9
2002,ISERE,PONT-DE-CHERUY,13161,4180,8981,225,8756,1,LCR,290,6.475,33.9
2002,ISERE,PONT-DE-CHERUY,13161,4180,8981,225,8756,1,LO,581,6.475,33.9
2002,ISERE,PONT-DE-CHERUY,13161,4180,8981,225,8756,1,LV,410,6.475,33.9
2002,ISERE,PONT-DE-CHERUY,13161,4180,8981,225,8756,1,MDC,477,6.475,33.9
2002,ISERE,PONT-DE-CHERUY,13161,4180,8981,225,8756,1,MNR,392,6.475,33.9
2002,ISERE,PONT-DE-CHERUY,13161,4180,8981,225,8756,1,MODEM,522,6.475,33.9
2002,ISERE,PONT-DE-CHERUY,13161,4180,8981,225,8756,1,PCF,206,6.475,33.9
2002,ISERE,PONT-DE-CHERUY,13161,4180,8981,225,8756,1,PRG,162,6.475,33.9
2002,ISERE,PONT-DE-CHERUY,13161,4180,8981,225,8756,1,PS,1156,6.475,33.9
2002,ISERE,PONT-DE-CHERUY,13161,4180,8981,225,8756,1,PT,41,6.475,33.9
2002,ISERE,PONT-DE-CHERUY,13161,4180,8981,225,8756,1,RPR,1363,6.475,33.9
2002,ISERE,Goncelin,13257,3569,9688,361,9327,1,CAP 21,238,6.475,33.9
2002,ISERE,Goncelin,13257,3569,9688,361,9327,1,CPNT,294,6.475,33.9
2002,ISERE,Goncelin,13257,3569,9688,361,9327,1,DL,375,6.475,33.9
2002,ISERE,Goncelin,13257,3569,9688,361,9327,1,FN,1772,6.475,33.9
2002,ISERE,Goncelin,13257,3569,9688,361,9327,1,FRS,97,6.475,33.9
2002,ISERE,Goncelin,13257,3569,9688,361,9327,1,LCR,502,6.475,33.9
2002,ISERE,Goncelin,13257,3569,9688,361,9327,1,LO,677,6.475,33.9
2002,ISERE,Goncelin,13257,3569,9688,361,9327,1,LV,679,6.475,33.9
2002,ISERE,Goncelin,13257,3569,9688,361,9327,1,MDC,551,6.475,33.9
2002,ISERE,Goncelin,13257,3569,9688,361,9327,1,MNR,239,6.475,33.9
2002,ISERE,Goncelin,13257,3569,9688,361,9327,1,MODEM,585,6.475,33.9
2002,ISERE,Goncelin,13257,3569,9688,361,9327,1,PCF,361,6.475,33.9
2002,ISERE,Goncelin,13257,3569,9688,361,9327,1,PRG,203,6.475,33.9
2002,ISERE,Goncelin,13257,3569,9688,361,9327,1,PS,1435,6.475,33.9
2002,ISERE,Goncelin,13257,3569,9688,361,9327,1,PT,43,6.475,33.9
2002,ISERE,Goncelin,13257,3569,9688,361,9327,1,RPR,1276,6.475,33.9
2002,ISERE,Saint-Ismier,13383,3065,10318,222,10096,1,CAP 21,414,6.475,33.9
2002,ISERE,Saint-Ismier,13383,3065,10318,222,10096,1,CPNT,162,6.475,33.9
2002,ISERE,Saint-Ismier,13383,3065,10318,222,10096,1,DL,848,6.475,33.9
2002,ISERE,Saint-Ismier,13383,3065,10318,222,10096,1,FN,1038,6.475,33.9
2002,ISERE,Saint-Ismier,13383,3065,10318,222,10096,1,FRS,198,6.475,33.9
2002,ISERE,Saint-Ismier,13383,3065,10318,222,10096,1,LCR,271,6.475,33.9
2002,ISERE,Saint-Ismier,13383,3065,10318,222,10096,1,LO,286,6.475,33.9
2002,ISERE,Saint-Ismier,13383,3065,10318,222,10096,1,LV,717,6.475,33.9
2002,ISERE,Saint-Ismier,13383,3065,10318,222,10096,1,MDC,811,6.475,33.9
2002,ISERE,Saint-Ismier,13383,3065,10318,222,10096,1,MNR,186,6.475,33.9
2002,ISERE,Saint-Ismier,13383,3065,10318,222,10096,1,MODEM,1037,6.475,33.9
2002,ISERE,Saint-Ismier,13383,3065,10318,222,10096,1,PCF,157,6.475,33.9
2002,ISERE,Saint-Ismier,13383,3065,10318,222,10096,1,PRG,234,6.475,33.9
2002,ISERE,Saint-Ismier,13383,3065,10318,222,10096,1,PS,1682,6.475,33.9
2002,ISERE,Saint-Ismier,13383,3065,10318,222,10096,1,PT,21,6.475,33.9
2002,ISERE,Saint-Ismier,13383,3065,10318,222,10096,1,RPR,2034,6.475,33.9
2002,ISERE,GRENOBLE-2,13528,3511,10017,203,9814,1,CAP 21,262,6.475,33.9
2002,ISERE,GRENOBLE-2,13528,3511,10017,203,9814,1,CPNT,77,6.475,33.9
2002,ISERE,GRENOBLE-2,13528,3511,10017,203,9814,1,DL,547,6.475,33.9
2002,ISERE,GRENOBLE-2,13528,3511,10017,203,9814,1,FN,1038,6.475,33.9
2002,ISERE,GRENOBLE-2,13528,3511,10017,203,9814,1,FRS,152,6.475,33.9
2002,ISERE,GRENOBLE-2,13528,3511,10017,203,9814,1,LCR,425,6.475,33.9
2002,ISERE,GRENOBLE-2,13528,3511,10017,203,9814,1,LO,339,6.475,33.9
2002,ISERE,GRENOBLE-2,13528,3511,10017,203,9814,1,LV,849,6.475,33.9
2002,ISERE,GRENOBLE-2,13528,3511,10017,203,9814,1,MDC,742,6.475,33.9
2002,ISERE,GRENOBLE-2,13528,3511,10017,203,9814,1,MNR,136,6.475,33.9
2002,ISERE,GRENOBLE-2,13528,3511,10017,203,9814,1,MODEM,846,6.475,33.9
2002,ISERE,GRENOBLE-2,13528,3511,10017,203,9814,1,PCF,227,6.475,33.9
2002,ISERE,GRENOBLE-2,13528,3511,10017,203,9814,1,PRG,292,6.475,33.9
2002,ISERE,GRENOBLE-2,13528,3511,10017,203,9814,1,PS,1790,6.475,33.9
2002,ISERE,GRENOBLE-2,13528,3511,10017,203,9814,1,PT,50,6.475,33.9
2002,ISERE,GRENOBLE-2,13528,3511,10017,203,9814,1,RPR,2042,6.475,33.9
2002,ISERE,BOURGOIN-JALLIEU-SUD,14314,3689,10625,362,10263,1,CAP 21,244,6.475,33.9
2002,ISERE,BOURGOIN-JALLIEU-SUD,14314,3689,10625,362,10263,1,CPNT,246,6.475,33.9
2002,ISERE,BOURGOIN-JALLIEU-SUD,14314,3689,10625,362,10263,1,DL,514,6.475,33.9
2002,ISERE,BOURGOIN-JALLIEU-SUD,14314,3689,10625,362,10263,1,FN,2085,6.475,33.9
2002,ISERE,BOURGOIN-JALLIEU-SUD,14314,3689,10625,362,10263,1,FRS,130,6.475,33.9
2002,ISERE,BOURGOIN-JALLIEU-SUD,14314,3689,10625,362,10263,1,LCR,395,6.475,33.9
2002,ISERE,BOURGOIN-JALLIEU-SUD,14314,3689,10625,362,10263,1,LO,456,6.475,33.9
2002,ISERE,BOURGOIN-JALLIEU-SUD,14314,3689,10625,362,10263,1,LV,547,6.475,33.9
2002,ISERE,BOURGOIN-JALLIEU-SUD,14314,3689,10625,362,10263,1,MDC,720,6.475,33.9
2002,ISERE,BOURGOIN-JALLIEU-SUD,14314,3689,10625,362,10263,1,MNR,344,6.475,33.9
2002,ISERE,BOURGOIN-JALLIEU-SUD,14314,3689,10625,362,10263,1,MODEM,820,6.475,33.9
2002,ISERE,BOURGOIN-JALLIEU-SUD,14314,3689,10625,362,10263,1,PCF,321,6.475,33.9
2002,ISERE,BOURGOIN-JALLIEU-SUD,14314,3689,10625,362,10263,1,PRG,223,6.475,33.9
2002,ISERE,BOURGOIN-JALLIEU-SUD,14314,3689,10625,362,10263,1,PS,1372,6.475,33.9
2002,ISERE,BOURGOIN-JALLIEU-SUD,14314,3689,10625,362,10263,1,PT,47,6.475,33.9
2002,ISERE,BOURGOIN-JALLIEU-SUD,14314,3689,10625,362,10263,1,RPR,1799,6.475,33.9
2002,ISERE,Saint-Marcellin,14532,3895,10637,401,10236,1,CAP 21,177,6.475,33.9
2002,ISERE,Saint-Marcellin,14532,3895,10637,401,10236,1,CPNT,571,6.475,33.9
2002,ISERE,Saint-Marcellin,14532,3895,10637,401,10236,1,DL,423,6.475,33.9
2002,ISERE,Saint-Marcellin,14532,3895,10637,401,10236,1,FN,2163,6.475,33.9
2002,ISERE,Saint-Marcellin,14532,3895,10637,401,10236,1,FRS,172,6.475,33.9
2002,ISERE,Saint-Marcellin,14532,3895,10637,401,10236,1,LCR,427,6.475,33.9
2002,ISERE,Saint-Marcellin,14532,3895,10637,401,10236,1,LO,593,6.475,33.9
2002,ISERE,Saint-Marcellin,14532,3895,10637,401,10236,1,LV,558,6.475,33.9
2002,ISERE,Saint-Marcellin,14532,3895,10637,401,10236,1,MDC,630,6.475,33.9
2002,ISERE,Saint-Marcellin,14532,3895,10637,401,10236,1,MNR,344,6.475,33.9
2002,ISERE,Saint-Marcellin,14532,3895,10637,401,10236,1,MODEM,723,6.475,33.9
2002,ISERE,Saint-Marcellin,14532,3895,10637,401,10236,1,PCF,190,6.475,33.9
2002,ISERE,Saint-Marcellin,14532,3895,10637,401,10236,1,PRG,183,6.475,33.9
2002,ISERE,Saint-Marcellin,14532,3895,10637,401,10236,1,PS,1347,6.475,33.9
2002,ISERE,Saint-Marcellin,14532,3895,10637,401,10236,1,PT,45,6.475,33.9
2002,ISERE,Saint-Marcellin,14532,3895,10637,401,10236,1,RPR,1690,6.475,33.9
2002,ISERE,BOURGOIN-JALLIEU-NORD,14916,4222,10694,383,10311,1,CAP 21,223,6.475,33.9
2002,ISERE,BOURGOIN-JALLIEU-NORD,14916,4222,10694,383,10311,1,CPNT,310,6.475,33.9
2002,ISERE,BOURGOIN-JALLIEU-NORD,14916,4222,10694,383,10311,1,DL,484,6.475,33.9
2002,ISERE,BOURGOIN-JALLIEU-NORD,14916,4222,10694,383,10311,1,FN,2228,6.475,33.9
2002,ISERE,BOURGOIN-JALLIEU-NORD,14916,4222,10694,383,10311,1,FRS,146,6.475,33.9
2002,ISERE,BOURGOIN-JALLIEU-NORD,14916,4222,10694,383,10311,1,LCR,404,6.475,33.9
2002,ISERE,BOURGOIN-JALLIEU-NORD,14916,4222,10694,383,10311,1,LO,548,6.475,33.9
2002,ISERE,BOURGOIN-JALLIEU-NORD,14916,4222,10694,383,10311,1,LV,557,6.475,33.9
2002,ISERE,BOURGOIN-JALLIEU-NORD,14916,4222,10694,383,10311,1,MDC,693,6.475,33.9
2002,ISERE,BOURGOIN-JALLIEU-NORD,14916,4222,10694,383,10311,1,MNR,291,6.475,33.9
2002,ISERE,BOURGOIN-JALLIEU-NORD,14916,4222,10694,383,10311,1,MODEM,726,6.475,33.9
2002,ISERE,BOURGOIN-JALLIEU-NORD,14916,4222,10694,383,10311,1,PCF,308,6.475,33.9
2002,ISERE,BOURGOIN-JALLIEU-NORD,14916,4222,10694,383,10311,1,PRG,208,6.475,33.9
2002,ISERE,BOURGOIN-JALLIEU-NORD,14916,4222,10694,383,10311,1,PS,1469,6.475,33.9
2002,ISERE,BOURGOIN-JALLIEU-NORD,14916,4222,10694,383,10311,1,PT,47,6.475,33.9
2002,ISERE,BOURGOIN-JALLIEU-NORD,14916,4222,10694,383,10311,1,RPR,1669,6.475,33.9
2002,ISERE,GRENOBLE-5,15124,4097,11027,262,10765,1,CAP 21,243,6.475,33.9
2002,ISERE,GRENOBLE-5,15124,4097,11027,262,10765,1,CPNT,92,6.475,33.9
2002,ISERE,GRENOBLE-5,15124,4097,11027,262,10765,1,DL,387,6.475,33.9
2002,ISERE,GRENOBLE-5,15124,4097,11027,262,10765,1,FN,1441,6.475,33.9
2002,ISERE,GRENOBLE-5,15124,4097,11027,262,10765,1,FRS,110,6.475,33.9
2002,ISERE,GRENOBLE-5,15124,4097,11027,262,10765,1,LCR,625,6.475,33.9
2002,ISERE,GRENOBLE-5,15124,4097,11027,262,10765,1,LO,565,6.475,33.9
2002,ISERE,GRENOBLE-5,15124,4097,11027,262,10765,1,LV,1079,6.475,33.9
2002,ISERE,GRENOBLE-5,15124,4097,11027,262,10765,1,MDC,766,6.475,33.9
2002,ISERE,GRENOBLE-5,15124,4097,11027,262,10765,1,MNR,206,6.475,33.9
2002,ISERE,GRENOBLE-5,15124,4097,11027,262,10765,1,MODEM,757,6.475,33.9
2002,ISERE,GRENOBLE-5,15124,4097,11027,262,10765,1,PCF,340,6.475,33.9
2002,ISERE,GRENOBLE-5,15124,4097,11027,262,10765,1,PRG,328,6.475,33.9
2002,ISERE,GRENOBLE-5,15124,4097,11027,262,10765,1,PS,2134,6.475,33.9
2002,ISERE,GRENOBLE-5,15124,4097,11027,262,10765,1,PT,46,6.475,33.9
2002,ISERE,GRENOBLE-5,15124,4097,11027,262,10765,1,RPR,1646,6.475,33.9
2002,ISERE,L'Isle-d'Abeau,15239,4587,10652,316,10336,1,CAP 21,234,6.475,33.9
2002,ISERE,L'Isle-d'Abeau,15239,4587,10652,316,10336,1,CPNT,119,6.475,33.9
2002,ISERE,L'Isle-d'Abeau,15239,4587,10652,316,10336,1,DL,365,6.475,33.9
2002,ISERE,L'Isle-d'Abeau,15239,4587,10652,316,10336,1,FN,2091,6.475,33.9
2002,ISERE,L'Isle-d'Abeau,15239,4587,10652,316,10336,1,FRS,102,6.475,33.9
2002,ISERE,L'Isle-d'Abeau,15239,4587,10652,316,10336,1,LCR,537,6.475,33.9
2002,ISERE,L'Isle-d'Abeau,15239,4587,10652,316,10336,1,LO,735,6.475,33.9
2002,ISERE,L'Isle-d'Abeau,15239,4587,10652,316,10336,1,LV,799,6.475,33.9
2002,ISERE,L'Isle-d'Abeau,15239,4587,10652,316,10336,1,MDC,666,6.475,33.9
2002,ISERE,L'Isle-d'Abeau,15239,4587,10652,316,10336,1,MNR,245,6.475,33.9
2002,ISERE,L'Isle-d'Abeau,15239,4587,10652,316,10336,1,MODEM,673,6.475,33.9
2002,ISERE,L'Isle-d'Abeau,15239,4587,10652,316,10336,1,PCF,295,6.475,33.9
2002,ISERE,L'Isle-d'Abeau,15239,4587,10652,316,10336,1,PRG,317,6.475,33.9
2002,ISERE,L'Isle-d'Abeau,15239,4587,10652,316,10336,1,PS,1853,6.475,33.9
2002,ISERE,L'Isle-d'Abeau,15239,4587,10652,316,10336,1,PT,57,6.475,33.9
2002,ISERE,L'Isle-d'Abeau,15239,4587,10652,316,10336,1,RPR,1248,6.475,33.9
2002,ISERE,Morestel,15715,4477,11238,414,10824,1,CAP 21,168,6.475,33.9
2002,ISERE,Morestel,15715,4477,11238,414,10824,1,CPNT,525,6.475,33.9
2002,ISERE,Morestel,15715,4477,11238,414,10824,1,DL,540,6.475,33.9
2002,ISERE,Morestel,15715,4477,11238,414,10824,1,FN,2744,6.475,33.9
2002,ISERE,Morestel,15715,4477,11238,414,10824,1,FRS,136,6.475,33.9
2002,ISERE,Morestel,15715,4477,11238,414,10824,1,LCR,474,6.475,33.9
2002,ISERE,Morestel,15715,4477,11238,414,10824,1,LO,669,6.475,33.9
2002,ISERE,Morestel,15715,4477,11238,414,10824,1,LV,428,6.475,33.9
2002,ISERE,Morestel,15715,4477,11238,414,10824,1,MDC,576,6.475,33.9
2002,ISERE,Morestel,15715,4477,11238,414,10824,1,MNR,410,6.475,33.9
2002,ISERE,Morestel,15715,4477,11238,414,10824,1,MODEM,725,6.475,33.9
2002,ISERE,Morestel,15715,4477,11238,414,10824,1,PCF,345,6.475,33.9
2002,ISERE,Morestel,15715,4477,11238,414,10824,1,PRG,168,6.475,33.9
2002,ISERE,Morestel,15715,4477,11238,414,10824,1,PS,1307,6.475,33.9
2002,ISERE,Morestel,15715,4477,11238,414,10824,1,PT,76,6.475,33.9
2002,ISERE,Morestel,15715,4477,11238,414,10824,1,RPR,1533,6.475,33.9
2002,ISERE,GRENOBLE-1,16383,4587,11796,218,11578,1,CAP 21,318,6.475,33.9
2002,ISERE,GRENOBLE-1,16383,4587,11796,218,11578,1,CPNT,77,6.475,33.9
2002,ISERE,GRENOBLE-1,16383,4587,11796,218,11578,1,DL,368,6.475,33.9
2002,ISERE,GRENOBLE-1,16383,4587,11796,218,11578,1,FN,1401,6.475,33.9
2002,ISERE,GRENOBLE-1,16383,4587,11796,218,11578,1,FRS,187,6.475,33.9
2002,ISERE,GRENOBLE-1,16383,4587,11796,218,11578,1,LCR,602,6.475,33.9
2002,ISERE,GRENOBLE-1,16383,4587,11796,218,11578,1,LO,587,6.475,33.9
2002,ISERE,GRENOBLE-1,16383,4587,11796,218,11578,1,LV,1169,6.475,33.9
2002,ISERE,GRENOBLE-1,16383,4587,11796,218,11578,1,MDC,875,6.475,33.9
2002,ISERE,GRENOBLE-1,16383,4587,11796,218,11578,1,MNR,190,6.475,33.9
2002,ISERE,GRENOBLE-1,16383,4587,11796,218,11578,1,MODEM,817,6.475,33.9
2002,ISERE,GRENOBLE-1,16383,4587,11796,218,11578,1,PCF,355,6.475,33.9
2002,ISERE,GRENOBLE-1,16383,4587,11796,218,11578,1,PRG,321,6.475,33.9
2002,ISERE,GRENOBLE-1,16383,4587,11796,218,11578,1,PS,2422,6.475,33.9
2002,ISERE,GRENOBLE-1,16383,4587,11796,218,11578,1,PT,51,6.475,33.9
2002,ISERE,GRENOBLE-1,16383,4587,11796,218,11578,1,RPR,1838,6.475,33.9
2002,ISERE,Le Touvet,16413,3614,12799,360,12439,1,CAP 21,369,6.475,33.9
2002,ISERE,Le Touvet,16413,3614,12799,360,12439,1,CPNT,304,6.475,33.9
2002,ISERE,Le Touvet,16413,3614,12799,360,12439,1,DL,588,6.475,33.9
2002,ISERE,Le Touvet,16413,3614,12799,360,12439,1,FN,1692,6.475,33.9
2002,ISERE,Le Touvet,16413,3614,12799,360,12439,1,FRS,172,6.475,33.9
2002,ISERE,Le Touvet,16413,3614,12799,360,12439,1,LCR,667,6.475,33.9
2002,ISERE,Le Touvet,16413,3614,12799,360,12439,1,LO,722,6.475,33.9
2002,ISERE,Le Touvet,16413,3614,12799,360,12439,1,LV,1154,6.475,33.9
2002,ISERE,Le Touvet,16413,3614,12799,360,12439,1,MDC,858,6.475,33.9
2002,ISERE,Le Touvet,16413,3614,12799,360,12439,1,MNR,239,6.475,33.9
2002,ISERE,Le Touvet,16413,3614,12799,360,12439,1,MODEM,870,6.475,33.9
2002,ISERE,Le Touvet,16413,3614,12799,360,12439,1,PCF,385,6.475,33.9
2002,ISERE,Le Touvet,16413,3614,12799,360,12439,1,PRG,331,6.475,33.9
2002,ISERE,Le Touvet,16413,3614,12799,360,12439,1,PS,2233,6.475,33.9
2002,ISERE,Le Touvet,16413,3614,12799,360,12439,1,PT,63,6.475,33.9
2002,ISERE,Le Touvet,16413,3614,12799,360,12439,1,RPR,1792,6.475,33.9
2002,ISERE,FONTAINE-SASSENAGE,16421,4253,12168,400,11768,1,CAP 21,235,6.475,33.9
2002,ISERE,FONTAINE-SASSENAGE,16421,4253,12168,400,11768,1,CPNT,198,6.475,33.9
2002,ISERE,FONTAINE-SASSENAGE,16421,4253,12168,400,11768,1,DL,399,6.475,33.9
2002,ISERE,FONTAINE-SASSENAGE,16421,4253,12168,400,11768,1,FN,1987,6.475,33.9
2002,ISERE,FONTAINE-SASSENAGE,16421,4253,12168,400,11768,1,FRS,126,6.475,33.9
2002,ISERE,FONTAINE-SASSENAGE,16421,4253,12168,400,11768,1,LCR,573,6.475,33.9
2002,ISERE,FONTAINE-SASSENAGE,16421,4253,12168,400,11768,1,LO,791,6.475,33.9
2002,ISERE,FONTAINE-SASSENAGE,16421,4253,12168,400,11768,1,LV,887,6.475,33.9
2002,ISERE,FONTAINE-SASSENAGE,16421,4253,12168,400,11768,1,MDC,873,6.475,33.9
2002,ISERE,FONTAINE-SASSENAGE,16421,4253,12168,400,11768,1,MNR,325,6.475,33.9
2002,ISERE,FONTAINE-SASSENAGE,16421,4253,12168,400,11768,1,MODEM,710,6.475,33.9
2002,ISERE,FONTAINE-SASSENAGE,16421,4253,12168,400,11768,1,PCF,638,6.475,33.9
2002,ISERE,FONTAINE-SASSENAGE,16421,4253,12168,400,11768,1,PRG,239,6.475,33.9
2002,ISERE,FONTAINE-SASSENAGE,16421,4253,12168,400,11768,1,PS,2170,6.475,33.9
2002,ISERE,FONTAINE-SASSENAGE,16421,4253,12168,400,11768,1,PT,58,6.475,33.9
2002,ISERE,FONTAINE-SASSENAGE,16421,4253,12168,400,11768,1,RPR,1559,6.475,33.9
2002,ISERE,LA-TOUR-DU-PIN,16866,4425,12441,465,11976,1,CAP 21,239,6.475,33.9
2002,ISERE,LA-TOUR-DU-PIN,16866,4425,12441,465,11976,1,CPNT,344,6.475,33.9
2002,ISERE,LA-TOUR-DU-PIN,16866,4425,12441,465,11976,1,DL,586,6.475,33.9
2002,ISERE,LA-TOUR-DU-PIN,16866,4425,12441,465,11976,1,FN,2940,6.475,33.9
2002,ISERE,LA-TOUR-DU-PIN,16866,4425,12441,465,11976,1,FRS,152,6.475,33.9
2002,ISERE,LA-TOUR-DU-PIN,16866,4425,12441,465,11976,1,LCR,494,6.475,33.9
2002,ISERE,LA-TOUR-DU-PIN,16866,4425,12441,465,11976,1,LO,733,6.475,33.9
2002,ISERE,LA-TOUR-DU-PIN,16866,4425,12441,465,11976,1,LV,574,6.475,33.9
2002,ISERE,LA-TOUR-DU-PIN,16866,4425,12441,465,11976,1,MDC,720,6.475,33.9
2002,ISERE,LA-TOUR-DU-PIN,16866,4425,12441,465,11976,1,MNR,396,6.475,33.9
2002,ISERE,LA-TOUR-DU-PIN,16866,4425,12441,465,11976,1,MODEM,794,6.475,33.9
2002,ISERE,LA-TOUR-DU-PIN,16866,4425,12441,465,11976,1,PCF,386,6.475,33.9
2002,ISERE,LA-TOUR-DU-PIN,16866,4425,12441,465,11976,1,PRG,208,6.475,33.9
2002,ISERE,LA-TOUR-DU-PIN,16866,4425,12441,465,11976,1,PS,1487,6.475,33.9
2002,ISERE,LA-TOUR-DU-PIN,16866,4425,12441,465,11976,1,PT,78,6.475,33.9
2002,ISERE,LA-TOUR-DU-PIN,16866,4425,12441,465,11976,1,RPR,1845,6.475,33.9
2002,ISERE,SAINT-EGREVE,16968,4215,12753,316,12437,1,CAP 21,316,6.475,33.9
2002,ISERE,SAINT-EGREVE,16968,4215,12753,316,12437,1,CPNT,234,6.475,33.9
2002,ISERE,SAINT-EGREVE,16968,4215,12753,316,12437,1,DL,476,6.475,33.9
2002,ISERE,SAINT-EGREVE,16968,4215,12753,316,12437,1,FN,1720,6.475,33.9
2002,ISERE,SAINT-EGREVE,16968,4215,12753,316,12437,1,FRS,167,6.475,33.9
2002,ISERE,SAINT-EGREVE,16968,4215,12753,316,12437,1,LCR,586,6.475,33.9
2002,ISERE,SAINT-EGREVE,16968,4215,12753,316,12437,1,LO,738,6.475,33.9
2002,ISERE,SAINT-EGREVE,16968,4215,12753,316,12437,1,LV,1121,6.475,33.9
2002,ISERE,SAINT-EGREVE,16968,4215,12753,316,12437,1,MDC,1055,6.475,33.9
2002,ISERE,SAINT-EGREVE,16968,4215,12753,316,12437,1,MNR,239,6.475,33.9
2002,ISERE,SAINT-EGREVE,16968,4215,12753,316,12437,1,MODEM,850,6.475,33.9
2002,ISERE,SAINT-EGREVE,16968,4215,12753,316,12437,1,PCF,439,6.475,33.9
2002,ISERE,SAINT-EGREVE,16968,4215,12753,316,12437,1,PRG,361,6.475,33.9
2002,ISERE,SAINT-EGREVE,16968,4215,12753,316,12437,1,PS,2311,6.475,33.9
2002,ISERE,SAINT-EGREVE,16968,4215,12753,316,12437,1,PT,59,6.475,33.9
2002,ISERE,SAINT-EGREVE,16968,4215,12753,316,12437,1,RPR,1765,6.475,33.9
2002,ISERE,DOMENE,17603,4397,13206,377,12829,1,CAP 21,330,6.475,33.9
2002,ISERE,DOMENE,17603,4397,13206,377,12829,1,CPNT,286,6.475,33.9
2002,ISERE,DOMENE,17603,4397,13206,377,12829,1,DL,531,6.475,33.9
2002,ISERE,DOMENE,17603,4397,13206,377,12829,1,FN,1985,6.475,33.9
2002,ISERE,DOMENE,17603,4397,13206,377,12829,1,FRS,132,6.475,33.9
2002,ISERE,DOMENE,17603,4397,13206,377,12829,1,LCR,577,6.475,33.9
2002,ISERE,DOMENE,17603,4397,13206,377,12829,1,LO,831,6.475,33.9
2002,ISERE,DOMENE,17603,4397,13206,377,12829,1,LV,1084,6.475,33.9
2002,ISERE,DOMENE,17603,4397,13206,377,12829,1,MDC,841,6.475,33.9
2002,ISERE,DOMENE,17603,4397,13206,377,12829,1,MNR,307,6.475,33.9
2002,ISERE,DOMENE,17603,4397,13206,377,12829,1,MODEM,823,6.475,33.9
2002,ISERE,DOMENE,17603,4397,13206,377,12829,1,PCF,689,6.475,33.9
2002,ISERE,DOMENE,17603,4397,13206,377,12829,1,PRG,249,6.475,33.9
2002,ISERE,DOMENE,17603,4397,13206,377,12829,1,PS,2269,6.475,33.9
2002,ISERE,DOMENE,17603,4397,13206,377,12829,1,PT,62,6.475,33.9
2002,ISERE,DOMENE,17603,4397,13206,377,12829,1,RPR,1833,6.475,33.9
2002,ISERE,FONTAINE-SEYSSINET,18244,4557,13687,385,13302,1,CAP 21,331,6.475,33.9
2002,ISERE,FONTAINE-SEYSSINET,18244,4557,13687,385,13302,1,CPNT,184,6.475,33.9
2002,ISERE,FONTAINE-SEYSSINET,18244,4557,13687,385,13302,1,DL,482,6.475,33.9
2002,ISERE,FONTAINE-SEYSSINET,18244,4557,13687,385,13302,1,FN,2133,6.475,33.9
2002,ISERE,FONTAINE-SEYSSINET,18244,4557,13687,385,13302,1,FRS,124,6.475,33.9
2002,ISERE,FONTAINE-SEYSSINET,18244,4557,13687,385,13302,1,LCR,696,6.475,33.9
2002,ISERE,FONTAINE-SEYSSINET,18244,4557,13687,385,13302,1,LO,800,6.475,33.9
2002,ISERE,FONTAINE-SEYSSINET,18244,4557,13687,385,13302,1,LV,1129,6.475,33.9
2002,ISERE,FONTAINE-SEYSSINET,18244,4557,13687,385,13302,1,MDC,947,6.475,33.9
2002,ISERE,FONTAINE-SEYSSINET,18244,4557,13687,385,13302,1,MNR,275,6.475,33.9
2002,ISERE,FONTAINE-SEYSSINET,18244,4557,13687,385,13302,1,MODEM,771,6.475,33.9
2002,ISERE,FONTAINE-SEYSSINET,18244,4557,13687,385,13302,1,PCF,505,6.475,33.9
2002,ISERE,FONTAINE-SEYSSINET,18244,4557,13687,385,13302,1,PRG,287,6.475,33.9
2002,ISERE,FONTAINE-SEYSSINET,18244,4557,13687,385,13302,1,PS,2784,6.475,33.9
2002,ISERE,FONTAINE-SEYSSINET,18244,4557,13687,385,13302,1,PT,67,6.475,33.9
2002,ISERE,FONTAINE-SEYSSINET,18244,4557,13687,385,13302,1,RPR,1787,6.475,33.9
2002,ISERE,CREMIEU,18529,4704,13825,476,13349,1,CAP 21,325,6.475,33.9
2002,ISERE,CREMIEU,18529,4704,13825,476,13349,1,CPNT,458,6.475,33.9
2002,ISERE,CREMIEU,18529,4704,13825,476,13349,1,DL,592,6.475,33.9
2002,ISERE,CREMIEU,18529,4704,13825,476,13349,1,FN,3402,6.475,33.9
2002,ISERE,CREMIEU,18529,4704,13825,476,13349,1,FRS,157,6.475,33.9
2002,ISERE,CREMIEU,18529,4704,13825,476,13349,1,LCR,548,6.475,33.9
2002,ISERE,CREMIEU,18529,4704,13825,476,13349,1,LO,699,6.475,33.9
2002,ISERE,CREMIEU,18529,4704,13825,476,13349,1,LV,724,6.475,33.9
2002,ISERE,CREMIEU,18529,4704,13825,476,13349,1,MDC,846,6.475,33.9
2002,ISERE,CREMIEU,18529,4704,13825,476,13349,1,MNR,459,6.475,33.9
2002,ISERE,CREMIEU,18529,4704,13825,476,13349,1,MODEM,966,6.475,33.9
2002,ISERE,CREMIEU,18529,4704,13825,476,13349,1,PCF,278,6.475,33.9
2002,ISERE,CREMIEU,18529,4704,13825,476,13349,1,PRG,227,6.475,33.9
2002,ISERE,CREMIEU,18529,4704,13825,476,13349,1,PS,1617,6.475,33.9
2002,ISERE,CREMIEU,18529,4704,13825,476,13349,1,PT,57,6.475,33.9
2002,ISERE,CREMIEU,18529,4704,13825,476,13349,1,RPR,1994,6.475,33.9
2002,ISERE,Rives,18939,4848,14091,482,13609,1,CAP 21,323,6.475,33.9
2002,ISERE,Rives,18939,4848,14091,482,13609,1,CPNT,356,6.475,33.9
2002,ISERE,Rives,18939,4848,14091,482,13609,1,DL,658,6.475,33.9
2002,ISERE,Rives,18939,4848,14091,482,13609,1,FN,2340,6.475,33.9
2002,ISERE,Rives,18939,4848,14091,482,13609,1,FRS,160,6.475,33.9
2002,ISERE,Rives,18939,4848,14091,482,13609,1,LCR,651,6.475,33.9
2002,ISERE,Rives,18939,4848,14091,482,13609,1,LO,928,6.475,33.9
2002,ISERE,Rives,18939,4848,14091,482,13609,1,LV,874,6.475,33.9
2002,ISERE,Rives,18939,4848,14091,482,13609,1,MDC,936,6.475,33.9
2002,ISERE,Rives,18939,4848,14091,482,13609,1,MNR,306,6.475,33.9
2002,ISERE,Rives,18939,4848,14091,482,13609,1,MODEM,923,6.475,33.9
2002,ISERE,Rives,18939,4848,14091,482,13609,1,PCF,563,6.475,33.9
2002,ISERE,Rives,18939,4848,14091,482,13609,1,PRG,259,6.475,33.9
2002,ISERE,Rives,18939,4848,14091,482,13609,1,PS,2180,6.475,33.9
2002,ISERE,Rives,18939,4848,14091,482,13609,1,PT,104,6.475,33.9
2002,ISERE,Rives,18939,4848,14091,482,13609,1,RPR,2048,6.475,33.9
2002,ISERE,Vizille,19896,5216,14680,506,14174,1,CAP 21,334,6.475,33.9
2002,ISERE,Vizille,19896,5216,14680,506,14174,1,CPNT,402,6.475,33.9
2002,ISERE,Vizille,19896,5216,14680,506,14174,1,DL,543,6.475,33.9
2002,ISERE,Vizille,19896,5216,14680,506,14174,1,FN,2652,6.475,33.9
2002,ISERE,Vizille,19896,5216,14680,506,14174,1,FRS,109,6.475,33.9
2002,ISERE,Vizille,19896,5216,14680,506,14174,1,LCR,733,6.475,33.9
2002,ISERE,Vizille,19896,5216,14680,506,14174,1,LO,1056,6.475,33.9
2002,ISERE,Vizille,19896,5216,14680,506,14174,1,LV,1032,6.475,33.9
2002,ISERE,Vizille,19896,5216,14680,506,14174,1,MDC,1012,6.475,33.9
2002,ISERE,Vizille,19896,5216,14680,506,14174,1,MNR,370,6.475,33.9
2002,ISERE,Vizille,19896,5216,14680,506,14174,1,MODEM,847,6.475,33.9
2002,ISERE,Vizille,19896,5216,14680,506,14174,1,PCF,685,6.475,33.9
2002,ISERE,Vizille,19896,5216,14680,506,14174,1,PRG,273,6.475,33.9
2002,ISERE,Vizille,19896,5216,14680,506,14174,1,PS,2318,6.475,33.9
2002,ISERE,Vizille,19896,5216,14680,506,14174,1,PT,63,6.475,33.9
2002,ISERE,Vizille,19896,5216,14680,506,14174,1,RPR,1745,6.475,33.9
2002,ISERE,Meylan,20459,4754,15705,340,15365,1,CAP 21,593,6.475,33.9
2002,ISERE,Meylan,20459,4754,15705,340,15365,1,CPNT,182,6.475,33.9
2002,ISERE,Meylan,20459,4754,15705,340,15365,1,DL,1085,6.475,33.9
2002,ISERE,Meylan,20459,4754,15705,340,15365,1,FN,1413,6.475,33.9
2002,ISERE,Meylan,20459,4754,15705,340,15365,1,FRS,316,6.475,33.9
2002,ISERE,Meylan,20459,4754,15705,340,15365,1,LCR,479,6.475,33.9
2002,ISERE,Meylan,20459,4754,15705,340,15365,1,LO,434,6.475,33.9
2002,ISERE,Meylan,20459,4754,15705,340,15365,1,LV,1325,6.475,33.9
2002,ISERE,Meylan,20459,4754,15705,340,15365,1,MDC,1236,6.475,33.9
2002,ISERE,Meylan,20459,4754,15705,340,15365,1,MNR,218,6.475,33.9
2002,ISERE,Meylan,20459,4754,15705,340,15365,1,MODEM,1572,6.475,33.9
2002,ISERE,Meylan,20459,4754,15705,340,15365,1,PCF,276,6.475,33.9
2002,ISERE,Meylan,20459,4754,15705,340,15365,1,PRG,399,6.475,33.9
2002,ISERE,Meylan,20459,4754,15705,340,15365,1,PS,2601,6.475,33.9
2002,ISERE,Meylan,20459,4754,15705,340,15365,1,PT,36,6.475,33.9
2002,ISERE,Meylan,20459,4754,15705,340,15365,1,RPR,3200,6.475,33.9
2002,ISERE,VIENNE-SUD,20549,5220,15329,492,14837,1,CAP 21,362,6.475,33.9
2002,ISERE,VIENNE-SUD,20549,5220,15329,492,14837,1,CPNT,384,6.475,33.9
2002,ISERE,VIENNE-SUD,20549,5220,15329,492,14837,1,DL,778,6.475,33.9
2002,ISERE,VIENNE-SUD,20549,5220,15329,492,14837,1,FN,3182,6.475,33.9
2002,ISERE,VIENNE-SUD,20549,5220,15329,492,14837,1,FRS,172,6.475,33.9
2002,ISERE,VIENNE-SUD,20549,5220,15329,492,14837,1,LCR,600,6.475,33.9
2002,ISERE,VIENNE-SUD,20549,5220,15329,492,14837,1,LO,750,6.475,33.9
2002,ISERE,VIENNE-SUD,20549,5220,15329,492,14837,1,LV,778,6.475,33.9
2002,ISERE,VIENNE-SUD,20549,5220,15329,492,14837,1,MDC,1003,6.475,33.9
2002,ISERE,VIENNE-SUD,20549,5220,15329,492,14837,1,MNR,501,6.475,33.9
2002,ISERE,VIENNE-SUD,20549,5220,15329,492,14837,1,MODEM,1086,6.475,33.9
2002,ISERE,VIENNE-SUD,20549,5220,15329,492,14837,1,PCF,279,6.475,33.9
2002,ISERE,VIENNE-SUD,20549,5220,15329,492,14837,1,PRG,287,6.475,33.9
2002,ISERE,VIENNE-SUD,20549,5220,15329,492,14837,1,PS,1969,6.475,33.9
2002,ISERE,VIENNE-SUD,20549,5220,15329,492,14837,1,PT,70,6.475,33.9
2002,ISERE,VIENNE-SUD,20549,5220,15329,492,14837,1,RPR,2636,6.475,33.9
2002,ISERE,Vif,22071,5393,16678,425,16253,1,CAP 21,355,6.475,33.9
2002,ISERE,Vif,22071,5393,16678,425,16253,1,CPNT,342,6.475,33.9
2002,ISERE,Vif,22071,5393,16678,425,16253,1,DL,643,6.475,33.9
2002,ISERE,Vif,22071,5393,16678,425,16253,1,FN,3011,6.475,33.9
2002,ISERE,Vif,22071,5393,16678,425,16253,1,FRS,149,6.475,33.9
2002,ISERE,Vif,22071,5393,16678,425,16253,1,LCR,737,6.475,33.9
2002,ISERE,Vif,22071,5393,16678,425,16253,1,LO,1035,6.475,33.9
2002,ISERE,Vif,22071,5393,16678,425,16253,1,LV,1160,6.475,33.9
2002,ISERE,Vif,22071,5393,16678,425,16253,1,MDC,1141,6.475,33.9
2002,ISERE,Vif,22071,5393,16678,425,16253,1,MNR,465,6.475,33.9
2002,ISERE,Vif,22071,5393,16678,425,16253,1,MODEM,1042,6.475,33.9
2002,ISERE,Vif,22071,5393,16678,425,16253,1,PCF,807,6.475,33.9
2002,ISERE,Vif,22071,5393,16678,425,16253,1,PRG,302,6.475,33.9
2002,ISERE,Vif,22071,5393,16678,425,16253,1,PS,2610,6.475,33.9
2002,ISERE,Vif,22071,5393,16678,425,16253,1,PT,73,6.475,33.9
2002,ISERE,Vif,22071,5393,16678,425,16253,1,RPR,2381,6.475,33.9
2002,ISERE,VIENNE-NORD,22272,6659,15613,528,15085,1,CAP 21,308,6.475,33.9
2002,ISERE,VIENNE-NORD,22272,6659,15613,528,15085,1,CPNT,285,6.475,33.9
2002,ISERE,VIENNE-NORD,22272,6659,15613,528,15085,1,DL,601,6.475,33.9
2002,ISERE,VIENNE-NORD,22272,6659,15613,528,15085,1,FN,3274,6.475,33.9
2002,ISERE,VIENNE-NORD,22272,6659,15613,528,15085,1,FRS,156,6.475,33.9
2002,ISERE,VIENNE-NORD,22272,6659,15613,528,15085,1,LCR,559,6.475,33.9
2002,ISERE,VIENNE-NORD,22272,6659,15613,528,15085,1,LO,840,6.475,33.9
2002,ISERE,VIENNE-NORD,22272,6659,15613,528,15085,1,LV,869,6.475,33.9
2002,ISERE,VIENNE-NORD,22272,6659,15613,528,15085,1,MDC,1104,6.475,33.9
2002,ISERE,VIENNE-NORD,22272,6659,15613,528,15085,1,MNR,556,6.475,33.9
2002,ISERE,VIENNE-NORD,22272,6659,15613,528,15085,1,MODEM,945,6.475,33.9
2002,ISERE,VIENNE-NORD,22272,6659,15613,528,15085,1,PCF,467,6.475,33.9
2002,ISERE,VIENNE-NORD,22272,6659,15613,528,15085,1,PRG,266,6.475,33.9
2002,ISERE,VIENNE-NORD,22272,6659,15613,528,15085,1,PS,2479,6.475,33.9
2002,ISERE,VIENNE-NORD,22272,6659,15613,528,15085,1,PT,77,6.475,33.9
2002,ISERE,VIENNE-NORD,22272,6659,15613,528,15085,1,RPR,2299,6.475,33.9
2002,ISERE,Voiron,28514,7009,21505,701,20804,1,CAP 21,557,6.475,33.9
2002,ISERE,Voiron,28514,7009,21505,701,20804,1,CPNT,427,6.475,33.9
2002,ISERE,Voiron,28514,7009,21505,701,20804,1,DL,1070,6.475,33.9
2002,ISERE,Voiron,28514,7009,21505,701,20804,1,FN,3159,6.475,33.9
2002,ISERE,Voiron,28514,7009,21505,701,20804,1,FRS,299,6.475,33.9
2002,ISERE,Voiron,28514,7009,21505,701,20804,1,LCR,940,6.475,33.9
2002,ISERE,Voiron,28514,7009,21505,701,20804,1,LO,1219,6.475,33.9
2002,ISERE,Voiron,28514,7009,21505,701,20804,1,LV,1617,6.475,33.9
2002,ISERE,Voiron,28514,7009,21505,701,20804,1,MDC,1616,6.475,33.9
2002,ISERE,Voiron,28514,7009,21505,701,20804,1,MNR,416,6.475,33.9
2002,ISERE,Voiron,28514,7009,21505,701,20804,1,MODEM,1651,6.475,33.9
2002,ISERE,Voiron,28514,7009,21505,701,20804,1,PCF,547,6.475,33.9
2002,ISERE,Voiron,28514,7009,21505,701,20804,1,PRG,412,6.475,33.9
2002,ISERE,Voiron,28514,7009,21505,701,20804,1,PS,3362,6.475,33.9
2002,ISERE,Voiron,28514,7009,21505,701,20804,1,PT,123,6.475,33.9
2002,ISERE,Voiron,28514,7009,21505,701,20804,1,RPR,3389,6.475,33.9
2002,ISERE,Roussillon,28809,7683,21126,758,20368,1,CAP 21,336,6.475,33.9
2002,ISERE,Roussillon,28809,7683,21126,758,20368,1,CPNT,788,6.475,33.9
2002,ISERE,Roussillon,28809,7683,21126,758,20368,1,DL,748,6.475,33.9
2002,ISERE,Roussillon,28809,7683,21126,758,20368,1,FN,4641,6.475,33.9
2002,ISERE,Roussillon,28809,7683,21126,758,20368,1,FRS,242,6.475,33.9
2002,ISERE,Roussillon,28809,7683,21126,758,20368,1,LCR,904,6.475,33.9
2002,ISERE,Roussillon,28809,7683,21126,758,20368,1,LO,1223,6.475,33.9
2002,ISERE,Roussillon,28809,7683,21126,758,20368,1,LV,834,6.475,33.9
2002,ISERE,Roussillon,28809,7683,21126,758,20368,1,MDC,1346,6.475,33.9
2002,ISERE,Roussillon,28809,7683,21126,758,20368,1,MNR,719,6.475,33.9
2002,ISERE,Roussillon,28809,7683,21126,758,20368,1,MODEM,1196,6.475,33.9
2002,ISERE,Roussillon,28809,7683,21126,758,20368,1,PCF,1500,6.475,33.9
2002,ISERE,Roussillon,28809,7683,21126,758,20368,1,PRG,296,6.475,33.9
2002,ISERE,Roussillon,28809,7683,21126,758,20368,1,PS,2824,6.475,33.9
2002,ISERE,Roussillon,28809,7683,21126,758,20368,1,PT,89,6.475,33.9
2002,ISERE,Roussillon,28809,7683,21126,758,20368,1,RPR,2682,6.475,33.9
2002,ISERE,Clelles,1560,225,1335,65,1270,2,FN,212,6.475,33.9
2002,ISERE,Clelles,1560,225,1335,65,1270,2,RPR,1058,6.475,33.9
2002,ISERE,Valbonnais,1889,381,1508,100,1408,2,FN,256,6.475,33.9
2002,ISERE,Valbonnais,1889,381,1508,100,1408,2,RPR,1152,6.475,33.9
2002,ISERE,Corps,1933,342,1591,80,1511,2,FN,313,6.475,33.9
2002,ISERE,Corps,1933,342,1591,80,1511,2,RPR,1198,6.475,33.9
2002,ISERE,Mens,2485,420,2065,114,1951,2,FN,343,6.475,33.9
2002,ISERE,Mens,2485,420,2065,114,1951,2,RPR,1608,6.475,33.9
2002,ISERE,Monestier-de-Clermont,3109,408,2701,123,2578,2,FN,342,6.475,33.9
2002,ISERE,Monestier-de-Clermont,3109,408,2701,123,2578,2,RPR,2236,6.475,33.9
2002,ISERE,Roybon,4475,910,3565,239,3326,2,FN,775,6.475,33.9
2002,ISERE,Roybon,4475,910,3565,239,3326,2,RPR,2551,6.475,33.9
2002,ISERE,Pont-en-Royans,4505,772,3733,239,3494,2,FN,655,6.475,33.9
2002,ISERE,Pont-en-Royans,4505,772,3733,239,3494,2,RPR,2839,6.475,33.9
2002,ISERE,Allevard,4691,897,3794,214,3580,2,FN,588,6.475,33.9
2002,ISERE,Allevard,4691,897,3794,214,3580,2,RPR,2992,6.475,33.9
2002,ISERE,Vinay,5745,1029,4716,263,4453,2,FN,1013,6.475,33.9
2002,ISERE,Vinay,5745,1029,4716,263,4453,2,RPR,3440,6.475,33.9
2002,ISERE,SAINT-MARTIN-D'HERES-SUD,6220,1229,4991,190,4801,2,FN,634,6.475,33.9
2002,ISERE,SAINT-MARTIN-D'HERES-SUD,6220,1229,4991,190,4801,2,RPR,4167,6.475,33.9
2002,ISERE,Saint-Geoire-en-Valdaine,6237,1120,5117,313,4804,2,FN,1153,6.475,33.9
2002,ISERE,Saint-Geoire-en-Valdaine,6237,1120,5117,313,4804,2,RPR,3651,6.475,33.9
2002,ISERE,VIRIEU,6815,1184,5631,360,5271,2,FN,1136,6.475,33.9
2002,ISERE,VIRIEU,6815,1184,5631,360,5271,2,RPR,4135,6.475,33.9
2002,ISERE,Saint-Etienne-de-Saint-Geoirs,7610,1430,6180,356,5824,2,FN,1155,6.475,33.9
2002,ISERE,Saint-Etienne-de-Saint-Geoirs,7610,1430,6180,356,5824,2,RPR,4669,6.475,33.9
2002,ISERE,Saint-Laurent-du-Pont,7669,1399,6270,346,5924,2,FN,1172,6.475,33.9
2002,ISERE,Saint-Laurent-du-Pont,7669,1399,6270,346,5924,2,RPR,4752,6.475,33.9
2002,ISERE,ECHIROLLES-EST,7751,1296,6455,286,6169,2,FN,923,6.475,33.9
2002,ISERE,ECHIROLLES-EST,7751,1296,6455,286,6169,2,RPR,5246,6.475,33.9
2002,ISERE,Tullins,7850,1495,6355,376,5979,2,FN,1188,6.475,33.9
2002,ISERE,Tullins,7850,1495,6355,376,5979,2,RPR,4791,6.475,33.9
2002,ISERE,Villard-de-Lans,8006,1316,6690,241,6449,2,FN,777,6.475,33.9
2002,ISERE,Villard-de-Lans,8006,1316,6690,241,6449,2,RPR,5672,6.475,33.9
2002,ISERE,LE-BOURG-D'OISANS,8510,2031,6479,330,6149,2,FN,1130,6.475,33.9
2002,ISERE,LE-BOURG-D'OISANS,8510,2031,6479,330,6149,2,RPR,5019,6.475,33.9
2002,ISERE,SAINT-MARTIN-D'HERES-NORD,8715,1684,7031,249,6782,2,FN,945,6.475,33.9
2002,ISERE,SAINT-MARTIN-D'HERES-NORD,8715,1684,7031,249,6782,2,RPR,5837,6.475,33.9
2002,ISERE,LA-COTE-SAINT-ANDRE,9043,1506,7537,429,7108,2,FN,1569,6.475,33.9
2002,ISERE,LA-COTE-SAINT-ANDRE,9043,1506,7537,429,7108,2,RPR,5539,6.475,33.9
2002,ISERE,Beaurepaire,9290,1785,7505,454,7051,2,FN,1776,6.475,33.9
2002,ISERE,Beaurepaire,9290,1785,7505,454,7051,2,RPR,5275,6.475,33.9
2002,ISERE,LE-GRAND-LEMPS,9292,1654,7638,492,7146,2,FN,1483,6.475,33.9
2002,ISERE,LE-GRAND-LEMPS,9292,1654,7638,492,7146,2,RPR,5663,6.475,33.9
2002,ISERE,La Mure,9747,1893,7854,547,7307,2,FN,1470,6.475,33.9
2002,ISERE,La Mure,9747,1893,7854,547,7307,2,RPR,5837,6.475,33.9
2002,ISERE,GRENOBLE-4,10389,2169,8220,223,7997,2,FN,944,6.475,33.9
2002,ISERE,GRENOBLE-4,10389,2169,8220,223,7997,2,RPR,7053,6.475,33.9
2002,ISERE,GRENOBLE-6,10416,2193,8223,273,7950,2,FN,1063,6.475,33.9
2002,ISERE,GRENOBLE-6,10416,2193,8223,273,7950,2,RPR,6887,6.475,33.9
2002,ISERE,ECHIROLLES-OUEST,10618,1833,8785,336,8449,2,FN,1368,6.475,33.9
2002,ISERE,ECHIROLLES-OUEST,10618,1833,8785,336,8449,2,RPR,7081,6.475,33.9
2002,ISERE,Saint-Jean-de-Bournay,10641,2035,8606,582,8024,2,FN,2114,6.475,33.9
2002,ISERE,Saint-Jean-de-Bournay,10641,2035,8606,582,8024,2,RPR,5910,6.475,33.9
2002,ISERE,LA VERPILLIERE,10798,2123,8675,481,8194,2,FN,2008,6.475,33.9
2002,ISERE,LA VERPILLIERE,10798,2123,8675,481,8194,2,RPR,6186,6.475,33.9
2002,ISERE,GRENOBLE-3,12028,2232,9796,355,9441,2,FN,1181,6.475,33.9
2002,ISERE,GRENOBLE-3,12028,2232,9796,355,9441,2,RPR,8260,6.475,33.9
2002,ISERE,Eybens,12374,1914,10460,439,10021,2,FN,1249,6.475,33.9
2002,ISERE,Eybens,12374,1914,10460,439,10021,2,RPR,8772,6.475,33.9
2002,ISERE,Heyrieux,12646,2257,10389,721,9668,2,FN,2479,6.475,33.9
2002,ISERE,Heyrieux,12646,2257,10389,721,9668,2,RPR,7189,6.475,33.9
2002,ISERE,LE-PONT-DE-BEAUVOISIN,13107,2541,10566,620,9946,2,FN,2595,6.475,33.9
2002,ISERE,LE-PONT-DE-BEAUVOISIN,13107,2541,10566,620,9946,2,RPR,7351,6.475,33.9
2002,ISERE,PONT-DE-CHERUY,13161,3060,10101,421,9680,2,FN,2631,6.475,33.9
2002,ISERE,PONT-DE-CHERUY,13161,3060,10101,421,9680,2,RPR,7049,6.475,33.9
2002,ISERE,Goncelin,13258,2425,10833,646,10187,2,FN,1886,6.475,33.9
2002,ISERE,Goncelin,13258,2425,10833,646,10187,2,RPR,8301,6.475,33.9
2002,ISERE,Saint-Ismier,13383,1945,11438,357,11081,2,FN,1169,6.475,33.9
2002,ISERE,Saint-Ismier,13383,1945,11438,357,11081,2,RPR,9912,6.475,33.9
2002,ISERE,GRENOBLE-2,13531,2531,11000,323,10677,2,FN,1132,6.475,33.9
2002,ISERE,GRENOBLE-2,13531,2531,11000,323,10677,2,RPR,9545,6.475,33.9
2002,ISERE,BOURGOIN-JALLIEU-SUD,14325,2810,11515,574,10941,2,FN,2353,6.475,33.9
2002,ISERE,BOURGOIN-JALLIEU-SUD,14325,2810,11515,574,10941,2,RPR,8588,6.475,33.9
2002,ISERE,Saint-Marcellin,14532,2578,11954,640,11314,2,FN,2457,6.475,33.9
2002,ISERE,Saint-Marcellin,14532,2578,11954,640,11314,2,RPR,8857,6.475,33.9
2002,ISERE,BOURGOIN-JALLIEU-NORD,14917,3092,11825,648,11177,2,FN,2475,6.475,33.9
2002,ISERE,BOURGOIN-JALLIEU-NORD,14917,3092,11825,648,11177,2,RPR,8702,6.475,33.9
2002,ISERE,GRENOBLE-5,15132,2994,12138,424,11714,2,FN,1529,6.475,33.9
2002,ISERE,GRENOBLE-5,15132,2994,12138,424,11714,2,RPR,10185,6.475,33.9
2002,ISERE,L'Isle-d'Abeau,15240,3209,12031,614,11417,2,FN,2235,6.475,33.9
2002,ISERE,L'Isle-d'Abeau,15240,3209,12031,614,11417,2,RPR,9182,6.475,33.9
2002,ISERE,Morestel,15715,3390,12325,809,11516,2,FN,3100,6.475,33.9
2002,ISERE,Morestel,15715,3390,12325,809,11516,2,RPR,8416,6.475,33.9
2002,ISERE,GRENOBLE-1,16393,3276,13117,393,12724,2,FN,1503,6.475,33.9
2002,ISERE,GRENOBLE-1,16393,3276,13117,393,12724,2,RPR,11221,6.475,33.9
2002,ISERE,Le Touvet,16401,2313,14088,567,13521,2,FN,1852,6.475,33.9
2002,ISERE,Le Touvet,16401,2313,14088,567,13521,2,RPR,11669,6.475,33.9
2002,ISERE,FONTAINE-SASSENAGE,16421,3008,13413,595,12818,2,FN,2070,6.475,33.9
2002,ISERE,FONTAINE-SASSENAGE,16421,3008,13413,595,12818,2,RPR,10748,6.475,33.9
2002,ISERE,LA-TOUR-DU-PIN,16872,3223,13649,810,12839,2,FN,3135,6.475,33.9
2002,ISERE,LA-TOUR-DU-PIN,16872,3223,13649,810,12839,2,RPR,9704,6.475,33.9
2002,ISERE,SAINT-EGREVE,16969,3055,13914,570,13344,2,FN,1812,6.475,33.9
2002,ISERE,SAINT-EGREVE,16969,3055,13914,570,13344,2,RPR,11532,6.475,33.9
2002,ISERE,DOMENE,17604,2849,14755,651,14104,2,FN,2126,6.475,33.9
2002,ISERE,DOMENE,17604,2849,14755,651,14104,2,RPR,11978,6.475,33.9
2002,ISERE,FONTAINE-SEYSSINET,18251,3264,14987,604,14383,2,FN,1991,6.475,33.9
2002,ISERE,FONTAINE-SEYSSINET,18251,3264,14987,604,14383,2,RPR,12392,6.475,33.9
2002,ISERE,CREMIEU,18526,3501,15025,805,14220,2,FN,3750,6.475,33.9
2002,ISERE,CREMIEU,18526,3501,15025,805,14220,2,RPR,10470,6.475,33.9
2002,ISERE,Rives,18938,3217,15721,746,14975,2,FN,2454,6.475,33.9
2002,ISERE,Rives,18938,3217,15721,746,14975,2,RPR,12521,6.475,33.9
2002,ISERE,Vizille,19901,3685,16216,855,15361,2,FN,2771,6.475,33.9
2002,ISERE,Vizille,19901,3685,16216,855,15361,2,RPR,12590,6.475,33.9
2002,ISERE,Meylan,20466,3058,17408,480,16928,2,FN,1611,6.475,33.9
2002,ISERE,Meylan,20466,3058,17408,480,16928,2,RPR,15317,6.475,33.9
2002,ISERE,VIENNE-SUD,20618,3741,16877,856,16021,2,FN,3543,6.475,33.9
2002,ISERE,VIENNE-SUD,20618,3741,16877,856,16021,2,RPR,12478,6.475,33.9
2002,ISERE,Vif,22077,3700,18377,827,17550,2,FN,3032,6.475,33.9
2002,ISERE,Vif,22077,3700,18377,827,17550,2,RPR,14518,6.475,33.9
2002,ISERE,VIENNE-NORD,22357,4864,17493,898,16595,2,FN,3559,6.475,33.9
2002,ISERE,VIENNE-NORD,22357,4864,17493,898,16595,2,RPR,13036,6.475,33.9
2002,ISERE,Voiron,28514,4512,24002,1074,22928,2,FN,3307,6.475,33.9
2002,ISERE,Voiron,28514,4512,24002,1074,22928,2,RPR,19621,6.475,33.9
2002,ISERE,Roussillon,28808,5882,22926,1422,21504,2,FN,4970,6.475,33.9
2002,ISERE,Roussillon,28808,5882,22926,1422,21504,2,RPR,16534,6.475,33.9
